Barcode	cell_type
TTTGGTTCACTGTCAA-1	CM
ACAGAAATCGTTCAGA-1	Fib
TGTAAGCTCAGTGGTT-1	CM
TTAGCTTCATATACGC-1	CM
AGCCGCATCGGAAAGC-1	CM
AACGAGGCAATCAGGG-1	CM
TGTGTCCCATGGATGG-1	CM
TGCACCTTCTCTTCCT-1	CM
TTGCACCAGAATCAAC-1	CM
GAGCATTCAAATGTCC-1	CM
CGCTAGGAGGGAGATA-1	CM
GGAGAACTCAAGTTGC-1	CM
CCCTGATCACGTTGTA-1	CM
CTCGCTATCCCAATAG-1	CM
AGATTCGGTGGTAAGC-1	CM
ACCGAATTCCTGGGAC-1	CM
GAACCGCGTAGATTAG-1	CM
GAGCGCTGTATCTAGC-1	CM
GCGATCGGTTTGGATC-1	CM
TCAGCTCAGTGATAAC-1	CM
TCGCCTACACTACACA-1	CM
AGATTCGTCATTCTCA-1	CM
CACAACAAGAACGTTA-1	CM
GCGGGTTCATGGAGGT-1	CM
CACTGAAAGCCGCAAA-1	CM
AGTGCGCTCAAGAGAT-1	CM
GCGATTATCCTCAAGA-1	Fib
AAGGTTCAGTATCTGC-1	CM
CAGGGCTCATGTGAGG-1	CM
GTTACTTTCTTAAGCG-1	CM
GGAGGATGTGGTCGAA-1	CM
ATGTTTCCAAAGGAAG-1	CM
TAGGTGTTCCAGCACG-1	CM
GCTCGAGCAAACCTAC-1	CM
CACCTTGGTTCCCTTG-1	CM
ACATGGTTCCTAGAGT-1	CM
AACCTGAGTATCACAC-1	CM
TCAATTCCATTCTTTG-1	Fib
TACCTCGGTTTAGAAG-1	CM
TTTACGTAGGAAGAAC-1	Endo
ATCCTGCGTTCTGAGT-1	CM
ATCCTGCCAAGCAATA-1	CM
GGATGAGGTGGCCTCA-1	CM
TACATTCTCGACTGGC-1	CM
TCAAGACCACTGATAC-1	CM
ATTTGTCAGATCTCAC-1	CM
CCCTCTCAGGTCCTCG-1	CM
GAGGTCCGTAGCCATT-1	CM
CTTAATCAGTTGCCGC-1	CM
CCACAGGCAACAAACA-1	CM
CACAACAAGAGGCCTA-1	CM
GATGGCCAGATTGACA-1	CM
TATCGAGTCTCTGACC-1	CM
GTGTCAAGTACATGGG-1	CM
AAACGAAAGCTCGTTA-1	CM
AATGCCATCAGTACAC-1	CM
GACCTTCGTAGATTAG-1	CM
TATCGAGGTGCTTGAT-1	CM
GAAAGTATCCACTAGA-1	CM
ACAGCGCAGGCCTAAG-1	CM
GCCTACTGTGGTAAGC-1	Fib
GCAAAGGGTATTCTGG-1	CM
TATCTGTGTACCTATG-1	CM
TTCAACTTCACCGCGA-1	CM
GTACTTTAGGGTCCCT-1	CM
ATGTACGCATTCACGA-1	CM
CCCTGATAGAATATCG-1	CM
GCCCAGATCGTCCCAT-1	CM
TATCTGTGTGAGTAAT-1	vSMCs
CCAATGAGTTTGTCTT-1	CM
GAGAACGCACATTGCA-1	CM
ACCGGGTAGCACACCC-1	Fib
CTCATGCTCAGGATCT-1	CM
GAAGTCTCATGATTGC-1	CM
CCCTAACGTGAATGTA-1	CM
GCATGATCAGGCACAA-1	CM
GAGGATGGTCCGTAGC-1	CM
TTCGATTAGGTACACG-1	Myeloid
AGTCAACGTGGCGCTT-1	CM
TCTCAGCGTGAGTCGA-1	CM
ACGGATTTCAGCCGGT-1	Myeloid
CCAATGAGTCCACCAG-1	CM
AATGGCTAGTTATGAG-1	CM
TGGCGCACATCTCTCG-1	CM
AGCCTCTGTGCACTTA-1	CM
TGTAGCAAGTTACACC-1	CM
GCGAGAACATGGTTTG-1	CM
AATGGAAAGACACAAT-1	CM
TCGTTCGGTCTGGGCT-1	CM
AGATAGATCACCGCGA-1	Fib
TGATTTCTCGGTAGGA-1	CM
AGCCTCTCAAACCCTA-1	CM
CCGCATTCAACGTACT-1	CM
CCTGGGAGTACGGAGT-1	CM
TATCGAGAGATACCAA-1	CM
AACCTTTCATGATCGT-1	CM
GCCTAGGTCTCATCCG-1	CM
TTTGTGTCATTGTTCT-1	CM
TATCGAGAGTGTAATG-1	CM
CCCTAACCAGTGCGAA-1	CM
ACAATCGGTAGCAGGT-1	Endo
GGTGCTGCACCGTCTT-1	CM
TAACAGCGTCATCGTA-1	CM
GGTGTCGAGTTGAATG-1	CM
TAAGCCAGTTACGAAA-1	CM
AAGGAGCGTAACCGAG-1	CM
CCGTAGGAGATTAGAC-1	CM
CAACGGCCAAGCAATA-1	CM
GTGTCAACACAGATGG-1	CM
GATCATGGTACGAGAC-1	CM
TAGACTGAGTCTAGAA-1	CM
GTTACGACATCAGAAA-1	CM
GGGTGTCAGCTGCCAC-1	CM
GAGAACGTCGGTTAGT-1	CM
ACGTGGCTCCTGTAGA-1	CM
CGCAATAGTCAACGGA-1	CM
TAACAGCTCAAACCCA-1	CM
AGCTGTAAGGAAGACA-1	CM
TGGCGCACAAGAGATT-1	CM
ATTGTGGGTAAACGGC-1	CM
CTTAATCTCCTGAAAC-1	CM
GCGGTGTAGCCCATGC-1	CM
GGATGAGGTGGCATAG-1	CM
GGAATCTTCATCATGG-1	CM
GAGGCTCCATAGAATG-1	CM
TTCGGTCTCAGCACTA-1	CM
GGTGAAGGTAACCATC-1	CM
GTCGTAATCTATCTAC-1	CM
CCCACATGTTAGCTCA-1	CM
TGATCAGTCTTACTCA-1	CM
TTCAACTAGACTAATG-1	CM
GTTCAAGCACACTAGT-1	CM
GGTGAAGGTTACTTTC-1	Fib
ACGTGGCAGTCTCGAT-1	CM
TCGAGCGCAGGCATCC-1	CM
GCGAGTCGTGCATTGT-1	CM
GTGTCCTGTCCGAGCT-1	CM
ACCCAAACACAGATGG-1	CM
AGATAGACAGGTAGGT-1	CM
AGTTTGGGTAAGTGCG-1	Fib
ATAGTCGTCTCTGCAC-1	CM
ACAAGCTCACCACCAG-1	CM
TGTAGCATCCTGTGGG-1	CM
TCTCTGGGTAAGCCTT-1	CM
AACTGGTGTTCGGGAA-1	CM
CCACGTTAGGATTGCG-1	CM
CTTGAAGTCGCGGCAT-1	CM
AATGTCGGTGCTAGTT-1	Endo
GAACCGCGTCCAAGTT-1	CM
TCCATCGGTCAACAGG-1	CM
TAAACCGCAACGTACT-1	CM
ATGTCTTGTTAGGAAT-1	Fib
GAGGATGCAACTACTG-1	CM
ACTACCCGTACGGAGT-1	CM
AACGAGGAGTACTCTG-1	CM
GTTATTCTCTCATCCG-1	CM
AGTTACGAGGTCTTTG-1	CM
AGCTGATTCCCTACCA-1	CM
GCATGATTCTACTTTG-1	CM
AGGCGTCAGGGAGATA-1	CM
TTCATTGAGAGAACCC-1	CM
TGTACAGTCGGGATCC-1	Fib
AGTTACGCATTCTTTG-1	Fib
CGCACAGAGGCAAGCT-1	CM
GTAGGAGTCTCTGAGA-1	CM
ACCTGCTCAGGGTAAC-1	CM
TTGGTCCTCATCGCCT-1	CM
GCGATTACAAAGAAGG-1	Fib
TTGGTCCTCGCAACTA-1	CM
TAGGAGGCACCGTCTT-1	CM
GCACCTTAGGTGAACC-1	CM
ATTGTCTGTATTTGCG-1	CM
TGACAACAGCGTAGCA-1	CM
GCAAAGGTCGGGAATG-1	CM
ATTCGTTAGTGCTAGG-1	CM
GTACTTTCATGGAGGT-1	CM
GCCAGCATCTCCTTGG-1	CM
GGTTGCGAGTCAACTC-1	CM
AAATGAGGTGCCCTAG-1	CM
TCACTCGAGCCCATGC-1	CM
AAAGGGCCAAAGGCCA-1	CM
TGAATCGAGAGTTTGA-1	CM
CCAATGAAGGATTAAC-1	CM
TCGATTTAGAGCTACG-1	CM
GTAGACTAGGCAGTAC-1	CM
ACAAGCTAGAGAATTC-1	CM
ACTACGACAATTCAGC-1	CM
TAGGAGGAGACTCGGA-1	CM
CTTAATCAGGATGCCA-1	CM
GCGGGTTAGTGTTCCA-1	CM
GAACGTTTCCGGGCAT-1	CM
TTGACGACATAGACGG-1	Fib
ATTACTCCAACTCGAT-1	CM
CAACGTACAGCAATGG-1	CM
AATGTCGTCCACACCT-1	CM
GGGACCTTCTGATCTT-1	CM
TCTATTGTCTCTTCCT-1	CM
CTCTACGCAAGGAGGG-1	CM
ACCAAACGTAATGTAG-1	CM
GCAGATTTCCGGAAAG-1	CM
GTAATCGAGCGCCTAC-1	CM
GGCACGTTCTTGGCCT-1	CM
CGAGTTAAGAGAAGCA-1	CM
CCTGGGATCCTAAGTG-1	CM
GCATTCCCACCATTCC-1	CM
CTTTGCGGTACCCATA-1	CM
GTACTTTAGCTCGTTA-1	CM
CATGTTTGTCAACTGT-1	Fib
CCGCATTAGTCAGGAC-1	CM
CCAGAATCACGCTAAT-1	CM
TTAGCTTGTAGAGAGA-1	CM
TTGACGAAGTTGCTTG-1	CM
CGCGCAAAGGCGATTG-1	CM
ACCGGGTCATTGCACA-1	CM
GCACCTTGTCAGGTGA-1	CM
TTGTCTAGTATTCTGG-1	CM
GCCAGACTCGATTACG-1	Fib
GATCGTATCCGGACTG-1	Fib
GGAACCCAGGTCGGTA-1	CM
GATGGCCTCGTCGCAG-1	CM
TGACTCCCATCGGCCA-1	CM
TGCTTTATCGTGGCGT-1	CM
CCATACCTCGGTTAGT-1	CM
TCTATTGAGGTTCGAG-1	CM
TTACGTTAGATATGTG-1	CM
AGATAGAGTCATGAGG-1	CM
TTGTTGTTCCATTGAG-1	CM
ACCGAATAGCTAACAA-1	CM
TGTGTCCAGTTATGAG-1	CM
CAAGCTAGTGAGGTCA-1	CM
TCGCCTACAGCAACAG-1	CM
CCGTAGGTCCGGACTG-1	CM
ATCCAGACAGGGCTTC-1	CM
TAGCGGCAGACGCCCT-1	CM
GTGTGATGTAGATTAG-1	CM
TCGCAGGCAACATAAG-1	CM
TGTAAGCAGCAGAATT-1	CM
GCGGTGTCAACGTCCG-1	CM
TTGCCCAGTTTGGATC-1	CM
GAAGTCTCAAAGGTCG-1	CM
TCACCACGTGAATGGC-1	CM
GAACCGCTCTATCCTA-1	CM
AAAGATGTCTCCTTGG-1	Fib
GCACGGTTCACTCCCA-1	CM
CTCTAGCTCGCTATTT-1	CM
TCGATTTGTTTAGGAA-1	CM
AACAGTCGTCCCGTGA-1	CM
TCAAGACTCGGATAAA-1	CM
GAATCTGCATCCCAAA-1	CM
GCAAAGGCAACGTCGC-1	Endo
TTGTCTATCCTGACCT-1	CM
CTTCTAACAGTAACCT-1	CM
GAACGTTAGCTCCGGT-1	CM
CCTTGCAAGAGATTAC-1	CM
GTGGATTTCCGCCTAT-1	CM
CTGCGTTCATAGAATG-1	CM
AGCCGCAGTCATAGAA-1	Fib
GGCATTAAGTCCAGAG-1	CM
GATCATGCAGTCAGAG-1	CM
GGGTTATGTAGATTAG-1	CM
TTGACGATCGGTCTAA-1	CM
TAGCATGCATTCTCGC-1	CM
ATCCTCGAGAGATTAC-1	CM
ATTGTGGGTCACAGTT-1	CM
TTCTAACGTGCCAAGA-1	CM
AGGCGTCGTGAAACAT-1	CM
GCCAGACCATGTCCCT-1	CM
AATGCCACACCTCGTT-1	CM
TGGACATTCGAACACT-1	CM
TGCTTTACAAGTAATG-1	CM
CTTGCTGCAAAGAAGG-1	CM
CTACAGACATTCGTCC-1	CM
TTAGCTTGTGAAACAT-1	CM
GAAATGACACCTGGTG-1	CM
AGATTCGGTACGGAGT-1	CM
CACGTTCAGAAGGGCG-1	CM
ACTACGACACGTTACA-1	CM
TCTATTGAGCCCATTA-1	Fib
AGCTGATTCGGTAGGA-1	CM
GATCATGAGAACGCCA-1	CM
CTACTTAAGGGTTCCC-1	CM
ATGGATCTCCAGTTAG-1	CM
CACCTTGGTTTGATCG-1	CM
ATTGTCTCATATAGAG-1	CM
TGTGACAAGGGTTCCC-1	CM
CACCTGTTCCTGGGAC-1	CM
GAACTTGTCCTCCATG-1	CM
GAAGTCTGTAAGCCGA-1	CM
GCTTAAGAGGTTCGTT-1	Myeloid
TTACCCGAGGGTGTTG-1	Fib
GTAGGAGGTCTGGGAA-1	Fib
GATGGCCAGGCAAGCT-1	CM
AGTCAACAGGGAGATA-1	CM
TAGGAGGCATGGATGG-1	CM
TCTATTGAGAAAGCAG-1	CM
CCGCATTAGTTGACAA-1	CM
TGTGTCCGTCAATACC-1	CM
CACCTGTTCTAGCAAC-1	CM
GCGAGAAAGTACCACT-1	Neuronal
TAACAGCCATTGTGAC-1	CM
GTCACTCTCTCTGCAC-1	CM
CTTGAAGTCCTCCATG-1	CM
CACTGAAGTCAGGTGA-1	CM
TACCCTGTCGTCCCAT-1	CM
AGCCTGGCAAGACTAA-1	CM
GCTCGAGCACTGTTAG-1	Fib
GCCCGAACATTGCACA-1	Fib
TTTACGTCAGCCACGT-1	CM
TAGCACAGTTACCACA-1	CM
TTGTCTAAGCGATACG-1	CM
ACATGGTTCGCTGATA-1	CM
GGTGAAGTCCGTGCGA-1	CM
TGAGTCACACGCTCAG-1	CM
GCACGCAGTTTAGAAG-1	CM
GGAGTAGAGACACTTC-1	Fib
GGTACCGGTGTCCCAG-1	CM
CTTAATCTCCATCTAT-1	CM
ACGGATTAGGTCTTGT-1	CM
GTGCACGTCCGGGCAT-1	CM
AACCTTTGTGCGTCCA-1	CM
GTCCATCAGCCGCAAA-1	CM
TTACCGCCAAGACTAA-1	Fib
TGATCAGAGGTGAACC-1	CM
CCCAGAGCATATTGGC-1	CM
AACAAAGAGTAGGAAG-1	CM
ATTGTGGTCGGTCAGC-1	CM
CGTAAACAGTTGAATG-1	CM
TAACAGCTCCGCTCTA-1	CM
CGCAATACACCGAATT-1	Fib
AGCCTTCGTCGATTAC-1	CM
CTACTTACAGTTAAAG-1	CM
TTAGCTTAGGATTGAT-1	CM
TTAGGTGTCCCGATTC-1	CM
GCTGTTCTCGGGCTCA-1	Fib
CTTGCCATCGATCTTT-1	CM
GGGACCTTCATTCGGA-1	Fib
ACTCGGGTCAGCCGGT-1	CM
TTCTAACAGTGAATAC-1	CM
GACCAATCAAGCGGTA-1	CM
GAACCGCCACGCTAAT-1	CM
TCTCTGGTCCCAATGA-1	CM
GAGAACGGTGACCAGA-1	CM
AGCCTTCTCGGATCGC-1	Fib
TTCTGTAAGGCCAATG-1	CM
TTACCCGTCCCGTATC-1	CM
TGATCAGTCGTGGTAT-1	CM
TTTGGCCTCGGTACTA-1	Myeloid
GGATGAGAGGAAGACA-1	CM
GACTAACGTTATGCAC-1	Fib
GTAATCGAGCGTCTGC-1	CM
CCCTCTCTCGGTCCGA-1	CM
GCCAGCAGTGTCGTGC-1	CM
ATTTGTCTCTATATCC-1	Fib
ACCCAAATCCCTAAAG-1	CM
TGCGTAAGTCTAAAGA-1	CM
TACCCTGTCCACTAGA-1	CM
CCCACATCAATGGTCT-1	Myeloid
TAGCACACAAGCGACA-1	Myeloid
GAAGTCTAGTAACATG-1	CM
GCTCACTCACTACACA-1	CM
ACATGCAAGCTGCTCG-1	CM
TTTACGTAGAGGTGGG-1	CM
CAGTGCGTCTATAGGC-1	CM
CTTCTAACAACGTCCG-1	CM
TGGTCAAGTTCAGTTG-1	CM
ACCAAACGTGTCCAGC-1	CM
TGGGTTAAGCTGAATA-1	CM
TATCTGTAGGTTGTGG-1	CM
GGCGTTGCATTACTCT-1	CM
ACTACCCAGCCATGGA-1	CM
GTAGTACCACAAACGG-1	CM
CCCTAGTCATGATTGC-1	CM
GCGTAGCCACTGGGCT-1	CM
GGGACCTAGATGCGAC-1	CM
TGGCGCATCTGGTACA-1	CM
ACTGCGGTCAGATACC-1	CM
CTCTCAGCACAGGTAG-1	CM
CAATCCCTCCGAATTG-1	CM
CAAGCTACAGCTGATT-1	Fib
TAGGTGTTCTGGACAT-1	CM
GCATTCCCATAGTCCA-1	CM
TGGGTTAGTACGGAGT-1	CM
CTCGCTACACTCAGCG-1	CM
TGATGCATCTCTATCA-1	CM
TGCACCTTCGACTTAG-1	CM
ACGTGGCTCTCTTCCT-1	CM
CATTGGACATAGATAG-1	CM
GCCAGACTCAATGCAC-1	CM
TACGCAAAGCCCATTA-1	CM
TTGCCCAAGTCACACT-1	CM
CCTTAATAGCGCACAA-1	Fib
CGCACAGGTCATAGCT-1	CM
TGGGTGCCACCGATCG-1	CM
TGACAACTCGCTATAG-1	CM
TTACTCACAACGGACA-1	CM
GTTATTCAGGTTCTCA-1	CM
CCCACATGTAAACGGC-1	Fib
CGCTATCGTTACTTTC-1	CM
GTCACCTTCGGGCTCA-1	CM
CATTCATGTTCAGTAC-1	CM
GGAACTTCAGTTGCAT-1	CM
TGTGTCCTCTACCCGT-1	CM
GGAATCTCAAGCTTTG-1	CM
TCGATTTAGGATTGCG-1	CM
TCAAGGTTCGAAGCCC-1	CM
CTTGCTGTCTATAGGC-1	CM
CGTAAACTCCATTGTT-1	CM
TCAGGGCAGTCATCTG-1	Fib
GAGCATTTCCTCCAGT-1	CM
ACCAAACCATGATTGC-1	CM
GCCAGACAGGAAGGTA-1	CM
GCTCCTATCACGATTG-1	CM
CCCTCTCTCTTTCGAT-1	Fib
TATTGCTGTAACTCCA-1	CM
TATCGAGGTAGCCATT-1	CM
GCGATCGGTTGGCTAT-1	CM
ACCAAACTCACTCCCA-1	CM
GCTGCGAGTCGCGCTA-1	CM
GTCGTAAAGGGACGTT-1	CM
TGTACAGTCGATCGCG-1	Fib
CTCTCGATCCGCGATG-1	Endo
CGTACAAAGATGTTCC-1	CM
AATGGCTGTAAACCCT-1	Fib
TCAAGCACATGCCCTT-1	CM
CAAGAAACAAGATGCG-1	CM
GGGTGTCGTCCACCAG-1	CM
TAGTCCCCAAACCTAC-1	CM
CATAACGGTAACGGCA-1	Fib
AAACTGCTCACTGATG-1	CM
GAGAACGGTGTAGGAC-1	CM
AACAGTCTCCCAGCAG-1	CM
ACATGCAAGAATATCG-1	CM
ACTCGGGCAGAAAGAG-1	Endo
CAAAGCTTCGTGATAC-1	CM
TGTAGCAGTTCAGTAC-1	CM
GGTAGGATCTCTGCAC-1	Fib
TTCTGTACATGGGTGA-1	CM
AGTGCCGAGTACGCGA-1	CM
AGCCTTCGTTTGCATG-1	CM
GCGGTGTGTTCAGAAA-1	CM
AGTCAACAGTCGAAAT-1	CM
TTTGCGCTCGGTAGGA-1	CM
ACTCGGGAGCGAGAAA-1	CM
CCCGTTACAATGTAAG-1	CM
TTAGGTGGTGGACCAA-1	Fib
GATGATCGTGGAGTGT-1	Fib
GCCTACTAGAGAGTTT-1	Fib
ATTCGTTTCAGGTCTA-1	CM
TTCGCGTGTGGATTCT-1	Fib
GATCATGAGTGCACAG-1	Fib
CAGCTAAAGGGAAGCG-1	Fib
ACAGGCCCAGTTGCAT-1	Fib
TGGCAATCAAGCGACA-1	CM
TAACTTCCATCGGCCA-1	CM
TGCTTCGAGGTACACG-1	Fib
GGTAGGATCCGGGCAT-1	CM
CTACAGAGTTTGCCCT-1	CM
TACCTATAGACTCGGA-1	CM
AACTGTGCAACGTACT-1	CM
GCTGTTCGTCAAGACG-1	CM
GAACCTAGTCCAAGAG-1	Fib
TTCAACTCATTCACGA-1	CM
TGTAGCATCTGATCCC-1	CM
TTCAACTTCGTGGCGT-1	CM
CTTTGCGAGCATACCT-1	CM
TCGCCTAAGGCCAGTA-1	CM
GTTATGGGTTCTACCC-1	CM
TGGTCCTCAGGCATCC-1	Fib
GTCACTCTCCTTGACC-1	CM
CCTATTAAGCCATGGA-1	CM
AGTCAACGTCAGCAAG-1	CM
AATGTCGCACCACAGC-1	CM
GCCAGACGTCTGGATT-1	CM
AACTGGTTCTGGGCGT-1	CM
CGGACTGGTTACGAAA-1	CM
GCACGCATCTGGCACG-1	CM
GTGACATAGTGAAGGA-1	CM
TGCTTCGTCCAGGCCA-1	CM
TTCTGTATCCCGAAGC-1	CM
ACAGACTGTAACCGAG-1	CM
AGCTATGCAATGAAAC-1	CM
CACTGAACAATTGTGC-1	Endo
ATTCGTTGTAGTGATA-1	Myeloid
GCTCACTTCGAGAAGC-1	CM
GCTTAAGAGGCACTAG-1	CM
TCTCAGCTCCAGGCCA-1	CM
CTAGCGGGTTCACGTA-1	CM
CACAACAAGGGCTCTC-1	Myeloid
AGTGCCGGTCTGCGCA-1	CM
TAGCCGGTCAAACCAC-1	CM
AAATGCCTCTCTGCAC-1	CM
ACTAGGTTCCAAGAGG-1	CM
CACTAAGAGTGATATG-1	CM
GGAGAACTCATCGCCT-1	CM
GCTTAAGCAGGAGCAT-1	CM
GCTTTCGTCGATTACG-1	CM
AGCCCGAAGTTCCAGT-1	Fib
TCAAGACGTATGCTAC-1	Fib
TAGGTGTCAGTTGCAT-1	CM
CGCACAGAGTCGATAA-1	Fib
GGCACGTGTTCACGTA-1	CM
GAGCGCTTCCCAATGA-1	CM
GACTAGTCAGATACAA-1	Fib
GAGCGCTAGGCCTAAG-1	CM
ACTATTCGTTATAGAG-1	CM
TCCCACACACACACCG-1	CM
GTTATTCCAAGCGACA-1	CM
ACCGCAGTCGGTCTCT-1	CM
TAATCGGTCGCTACCT-1	CM
GTGGCGTGTATTCTTC-1	CM
AACTGTGTCGTTGTTT-1	CM
CCAGATAGTGATAAGT-1	CM
TCAAGGTCAAGAAACT-1	CM
TTGAGTGGTCCTTATT-1	CM
GTAGTACCAACGCAAG-1	Endo
CTGAATGAGTACAACA-1	CM
AGCCTGGTCACCGCGA-1	CM
TCGGGACAGAAGAGTG-1	Fib
CATGTTTCAGGGTACA-1	CM
ACTAGGTAGGCAGATC-1	CM
CAGCTGGAGCTTTCCC-1	CM
ATGTACGGTCAACGGA-1	CM
ACTGTCCCAATCAGGG-1	CM
TGGAAGGAGGTTGACG-1	Neuronal
AGCTGGCCAATGTAAG-1	CM
ACCAAACGTTCACGTA-1	Myeloid
TGGACATAGCATGTGG-1	CM
CAGGATTGTAACATAG-1	CM
CCGTGAGTCCATATCT-1	CM
TTTGAGGTCATTGCCC-1	CM
GGAACTTCAAGGGTAC-1	Fib
GCCCAGAAGGAGAACA-1	CM
ACAATCGCACACATTG-1	CM
TACGCAAAGGCTGGAT-1	CM
GAAATGAGTTCCGCGA-1	CM
AGCTGGCAGTTCAGGG-1	Neuronal
GCGTTGGGTGTGAGGT-1	CM
TCGAGCGTCCAACAAC-1	CM
AAACTGCTCTTAATCC-1	CM
AGCTATGCATATTGGC-1	CM
TTCATCATCCAATAGC-1	CM
TTACCGCCACAGTAGG-1	CM
GGGTCTGTCCAGTTAG-1	CM
CCTTGGTGTGGTACTT-1	CM
TACCTATAGCCGCAAA-1	Fib
AGGCCCACAGTAAGCG-1	CM
TACATTCCATCAGCTA-1	CM
GCTGTTCTCGTAGCGC-1	CM
GAAAGTAGTATCACAC-1	CM
TCTCTGGCATGCGTTA-1	Fib
ATAGTCGGTCAAATCC-1	CM
GCTCCTAGTTAAGTCC-1	CM
GACCAATCAGTTGGAG-1	CM
ACTTTCAGTTACGGAG-1	CM
TAGCCCTCATTACACG-1	Fib
AGCGTATGTCATCAAC-1	CM
CGCTGGACATGGTAAA-1	CM
CAAGCTAGTGGTTCTA-1	CM
TGCTCGTCATCAACTG-1	CM
GGTGCTGAGAAATGGG-1	CM
ATCCCTGCAAGTTGCT-1	CM
ACTTCCGCAATTCTCT-1	CM
GTAGACTGTGCGCTCA-1	CM
GCAGATTAGAGCGGTT-1	CM
ACATGGTTCCACGAGC-1	CM
GATTGACTCAAGAGAT-1	Fib
TAATCGGCAGATAAGT-1	CM
ACTACGAAGACACAAT-1	CM
TTCGCGTGTCCGCTTT-1	Fib
AATGGCTGTCTGGGAA-1	CM
TTTGTGTCACCGAAAG-1	Fib
ACATGCAGTCCCTAAA-1	CM
TGATGCAAGGCAGTAC-1	Fib
CTGGGACCACCAAGGA-1	CM
TCCGACTCAATCACTG-1	CM
TTCGTTAGTGATTCCA-1	CM
AGCGATTGTAAACGGC-1	Myeloid
AAACGAAAGCAACGGT-1	CM
GTGTCAACATGGCCTG-1	Fib
ACAAGCTCACTCCACT-1	CM
CATGTTTAGTAATGTG-1	CM
TACGCAAGTAGCGTTT-1	CM
GGATAGGTCGCCGAAC-1	CM
CCGTACTAGTCGAAAT-1	CM
GGTGTCGTCAATTGGC-1	Fib
GCATTGAAGTGGGACT-1	CM
TCAGGTATCGTGGTAT-1	CM
GCGGAAAGTGATAACA-1	CM
TAAGTGCAGAAATACC-1	CM
CTTCTAATCGCCACTT-1	CM
ACAGGCCCATTTAGGC-1	CM
GTTATGGTCCTCCCAA-1	CM
AAATGCCCAGGCATTT-1	CM
TCGCAGGCATCCATAG-1	Fib
ATTACCTCACTAAACC-1	CM
TCACCACTCTTCGTTA-1	CM
TTACTCATCGCTAGTA-1	CM
TTACTCACACCTGAAT-1	Fib
ACCTGCTTCGGAGTTT-1	Fib
CGGTGCATCCAACAAC-1	CM
CCACAGGTCAGGGTTT-1	CM
GATTAGCTCCCAGTAA-1	CM
GAAACAAGTGATAACA-1	CM
GGAACCCAGTCCTTCC-1	Endo
TGCTTCGAGCCATGGA-1	Myeloid
AAACTCGTCACGATTG-1	CM
ACAGAAACACATGATC-1	CM
CCAGATAAGAGAGTAG-1	CM
TCGTTCGGTAATGCAA-1	CM
CCACGTTCATTGCCTC-1	CM
CTCTAGCAGTGCAACG-1	CM
CAAGCTATCTTGTCGC-1	CM
TGTAAGCCAGAACAGC-1	CM
GCGATTAAGGGTTCTT-1	CM
GTTATTCAGATCGAGC-1	CM
TTTGGTTAGTAATGTG-1	CM
GATTAGCTCCAATAGC-1	CM
GAAGTCTAGGCAAGCT-1	CM
CTGCTCAGTCAATACC-1	CM
GGTACCGTCTCGTAGA-1	Endo
GGAGTAGCACACACAT-1	CM
CTTGCCAGTCCAAGTT-1	CM
GGTAGGAAGACGCCCT-1	CM
TGGCCTTCACCGTCTT-1	CM
GTGGCGTTCCACACCT-1	CM
GTGCCAGTCATTCTTG-1	CM
AACAGTCCATCTCTCG-1	Fib
GCAGATTCACACATTG-1	CM
GTGGATTAGAACGCCA-1	CM
AATGGAATCTCGTGAA-1	Endo
TGTTAGGGTGCCCGAT-1	CM
AACTTGGTCGCTTACC-1	CM
GCGAGAATCAGTGGTT-1	CM
GGAATCTAGAGATTAC-1	Fib
TGTGACAGTTAACTCG-1	CM
CTCATGCTCCAGGCCA-1	CM
TCTAGTTCACTGATAC-1	CM
CTCCCAATCAGTCTTT-1	CM
TCGATTTAGCTGAGGT-1	CM
GCGGAAATCCCAATGA-1	CM
TCGGGACCAGGTCCTG-1	CM
AAATGCCCATTGTGAC-1	Myeloid
TGCTTTATCCCAATGA-1	CM
CGCTGGAAGAGCAGCT-1	CM
TGCCTGTTCCAGGGAA-1	CM
ATGTCTTGTAAGGTCG-1	Fib
TACATGGTCAGAACGG-1	Fib
CCAGAATGTCCAACCG-1	CM
TACGGATCACTAGGAG-1	CM
GCCCAGACATTCCCGT-1	CM
GTGGATTAGCAACGGT-1	Fib
CAAGCTAAGTACAGAT-1	CM
AATGCCATCATTCTTG-1	CM
ACCGCAGCAAGAGCGT-1	Fib
CAGCTGGGTAAACGTA-1	CM
CGGACCAAGACTCGGA-1	CM
TACATTCGTCACAGTT-1	CM
TCACAGATCGTGGTAT-1	CM
AGATTCGCATCATGTG-1	CM
CACATGAGTTCTACCC-1	CM
AACTGTGAGTAATCAG-1	Fib
CCTGCTAGTTCCGGCA-1	CM
GCGGAAACAGGTGTCC-1	CM
TACATTCGTAGAAGCC-1	Fib
TGATCAGAGGTTTCTG-1	CM
CAGCTGGTCGTCTAGA-1	CM
TTACGTTAGAGAGTAG-1	CM
CCAGATATCTCTCAAT-1	CM
GAAACAAGTAGTAACA-1	CM
CCCTAGTTCGTTCAGA-1	CM
AACCTGAAGTTAGCAA-1	CM
GCACCTTGTACCAAGG-1	CM
AACAGTCTCGACTGGC-1	CM
ACTACCCCAAGGGTAC-1	Fib
CTCAACCAGGCCAATG-1	Fib
AACGGGATCTGCTACC-1	Fib
AAGGAGCAGTTCAGGG-1	CM
CCGCATTTCCATACGA-1	CM
AGCTGATCAGTAACTC-1	Fib
GCTGTTCAGGGAAGCG-1	CM
GGAGAACGTTCTGATG-1	CM
CACAGATTCTGGCGCA-1	CM
AAATGAGGTGCATTCA-1	CM
TGACTCCGTGCAAGAC-1	CM
TTGACGACACATTGCA-1	CM
AGCTGATAGATTAGAC-1	Fib
TCTCAGCGTACGTAAA-1	CM
TCGCAGGGTACGAGAC-1	Fib
ACGTTAGGTTGGCTAT-1	CM
GTGTGATCATTAGCAC-1	CM
CCTCCCTTCTTACCTA-1	Fib
GGTTGCGTCAAAGTAG-1	Fib
CTTGTCGGTCTCTAAG-1	Fib
TAAACCGTCCGCGATG-1	CM
AGACAAATCCAGCACG-1	CM
TACTAGGGTTAGCTCA-1	CM
GGGACCTAGAACAGGA-1	CM
CTGTATTCATGTGGGA-1	CM
CGTAAACCAAGCCAGA-1	CM
TGCTCGTAGAGGCGGA-1	Fib
TAACGGTGTATGGTTC-1	CM
CCGAAGCCAGCGTCGT-1	Fib
TGGCCTTTCCACCTAC-1	CM
TAGCCCTTCTGTCGGG-1	Fib
CGTGGCACATTCACGA-1	Myeloid
CTAACTTAGAGAGTAG-1	CM
TCACCTGCAAACTACC-1	CM
TTCGTTAAGGGAGTTC-1	CM
CACTGAATCCAGTTAG-1	CM
CGAGTTACAACTCCCT-1	Fib
AAATGAGCATCACAGT-1	CM
AACGAGGAGGCGATTG-1	Fib
GCGGAAACAGCCACGT-1	Fib
GTGGATTTCGAGGCTC-1	CM
TAAACCGAGTCTTAGC-1	CM
TTTGAGGAGTCTCCAA-1	CM
TCCATCGGTAACCGAG-1	CM
CTGCGTTGTACTATGC-1	CM
ACAATCGCAGAACTTC-1	CM
GGGACCTAGGAGGCGA-1	CM
GGTAGGAGTCAGAGTG-1	CM
TTGAGCAAGGCAATTA-1	CM
GCCTACTAGCTCCATA-1	CM
GAGGATGGTGGTGGTA-1	Myeloid
GTCACGGAGTCCGATT-1	Myeloid
AGCTATGCACCTATTT-1	CM
ATGTCGAGTGAAACAT-1	CM
TCAAGACGTGTCGTCG-1	Fib
TACATTCGTGACCAGA-1	Fib
GATGGCCTCCCTACGT-1	CM
TGATTTCAGATGTTGA-1	CM
CCCTAACAGTCTGCTA-1	CM
CGGACCAAGGCCAGTA-1	CM
TACTCGCGTTCCAGTA-1	CM
GGAATCTGTGCACATT-1	CM
GGTCATAAGTCCAGAG-1	CM
ACAAACCGTCTCTAAG-1	CM
CTCTCGAGTAACACTC-1	CM
GGTACCGAGGGTATCG-1	Fib
GTGATCATCCCGGGTA-1	CM
TGATGCACAGATACAA-1	CM
CCCTAACTCCGCCTAT-1	CM
AGGCGTCTCGGCTATA-1	CM
CGGACTGAGGGACGTT-1	CM
AGCCTCTAGTACTCTG-1	CM
ATCGAGTCAGCGTGAA-1	CM
GCTTTCGGTAAGGTCG-1	CM
TACGGATAGCGATACG-1	CM
GCTGAGCCAAGATTAG-1	CM
AGTCCGGTCTGTTGCC-1	CM
ACTCGGGCATGGGAAC-1	CM
CTTGCCACATCCGTGG-1	CM
ATGTCGATCCGTCAAA-1	CM
TTGCGGGAGCGAGAAA-1	CM
GGAGAACAGTATACGA-1	CM
TCTATTGTCAGAACGG-1	CM
GCACCTTGTCCGGTAC-1	CM
TATGTTCAGGCAGTAC-1	CM
TCGTTCGCAAGGTCGA-1	Myeloid
CGTGGCATCACTTACT-1	CM
ACATGCAAGTGTTCCA-1	CM
GTGACATAGTTCAAGA-1	CM
GTGACATAGAACTAAC-1	CM
CACCTGTAGGCAGTGT-1	Fib
TTACTTGAGGCGACTA-1	CM
AACCTTTTCTGTGTGA-1	CM
AGATTCGCATTCTCGC-1	CM
CAGCTAAAGACACAAT-1	Fib
AGTTACGGTACGCAAG-1	CM
GCTCCTACAAGGGAGG-1	CM
TAGCGGCGTTCAGTAC-1	Neuronal
GTGTCCTCACATCATG-1	CM
TACCTCGGTGCACATT-1	CM
TTACGTTAGTTAGCAA-1	CM
GCCATAATCAGTCAAC-1	CM
AGGCGTCAGACGACTG-1	CM
GCTGAGCCATTCTCGC-1	CM
TTATGTCAGCCGCAAA-1	Endo
CGGTGCAAGATATGTG-1	Myeloid
TAATTCCGTGTGAGGT-1	Fib
TCACAGAGTATTCTGG-1	CM
TACGCCTCACGGCCAT-1	CM
ACAATCGTCGCGATGC-1	CM
TGTTAGGCATTGCACA-1	Fib
GAACTTGAGATCGAGC-1	CM
TTGCGGGAGGATTAAC-1	Fib
GAGCGCTTCCATCATT-1	CM
ATTGTCTCATGGTAAA-1	CM
TAAGCCAGTTAACTCG-1	CM
CCCACATAGTACCTCA-1	CM
CCTGGGAAGGCTGGAT-1	CM
CATAACGTCAAGAGAT-1	Fib
TTGGTCCGTCACTCTC-1	CM
AACTTGGCATCGTACA-1	CM
TAGCCCTCAGTCCTGG-1	CM
ACTACCCTCGATGCAT-1	Fib
TCGATTTGTGGACAGT-1	Fib
GGCATTACAACGTCCG-1	CM
TTCATCAAGCTGCTCG-1	Fib
GATTAGCAGTTACCAC-1	Myeloid
AGCTGTAGTCCAAGTT-1	CM
TCGGGACTCTATCTCA-1	CM
GCATTGATCGGTCTAA-1	CM
ACATGGTTCCATCTAT-1	CM
TCAGGGCCATCATCGA-1	CM
GACCCAGTCTAGCAGT-1	CM
AATGTCGAGGGTAATT-1	Fib
CTCACCATCGACTGGC-1	CM
GCGCCAAAGGAGGCGA-1	Fib
TCCGACTAGGTTGTGG-1	CM
ACTATTCAGTTCAACC-1	CM
TTGTCTACACCAAGGA-1	CM
GTTGGTATCTTCGTTA-1	CM
ACCATCCCAGGGTACA-1	CM
TCAGGTAAGTGAAGGA-1	CM
TTCATCACACTGCTTC-1	Endo
CCTTGGTTCATTCTTG-1	CM
TATGTTCAGGTTACAA-1	CM
CAGCCTTGTGGCCTCA-1	CM
GCGCATGCAGAGTCGA-1	Fib
TACCCTGCACCCTTAC-1	CM
GCACGCAGTAGGTAAT-1	CM
CTAGGGCGTGACCAGA-1	Fib
CTCATGCTCGACCCGA-1	CM
GTAGACTTCTCGACCT-1	CM
GCGCCAAGTGCAAAGC-1	Fib
TAGCGGCGTTCTTTCA-1	Fib
ACAGAAATCGAGGTAG-1	CM
TGACAACAGCGCAATG-1	Endo
CTCGCTAAGCTGATTC-1	CM
TGGAAGGCAGGCATTT-1	CM
ATGCATGGTACAAATG-1	CM
TTGCTATAGTGTAATG-1	CM
CAGCTGGTCCACGAGC-1	CM
TTAACGGAGTGGACGT-1	CM
AGTGCCGGTTTCACCC-1	CM
GCTGAGCCATTTCACT-1	CM
ACAAAGAGTGCTGGCT-1	Fib
CAGGGCTTCCAGTTAG-1	CM
GTCGTAAGTCAACAGG-1	Fib
TGACTCCAGCCATCAT-1	CM
CTTCCAGCATGTCCCT-1	CM
TTACGTTGTATATGGA-1	CM
ACTGCGGCACATATCG-1	Fib
TGCCTCACAATGGCTT-1	CM
GATGATCGTCCAAGTT-1	CM
TGGTCCTCAACTACTG-1	CM
GAGGTCCCATATACGC-1	CM
GGCGAAAAGTCCGATT-1	CM
ATTTGTCGTACTATGC-1	CM
CTGTATTGTGCAAGCA-1	Fib
AACCTGAGTCACCGCA-1	CM
ATAGGCTGTATCACAC-1	CM
TGGTCAAGTAACACTC-1	CM
CTGTATTCAGAACGAC-1	CM
TGTAAGCTCTCTGAGA-1	Myeloid
CAGCTAAAGCTCGGCT-1	CM
CGGACTGCACTGTTAG-1	CM
AACCAACGTTCAGTAC-1	CM
TCGCAGGCAGGCTACC-1	CM
TTGCTATGTACGTAAA-1	CM
GGTACCGAGTAGGAAG-1	Myeloid
TACCCTGTCGCCCTTA-1	Fib
GCAGCTGGTCTGGTTA-1	CM
AGCTGTATCTCGTGAA-1	CM
TAGCATGTCGAACCGC-1	CM
TTGACGAAGTCAGGAC-1	CM
CTCAACCAGGGATCCA-1	CM
CTTTGCGGTGTCGTGC-1	CM
TTAGCTTCACATTGCA-1	CM
GGCATTACAATAGCGG-1	Fib
AACTGTGTCCAAGAGG-1	CM
GCGCATGAGTAGTCGG-1	CM
TAACGGTAGTCGGGAT-1	Fib
CTCATGCCAAATGTCC-1	CM
TGATTTCTCGGCAATT-1	CM
GACTAACTCGCCACTT-1	CM
TTCTAACAGTGCAACG-1	Fib
TGAGCCGGTGGTACTT-1	Fib
GCATTGAGTGTTAGAA-1	CM
GAGCATTTCGCTATAG-1	Endo
CCGAAGCGTATTCTCT-1	CM
ACCTGCTAGAGGTGGG-1	Fib
AACCGATAGACTAGCG-1	Fib
TCTAGTTAGAGCCTGA-1	CM
GCGCATGTCAGGAATA-1	CM
AACGGGAAGAGTCCGA-1	CM
TGCTATTGTGGTACTT-1	CM
TCGATTTTCACTAGGT-1	CM
GCATGATTCAGGAATA-1	CM
CTCACCAAGTGTGTAA-1	CM
AGGCCCAAGGCCTCTG-1	CM
TGCCTCAAGAAGCCTG-1	CM
AACGGGAAGTATACGA-1	Myeloid
TTGTTGTTCAGAATGA-1	CM
TGAGCCGGTTATAGAG-1	CM
CCAATGATCCGTCAAA-1	Myeloid
GGGACCTCACTGTCAA-1	CM
GGTGCTGCACCGAATT-1	Fib
TTTGGTTAGTGATCTC-1	CM
TTAGCGACATAGCCAT-1	Fib
GCTTTCGAGGTGTCGA-1	Fib
TGAATCGGTAGAAGCC-1	CM
CTACTTACAACGTACT-1	CM
GTGTCAAAGATAGGTT-1	CM
TTGAGTGGTCGAGAAC-1	Myeloid
ATGTCGATCGCTTGAA-1	CM
TCAGTCCTCTTAAGCG-1	Fib
GTTATGGAGTGCTGAG-1	CM
CGTGGCATCTTTCGAT-1	CM
AATACGCCAACGCAAG-1	Myeloid
CTGTATTCAGATACAA-1	CM
GCGATCGAGAGGCAGG-1	CM
TAGCTTTCAGCTTACA-1	CM
GACCCAGGTAGAACGC-1	CM
AAATGCCGTTTAAGGA-1	Fib
CGTGGCAAGTGCACAG-1	CM
TACCCTGAGCTTACCA-1	CM
AAACTGCCAGTGCGAA-1	CM
AGACAAATCCCACGGA-1	Fib
AGATAGACAGAGTCGA-1	CM
CACCTGTGTTGTCGGC-1	CM
AATGGAAGTGTCCTTC-1	CM
TTGGTCCAGAGAGTAG-1	CM
AAACTCGTCACATCCC-1	CM
CAGCTGGCATTACACG-1	CM
GAACTTGGTTTCACCC-1	Fib
TCGCAGGAGTCATCTG-1	CM
TAATCGGTCCGGGCAT-1	CM
GACCTTCCACGCGTTG-1	CM
GAACGTTTCAAGAGGC-1	CM
GAAACAATCGCTAGTA-1	Fib
GGTTGCGTCTATATCC-1	CM
AGACAAATCCCACTAC-1	Fib
ATTTGTCTCTGTGTCC-1	CM
GAAAGTATCTCTTCCT-1	CM
TGGACATAGTGAAGGA-1	CM
AAACTGCGTAAACGGC-1	Fib
CCGTAGGTCGTGCTTC-1	CM
CCGTACTGTTATCGAC-1	CM
CCGTAGGCAAGTCTGT-1	Fib
GCAGATTAGCATACCT-1	CM
GAACCTACACTTATGG-1	Fib
TTCTAACAGAGTTTGA-1	CM
CGCTATCGTAAGCCTT-1	CM
TCAAGGTAGAACCCGA-1	CM
GCACCTTTCGCTATTT-1	Fib
CTGCTCACATGCCTTC-1	CM
CACAACACATGCGCTG-1	CM
TGTAAGCAGATCGAGC-1	Fib
ACTAGGTAGCCTGTAT-1	Fib
GTAATCGCATTCTCGC-1	CM
GCCTACTAGTGAGCAC-1	CM
GAAAGTATCGGTCGAC-1	CM
TATCGAGGTGCGTCCA-1	CM
TCTAGTTGTCTGGATT-1	CM
CCGCATTAGTAACATG-1	Fib
TAGCCCTGTAACGGCA-1	CM
ATTACTCAGTCCCTCT-1	Fib
GGGTCTGCAAACCGAG-1	CM
TCACCACTCCATTGAG-1	CM
GAGACTTGTACGGAGT-1	Fib
TAGGTGTTCTAGCAGT-1	CM
GTGGCGTGTCCGGTAC-1	CM
CGTTCCAAGCCTATAC-1	vSMCs
CCTGGGAAGACTAGCG-1	CM
AACTGTGAGTACGCGA-1	CM
GATCATGCACTGTTAG-1	CM
GGAGGATAGAGTCCGA-1	CM
TCAATTCTCTACATCT-1	CM
TTTGTGTCAATAGTGA-1	CM
TAGCATGTCACGTGTA-1	CM
GCATGATCACAAGGGT-1	CM
TTTGCGCTCCGAGAGA-1	CM
GCTTGCTCATTCTCGC-1	CM
GCACCTTCATAGCCGC-1	CM
CGTTCCAAGTGAGTGC-1	Myeloid
TCGTTCGCACGCTAAT-1	CM
TAGACTGAGTATACCC-1	Fib
TCGATTTCAGGTAGGT-1	CM
ATTTGTCTCTCGACCT-1	CM
TTGCCCACACAGCTTA-1	CM
TTGTTGTCAGGATAGC-1	Fib
TTAGCGAGTTTCTACT-1	Fib
TTCATTGCAACGAGGT-1	CM
CATGTTTTCCTGTAGA-1	Fib
ACAATCGCAGGATAGC-1	Fib
GAGTGAGTCTTCCACG-1	Fib
TGGAAGGTCCGTACGG-1	Myeloid
CTTAATCAGCTCCGGT-1	Fib
TTACGTTGTATCTGCA-1	CM
CATTGGACAACTACTG-1	Fib
TAGACTGAGTCGCCTG-1	Fib
TCAATTCCACCAAGGA-1	Fib
AGTTTGGTCTTAAGCG-1	CM
GCTGTTCAGAGTAAGG-1	Myeloid
AGCCTTCTCAAATGGA-1	Fib
CAGGATTTCTGTGTGA-1	CM
ACTACCCAGTTTGGAA-1	Fib
ATAGTCGCAGATGGCA-1	CM
GACCAATGTATTCACG-1	Fib
GTGTGATAGGCTTAAA-1	CM
TCACCACAGGGCTCTC-1	CM
CAACCAAAGAGGTGGG-1	CM
CCCGTTAGTAACGGCA-1	CM
ATAGGCTTCGGTCAGC-1	Fib
TTCATTGTCCTGTAGA-1	CM
TAAACCGCACGCTCAG-1	Fib
ACCTGCTCAAGAGCGT-1	Fib
GTCACAATCACGATTG-1	Fib
GGAACTTGTTCAGAAA-1	Fib
GTTATTCTCGCGGCAT-1	CM
CGCTGGAAGGTCGTTT-1	Fib
CTGTATTCAGGTAGGT-1	CM
AGCCAGCAGTAGTGTA-1	CM
GGTCATAGTCCTCAGG-1	Fib
CACAACATCGTTCAGA-1	CM
TTGCGGGAGTGTAATG-1	Fib
AAAGATGTCGTTGTAG-1	CM
GTCACTCTCTCCTTAA-1	Fib
TGTAGCAGTCCAAGAG-1	CM
AGTGCGCTCTTAGTGG-1	CM
TAGCACAAGCTCCATA-1	CM
AACTGGTAGTGCTCGC-1	CM
AAATGCCCATAGATAG-1	Fib
TACTAGGCAATTGCCA-1	Fib
GATGGCCTCGGTCCGA-1	Fib
GCTCAGGGTAGAACGC-1	CM
TCACTCGAGACTCGGA-1	CM
GCAACCGAGGACTTTC-1	Fib
GAGGATGGTACGGAGT-1	Fib
ACTACGAAGGCGCTTC-1	CM
AACGTACTCACTACCC-1	Pericyte
TGCATTTCATGACTGT-1	CM
ACAAGCTTCAGTCAAC-1	CM
CTTCCAGTCATTCTCA-1	CM
ACAAACCTCCTGACCT-1	CM
GTTACTTCAAGACTAA-1	CM
TCACCACCAGTAGTCT-1	vSMCs
CTAACTTCATTGAACC-1	Fib
CGCAGGTAGACAACGC-1	CM
GACCTTCCAATTGTGC-1	CM
CGAGTTAGTGTGACCC-1	CM
GCAACCGTCGGATAGG-1	CM
GTACTTTCAGGAGCAT-1	CM
GCCCGAAAGGTTGTGG-1	CM
TTCATCAGTAATGCAA-1	CM
GCTGTTCTCGGTCTAA-1	CM
GTGCTGGCACTAGCCG-1	CM
CTGTATTGTTAGCTCA-1	CM
CTTGTCGCATGGAGGT-1	CM
AGCGTATAGTGAGTGC-1	CM
TGTTAGGTCGGCAATT-1	CM
GTGATCACAGGATAGC-1	Fib
TGCTATTGTCCCGTGA-1	CM
CGCGCAATCCCTACGT-1	CM
CAGCTAAGTTTAAGCC-1	CM
TGTACAGGTTATGCAC-1	CM
TTGTTGTAGGATTAAC-1	CM
GCTCACTGTATGTCCA-1	CM
GCCCGAACAAGCAATA-1	Myeloid
CACATGAAGTACGACG-1	CM
ACTTTCAGTATTCGAC-1	Fib
TTCAACTCAAGGAACC-1	CM
CTACAGACATTAGCCA-1	CM
TACTAGGAGGCTCAGA-1	CM
GGTTGCGAGAACGCCA-1	Fib
TCACTCGCAATGATGA-1	CM
AGTGCGCGTTTAGGAA-1	CM
TCCCACAGTATCGCGC-1	CM
GCTCCTATCAAGAGGC-1	CM
TCGGGACGTATTGTCG-1	Myeloid
GGTACCGCATAGACGG-1	CM
AGATAGATCGGGATCC-1	CM
CCCTCTCCACGCGCAT-1	CM
CACAGATTCATTCTCA-1	Myeloid
GCTTAAGTCCGTGCGA-1	CM
GAAGTGGAGCGTTGCC-1	Endo
CAGCTAAGTAGCCATT-1	CM
GATGATCGTCCTCAGG-1	Myeloid
CAGGATTGTCATAGAA-1	CM
CCTGGGACAGTAAGCG-1	CM
AGGCCCAAGCTTACCA-1	Fib
AGCGTATCATGGCCCA-1	Myeloid
ACATGGTCATTCACCC-1	Endo
TTAACGGAGATGCGAC-1	CM
TTACTCAGTGTAGGAC-1	Pericyte
ACATGGTCACCACGAC-1	Fib
CAGGATTAGGATCCTT-1	CM
TAATCGGAGAGGCCTA-1	CM
GAGGCTCCACAGTTAC-1	CM
CCGTAGGCATCATCGA-1	CM
CAGCTAACAGCGTAGA-1	CM
CTCCCAAGTGTCCCAG-1	CM
GGAACCCTCGTGATAC-1	Fib
CCGTAGGTCTCCACTG-1	Myeloid
GCTCGAGCACGATATC-1	CM
GACTAACAGACACTTC-1	CM
TTTGGCCCAGCAGGTA-1	CM
AGCTGGCTCCAGTTAG-1	CM
TCTATTGAGGCGACTA-1	CM
GGGAACAAGCTAGCAG-1	Fib
ACCCAAAAGCTACGTT-1	Fib
ATGTACGGTCATAGCT-1	CM
CGGTGCAAGTTATGAG-1	Endo
CTTGCTGCAACTACTG-1	Fib
CTCAGCTAGCTTTCCC-1	CM
GCCTAGGAGAACGTTA-1	CM
AATGGCTGTGATGCTT-1	CM
TTACTTGCAGAAGTGC-1	CM
GCACGCAAGAACAGGA-1	CM
TTACCGCGTTCCGGCA-1	Fib
TACCCTGTCTATATCC-1	Fib
CAGCTGGAGAAATCTG-1	Endo
ACGGATTCACAACGGA-1	CM
GGACACCTCCTCCATG-1	CM
ACAGGCCGTGTCCAGC-1	CM
AAAGGATTCTTACCTA-1	CM
AGGCGTCAGAGTTTGA-1	CM
ATCGAGTTCATGTTCT-1	Fib
ACTATTCAGGCCTAAG-1	CM
GAGAACGAGTTCAAGA-1	CM
TGCTATTAGAGCTCCC-1	CM
GTGCTGGAGCTCCATA-1	CM
AAACGAAAGGCTCCTG-1	CM
GCGTAGCCATTAACGC-1	CM
TGCCTGTCAGCTGATT-1	CM
TAGCACAGTAACGGAC-1	Fib
CAAGCTACAACGTCCG-1	CM
TACATTCTCGCCCTTA-1	Fib
ACAAGCTAGCCAGAAC-1	CM
CTCAGCTAGTGATCTC-1	CM
CCGTACTGTCCTTCAC-1	CM
GATCATGGTAGCGTTT-1	CM
TATTGCTGTGTCGTGC-1	CM
ATGTCTTGTAAGCCTT-1	Endo
TAGGTGTGTGCGCTCA-1	Fib
GAGCATTTCGCACCTT-1	Pericyte
AACAAAGTCATTCTCA-1	Fib
GCATGATGTAGATGAT-1	Myeloid
TGTGACAAGTAACTCC-1	CM
ACAGGCCGTACTTCGA-1	CM
GCTTTCGGTCAGGCTC-1	Fib
CACGTTCCAAGCGAAC-1	Endo
CCCGTTAAGTAACACA-1	Fib
TCACCTGGTAGCAGGT-1	Myeloid
CTAGGATTCCCAGCGA-1	CM
CAACGGCTCTCTATTG-1	Fib
CTTGCTGGTTTGAAGA-1	CM
TGGCCTTTCGCGGCAT-1	CM
CTAACTTAGGTGTTGG-1	CM
AAACGAACAGTAGTTC-1	CM
AGTCAACGTAGACGCA-1	CM
AGCCAGCCAATCACTG-1	CM
TGAGTCATCACCACAA-1	CM
TGATTTCAGGCGCTTC-1	Neuronal
ACTGCGGCAAGGTTCT-1	Myeloid
AGGCCCATCACTAGGT-1	CM
TACATTCCATCAACTG-1	CM
GCTCCTAGTTTGTCTT-1	CM
GCAGCTGAGTAGTTCC-1	CM
GTCACTCAGACGCCAA-1	CM
TATGTGGGTCGATAGG-1	Myeloid
GCCTAGGCAGTAGTTC-1	CM
GCGAGTCAGTCGACCC-1	vSMCs
GTAATCGTCGGTTCCT-1	CM
CTTCCAGAGTCTAGAA-1	CM
GCTCACTTCTACTGCC-1	CM
CTAGCGGGTGCTTCCT-1	Fib
ATAGTCGAGATATGAC-1	CM
TAAACCGCATCCCGGA-1	Endo
GCACGGTAGAGGTGGG-1	CM
GGGTGTCGTCTCTGGG-1	CM
GGAATCTCATGCGCTG-1	CM
GACCCAGGTCACAGGA-1	Fib
ACTCGGGCACAAGTGG-1	CM
AAATGCCCATAGTCCA-1	Myeloid
GTCACGGAGGAGTCTG-1	Fib
TCTCAGCCACAGCCAC-1	CM
TTACGTTTCCCAGCGA-1	CM
GGGTTATCAACGGACA-1	Fib
ATGCATGGTACCTATG-1	CM
TCCCACATCGGTTCCT-1	Fib
GTGTCCTAGTCCCTCT-1	CM
ATCCAGAGTCGTAGTT-1	Endo
AGCGTGCTCTTAACGG-1	Fib
ACTACGACACCTGGTG-1	CM
TAGGTCACACTGATAC-1	Fib
AGGCCCACAATGTAAG-1	Fib
GTAGTACAGTAGAAGG-1	Fib
TGAGCCGCAACTCGAT-1	Myeloid
CATGTTTCATCGGCTG-1	CM
CATGTTTCATCAGCTA-1	Endo
ACTAGGTAGCGAGAAA-1	CM
CGGACTGGTCAGACGA-1	CM
ACCGGGTGTCAACTGT-1	Fib
GACCTTCCAGACTAAA-1	CM
CAATCCCCAATGCCAT-1	CM
TGCATTTCATGGGTGA-1	Fib
GGACACCGTGCATCAT-1	CM
GACCAATAGCCCATGC-1	CM
CGCAGGTCACCGAAAG-1	Myeloid
GGAATCTCAGGCTACC-1	CM
CTCTACGCAAGCGGTA-1	CM
GGGTCTGTCCATTGAG-1	CM
ATGTACGTCGAGGTAG-1	Fib
TTCGATTAGTAGGTCG-1	Fib
GGCATTAGTTCAGAAA-1	Neuronal
GAACCGCGTCAATACC-1	Pericyte
TCACTCGCATTATGGC-1	CM
GGATGAGTCCCAGCAG-1	CM
TGAGTCAGTCCGGTAC-1	CM
GGCGTTGTCTCCACTG-1	CM
GTGTCAAGTCCCGTGA-1	CM
GTCACGGTCCACGAGC-1	CM
TCGAGCGGTGCAAGAC-1	Fib
TTCGGTCCAAGGAACC-1	Neuronal
AGCCAGCTCCCGCAAG-1	Fib
TGAATCGGTGTTGTTG-1	CM
CAGCCTTTCTATAGGC-1	Fib
CGAGTTATCGATCTTT-1	CM
AGTCAACAGACGCCCT-1	CM
ATAGTCGAGGATGTCG-1	CM
CATTCCGGTCTGTGTA-1	CM
TCGGGACCACACACCG-1	Myeloid
CCCGTTACATCCGTGG-1	Fib
TACGCAAGTATCACAC-1	Endo
ATGTTTCGTACAACGG-1	CM
TGTTAGGTCTTGGCCT-1	CM
CGTACAATCGACTGGC-1	CM
CGCTAGGGTATGTCCA-1	Fib
AGATAGAAGGTTAACA-1	Myeloid
AGGCGAATCGCACCTT-1	Fib
GAGATTCAGTCGTATC-1	CM
GAACCGCCAGCGTAGA-1	CM
TCAGGGCCACAGCTTA-1	Fib
GTGCCAGCACCGTTGG-1	Myeloid
TGATCAGAGTCCTTCC-1	Endo
ATTGTCTCACAAACGG-1	Fib
GCAGCTGTCGCAACTA-1	CM
CAGCCTTAGGATGTCG-1	Fib
TACATGGTCTTCACTA-1	CM
TTCGATTTCTTCTCTC-1	CM
AGGCGTCTCCGTGCGA-1	Fib
AGTTACGCAACTCGTA-1	CM
CCCTAGTCATGGCCGT-1	Fib
GCCTACTAGACTAGCG-1	Fib
TTTGGTTTCTTAACGG-1	Fib
TTGACGAGTGAGTTGG-1	CM
CTACTTAAGGATATCA-1	Fib
AGTCAACAGTACTCTG-1	CM
TGGTCAAGTAGCTGTT-1	CM
GAGATTCGTGCACCCA-1	CM
CGTAAACTCAGGCCGT-1	Fib
TCCAGAAGTCTCAAAC-1	CM
TGTGTCCCATAGCCAT-1	Fib
TGACTCCTCCTAGAGT-1	CM
TAAGCCAAGACCCATT-1	Myeloid
GGTGAAGCAGCTTACA-1	CM
AGCGATTCAAACAGTA-1	Fib
TCAAGGTTCCCTAAAG-1	Myeloid
ACAAGCTCATAGCCAT-1	Fib
GTCACTCGTATGGATA-1	Fib
AGCCTTCCAGGGAGTT-1	CM
TACCCTGGTCGTCGCA-1	Endo
GACTAACAGACGTCAG-1	CM
GGGCCATCAACGAGGT-1	CM
ATGTACGGTAACGGAC-1	Fib
CCAATGAGTTGTATCG-1	Myeloid
AAGATAGTCCTGTGGG-1	CM
GAGCGCTTCTAGTCGA-1	CM
CGCACAGGTTGCAGAG-1	CM
TACCCTGCATACCCGG-1	CM
ATGTACGCACACATGT-1	Myeloid
TTACCCGGTTTGCCCT-1	Pericyte
TAGTCCCTCGATTACG-1	Endo
GACTAACGTATCCTTT-1	Fib
CTCAGAAGTGCCGGTT-1	CM
CCAGAATCAACATAAG-1	Myeloid
GCAACCGGTTCAGTAC-1	Myeloid
AATGTCGCACAAACGG-1	CM
TAGGTGTGTAGCGAGT-1	Fib
CTCTCAGTCTTACGGA-1	Fib
TTTACGTCATTAACGC-1	CM
AAACTCGCATCGGCTG-1	CM
AACCGATTCCCAGCGA-1	CM
TGTACAGCACAGTTAC-1	CM
AGTGCGCGTTCCGCGA-1	Neuronal
TCCGACTAGAGCGAAA-1	CM
ACCCAAAGTTCTGATG-1	CM
AGCCAGCAGATGGGAA-1	Fib
TGCATGACAAGGCGTA-1	CM
ACCGGGTAGCAGAGCT-1	CM
GAGCATTCAAACGTTC-1	CM
CTCACCAGTTCTGATG-1	Fib
GTGGCGTCAGGGCTTC-1	Fib
AGTGCGCTCGGCAATT-1	Myeloid
TTCGTTAGTGCCGGTT-1	CM
CAAAGCTTCAAGTTGC-1	CM
AACGGGACAGGTGTCC-1	Neuronal
GCTCACTAGGGTTCCC-1	Endo
TGTACAGTCAGCACTA-1	Myeloid
GTACTTTAGCGCACAA-1	CM
TGACAACAGACTAGGC-1	Pericyte
GAACCTATCCTCCATG-1	CM
TCAAAGCGTTCTTTCA-1	Fib
GTGATCATCGTGGCGT-1	Myeloid
CGTTCCACACCCTTAC-1	CM
CTTGCTGTCTTGTCGC-1	CM
GCTTGCTAGACGCCCT-1	CM
CTGGGACGTGACCAGA-1	Fib
TGAATCGTCTAAACGC-1	CM
GTGCTGGAGTTCCAGT-1	CM
ACCCAAAAGCTCCGGT-1	Myeloid
TCGATTTGTAGCATGG-1	CM
CAATCCCCATTTGGCA-1	Fib
GCAGATTTCTCTGCGT-1	Fib
CCCTCTCGTGCCCTAG-1	Endo
ACAGGCCGTTGGCTAT-1	CM
GTCACAATCAAACCAC-1	Fib
GAGACTTGTTTCACCC-1	Fib
CTCAACCCAATAGTGA-1	Fib
AGCCCGACACGGTTAT-1	CM
GCTTAAGTCTCCTTAA-1	Myeloid
ATGGATCAGTAGGTCG-1	Pericyte
GGGACCTAGGCGACTA-1	Fib
ACTGCGGAGTGATAAC-1	Fib
TATCGAGGTGAATGTA-1	Myeloid
TGCTTCGTCTCGTGAA-1	CM
CCGAAGCCACACACAT-1	Fib
TCTATTGTCGCGTGAC-1	CM
TCAGGTAAGTCATACC-1	CM
CAGCCTTCAGGCAAGT-1	Fib
TATTGCTTCCGTGCAG-1	Fib
GTGCCAGGTATTCTTC-1	Fib
CTACAGAGTCGTAATC-1	Fib
GACCCAGGTGCTAGTT-1	CM
TTAGCTTAGCTTACCA-1	CM
CCTATTACAGGTCTGC-1	Endo
CTAGCGGCACTTATGG-1	Pericyte
ACGGATTCAAATTGAG-1	CM
GCTTTCGTCGTTCTAT-1	Fib
TCAAAGCGTACTATGC-1	Fib
GACCGACCAGATAAGT-1	Fib
TTAACGGAGAAGCCTG-1	Fib
ATTTGTCTCTTGTACT-1	CM
TTGTTCACAAGGAGGG-1	CM
CACCACTCACAAGGGT-1	Fib
CATTCCGGTTCCAATG-1	CM
CAGGATTAGACTTCCA-1	CM
CCCACATTCTATGAGC-1	Fib
TTCATTGTCTTGTCAT-1	CM
CCCGTTATCGGTCCGA-1	Myeloid
CCCAGAGGTTGGCGAA-1	Fib
CCAGAATGTTCTACCC-1	Fib
GGTTGCGCAAGCCCTG-1	Fib
GAAGAGCCACCTATTT-1	Fib
TAATCGGTCTCCTTAA-1	Fib
TAGCTTTAGTAGTGTA-1	Fib
TAACTTCTCGCTCTAC-1	Fib
GCATTCCAGTCGTATC-1	Myeloid
GTCACCTCAATTCTCT-1	CM
TCGCAGGTCGCCCTTA-1	Fib
TCTAGTTTCGCGCCAA-1	CM
TTGAGTGAGGAAGAAC-1	Myeloid
CCGCATTCACGCTCAG-1	CM
ATCCTCGCACACATGT-1	Fib
AAAGATGCACGATTAC-1	Myeloid
AACCTTTCAAATTGAG-1	Fib
GGCGAAAAGCGCATTT-1	CM
TGTGGCGTCTGGCACG-1	Pericyte
GTCCATCCATCCATAG-1	Pericyte
TGATCAGAGGTACATA-1	CM
AACGTACTCGGGCTCA-1	CM
GTTACGACATGCGTTA-1	CM
GTAGTACCAGAGCCAA-1	CM
TGCACCTCATTGAACC-1	Endo
GCTCAGGCAAATTGAG-1	CM
CATGTTTTCGCAAGCC-1	Fib
CCCTCTCTCTGGCACG-1	Myeloid
TTTGTGTAGCTGAATA-1	Fib
GGCGTTGTCTCGTAGA-1	Fib
ACTTCCGTCTTCCGTG-1	Fib
GTCACGGAGTCCTTCC-1	Endo
CTCATGCTCGCCACTT-1	Fib
AGGCGAACACTCGTGG-1	CM
ACCGCAGCAATGGCTT-1	Fib
GAACGTTTCGGATGTT-1	Myeloid
CTGAATGCACCTCGTT-1	CM
ACTATTCAGTACCACT-1	Myeloid
CTAACTTGTCTCTAAG-1	Myeloid
GGTTGCGAGTCTGCTA-1	Fib
TGGAAGGCATTTGGCA-1	CM
CCACGTTCAAGGAACC-1	Myeloid
GCAGCTGTCCTCTCTT-1	CM
TTGACGAGTGCATTGT-1	CM
TTACCCGGTGGAGTGT-1	CM
CCGTGAGCATTACTTC-1	Fib
TTCATCACACGCTGTG-1	Fib
CGAGTTATCAGTGTGT-1	Pericyte
CGGACTGTCTCGTAGA-1	CM
GAAGTGGCATTATGGC-1	Fib
CATAACGCAAGCCTTA-1	Myeloid
TGCTTTAGTGCACATT-1	Endo
GTTGGTAAGTTCAACC-1	CM
AACCTTTAGCGAATAT-1	Fib
GCTTGCTTCCGAATTG-1	CM
TGGCAATTCAGAATGA-1	CM
TAAGCCATCGCTGATA-1	CM
GGGTGTCGTAAAGGCC-1	CM
GCATGATCAAATTCCG-1	Myeloid
TTACGTTAGTGTCGCC-1	CM
CAACGTAAGAGGAATG-1	CM
AGCCTCTAGGCCAATG-1	Fib
TAGGAGGTCTGGACAT-1	Pericyte
GCGAGTCTCGGTGATT-1	CM
GACCAATGTCCGCTTT-1	CM
GCAGATTCAAAGCTTC-1	Fib
TTATGTCAGTGCCCTG-1	Fib
TACTAGGCATCTGCAA-1	Endo
AACGAGGAGGCGACTA-1	Myeloid
CCCTAGTGTAAGTCTC-1	CM
CAGCTAAGTCGTAATC-1	CM
TGCTCGTGTTAACTCG-1	CM
AGATAGATCACCCGGA-1	Myeloid
TGCTTCGAGGATTAAC-1	Fib
CTGGCAGGTCTGGGCT-1	CM
CCAATGATCTCTGAGA-1	CM
AAACGAATCTTAAGCG-1	Endo
TCACCACAGATATGAC-1	CM
GACCCAGTCGAAGCCC-1	Myeloid
AACGTACGTATCTGCA-1	Myeloid
CTGAATGCAGAGCCAA-1	Fib
CCCGTTATCAGGTCTA-1	Myeloid
GCTTTCGTCGAGAACG-1	Myeloid
GAGCATTAGCTGAGGT-1	CM
ACTTCCGGTTGGTAAA-1	CM
ACAAAGACATCCCGGA-1	Myeloid
AAACGAAAGGTAAGTT-1	Myeloid
TGCTATTCATCCTCGT-1	Fib
ATGTCTTAGCCGCTGT-1	CM
GAGGATGTCTATATCC-1	Fib
TAATCGGGTCGCTAGC-1	CM
CTCGCTACACAGCCAC-1	Fib
TCACAAGCACAAACGG-1	CM
GCTGCGACACATTCTT-1	Fib
TTGGTCCGTACCGGCT-1	CM
CACCACTGTAAAGGCC-1	CM
AAACTCGCACTGAAGG-1	vSMCs
TCAAAGCAGGTACATA-1	Fib
CTTGTCGGTGCTTCCT-1	Endo
GAACCGCGTTTGAAGA-1	CM
CCTTGGTGTCACCCGA-1	Fib
AATGCCACAGCCACGT-1	CM
GCCCGAACATGTGAGG-1	Myeloid
GAACCGCTCGGGCTCA-1	CM
TTACTTGTCGATTACG-1	CM
TGTAGCAGTTAAGTCC-1	Fib
ATAGTCGGTGATAAGT-1	Endo
CTCCCAACAGTAAGCG-1	Pericyte
CGCACAGCACCACGAC-1	Fib
GCACGCACATAGCCGC-1	Myeloid
GGTGAAGAGGGTTCTT-1	Fib
GTCGTAAAGTGAGTGC-1	CM
GCACGCACAAGGCGTA-1	Myeloid
TTTACGTGTAGACACG-1	Fib
TCCCACAGTTCTGAAC-1	Myeloid
TACGCAACATTGCCTC-1	Myeloid
GGTAGGACAGTGGTCC-1	CM
TGAGTCACACATGATC-1	Fib
CACATGATCGATGTGT-1	Myeloid
CGTAAACCAGCAAACG-1	CM
ACTAACGGTGAATGGC-1	Pericyte
TTTGAGGAGAAACGCC-1	CM
AGTCCGGGTTTCGATG-1	vSMCs
TTTGTGTCACCGAATT-1	Fib
ATTACCTGTCATAGAA-1	Endo
GTCACGGTCAGCCGGT-1	CM
TGCCTGTTCTGGCACG-1	CM
GCGCCAACAGGCACAA-1	CM
TCCCACAGTAGCCATT-1	Fib
GTAGACTTCACTAGCA-1	Endo
TAGACTGAGAACAGGA-1	CM
ATCCTCGAGTGAAGGA-1	Myeloid
AGCCTTCCATCCATAG-1	CM
ATTCGTTCATCGCTAA-1	Myeloid
AACGGGAGTGAAACAT-1	Endo
AGCTATGAGACAGTGC-1	CM
CCAGAATGTTTGATCG-1	Fib
TACGCAAGTTGAAGCG-1	Endo
GCGCATGCACGCGATC-1	CM
GCGTTGGAGCGTTAGG-1	Myeloid
AACATCGCAACTCGAT-1	Myeloid
TTCATTGCAACCTCCT-1	Endo
AATGTCGAGCTTACCA-1	CM
AGTTACGCAGGTTATC-1	Fib
ATGTCTTTCACTCGGG-1	Endo
CAGCTGGGTTTAGAAG-1	Myeloid
TCACAAGTCGCAAGCC-1	CM
AAATGCCAGATGCGAC-1	CM
TAGCCGGAGGCCTCTG-1	CM
GGTGAAGGTGCCCTAG-1	CM
AACCTGAGTGGTAAGC-1	Fib
TTGTTGTGTTGTATCG-1	Pericyte
CTGCTCAAGATGTTGA-1	Endo
GAGATTCGTGAATCGG-1	Fib
GATGATCCACGATATC-1	Fib
ACTCGGGCAACCTCCT-1	Fib
CCGCATTTCTTAAGCG-1	Fib
TTGGTCCAGTCCGATT-1	Fib
GAAGTGGCAACGGGTA-1	Myeloid
GCATTGATCTTCGTTA-1	Myeloid
GAAACAAGTATTCGCA-1	CM
ATTACTCCATGATCGT-1	Endo
ATCCTCGAGCTAGTTC-1	CM
TGTTAGGGTACTATGC-1	Fib
CACCACTGTCGTAGTT-1	Endo
AGATAGAGTATTGTGC-1	CM
GCCTAGGTCGGAGTTT-1	Myeloid
GGGTTATTCCCACTAC-1	CM
GTGATCACAATGGTAA-1	Myeloid
CATGCCTTCCGATTGA-1	CM
ATCCTGCTCTGGCGCA-1	Fib
TTGCCCACACGACGAA-1	CM
ATGCATGCAAGGTCGA-1	Myeloid
TAGGTGTGTATTCGAC-1	Pericyte
GTGTGATCAGCCGAAA-1	Endo
ACTTCCGTCTGTTGCC-1	CM
TCAATTCCAATGGTCT-1	Endo
TAATCGGAGTACAGAT-1	CM
ACAAAGACAGATTAAG-1	CM
GACCCAGCACCTGTGG-1	CM
TCAAGCATCGGGAATG-1	Pericyte
CATTGGAGTAAGCCTT-1	Endo
CCGAAGCAGTCACGCC-1	CM
ATGTCTTTCTGGAAGG-1	CM
ACCAAACTCGTCAACA-1	Pericyte
GAGCGCTAGTGAGCTG-1	Pericyte
GCAACCGCATCACAAC-1	Endo
AACATCGTCACTGATG-1	vSMCs
TGCTTTATCAAAGTAG-1	Fib
GCGATCGAGTCTTAGC-1	Fib
AGCCTCTGTCATTGGT-1	CM
ACGTTAGAGACAACGC-1	Fib
AATGCCAAGGCCAATG-1	CM
GCCCAGATCGAACCGC-1	CM
AACTGGTGTGATTCCA-1	CM
CAGGGCTTCAGGCGCT-1	CM
CTCTACGAGGTCGTTT-1	CM
CAGGGCTGTCAGACGA-1	CM
GACCAATGTCCAACCG-1	Myeloid
GGCACGTAGTCGTACT-1	Pericyte
GATCATGGTTTAAGCC-1	CM
GCGCATGTCGCTATTT-1	Myeloid
TCTATTGCATGCTATG-1	CM
GCCAGACGTAGGGTTG-1	Myeloid
AGTCCGGGTAGAACGC-1	Fib
GTAATCGAGACCTATC-1	Endo
ACCGGGTGTACGACCC-1	CM
TACATTCGTGGAAGCT-1	Myeloid
CCTAAAGGTATCATGC-1	CM
TAAGCCAGTCAGGCTC-1	Pericyte
AGTGTACGTTGGCGAA-1	CM
AGCCTCTCAGACCTGC-1	CM
GAGCGCTTCTCGACCT-1	Endo
TGACTCCTCGTTCCGT-1	Myeloid
CAACGGCGTTCTGATG-1	CM
CAGTATGTCCATGTTT-1	Myeloid
CCTGCTACAGGATAGC-1	Myeloid
GAGGCTCTCACCACAA-1	Myeloid
ATCCTGCAGTGAGTTA-1	Fib
TGAGTCATCGCAAGCC-1	CM
CCATACCCAATCCATG-1	Myeloid
TCCATCGGTTGGAGGT-1	Myeloid
GTACTTTAGGTGATGC-1	Lymphoid
TGCTTCGGTGGCCTTG-1	Endo
TAGGTGTCATGATTGC-1	Pericyte
CGGTGCAAGCAGGACT-1	Pericyte
TACATGGGTGCATTGT-1	CM
TGGCAATAGAGGCCTA-1	Fib
AACCTTTCAAACTACC-1	Neuronal
GAAGTCTAGACCAATA-1	Pericyte
GCAGCTGAGGAAGACA-1	Fib
TGTGGCGAGCGGACTA-1	CM
AACCTTTAGAGACTCG-1	Endo
CAGCTAAAGCGCACAA-1	Pericyte
TCACCACCAAGAGCGT-1	Endo
TTTGCGCCACCTATTT-1	Pericyte
AGCCTTCTCGCTATTT-1	CM
TAAACCGGTCCTTCAC-1	Endo
GCACCTTAGCCTTTGA-1	Endo
GGTGTCGCACTTATGG-1	CM
ACTAGGTAGTAGAAGG-1	CM
TTAGCTTAGATTCCGT-1	Pericyte
TCAGGGCGTATTTGCG-1	Pericyte
GTGGATTAGCTACGCC-1	CM
GTCACGGAGGAATGGA-1	Pericyte
ATTACCTTCCAGCACG-1	Myeloid
CATAACGGTGAGCTAG-1	Pericyte
GCCTAGGCAGTAAGAT-1	Myeloid
AGCCGCACATAGCCAT-1	Endo
GACTAGTCAGCCACGT-1	Myeloid
CGGACCACACCGATCG-1	Endo
TTGTCTACAGTAAGAT-1	Endo
TAAGTGCCACTCGCAG-1	Endo
TGCTCACGTCCGAGCT-1	CM
AACAAAGAGCTTACCA-1	Myeloid
ACTACCCGTGCTTCCT-1	Myeloid
ATGTACGAGCGTAGCA-1	Myeloid
AACAAAGCAAACGTTC-1	CM
ACGGATTAGTAATCAG-1	Lymphoid
GCGGTGTGTGCAAAGC-1	Pericyte
GCTTTCGAGGAGTACC-1	Fib
TCGGGACCACGCGATC-1	CM
GACCTTCCAAAGAAGG-1	CM
TGAGCCGTCTCTCAAT-1	CM
CACTGAATCGCCACTT-1	Myeloid
AGGCCTGGTTTAGAAG-1	Endo
TTGCAGACACTGATTG-1	CM
TAAACCGAGTGCTCGC-1	CM
GCAAAGGTCGCACAAT-1	Myeloid
TAGCACACATTGATGC-1	Myeloid
TGCTATTTCCGGACTG-1	Myeloid
TACCTCGTCGCTACCT-1	CM
TTTGTGTGTTTCAGCA-1	Myeloid
GCCTACTCATTGATGC-1	CM
TCACCTGTCTTAACGG-1	Pericyte
ATTTGTCGTTTCTTAC-1	Endo
AGTCCGGCAAGTCTCA-1	Myeloid
ACATGCACACTGTCAA-1	Pericyte
CAACCAACAAGTCCTA-1	Endo
AAGGTTCTCGACTCGG-1	Myeloid
CCCAGAGTCTCTTAAC-1	Myeloid
GGGTCTGCAACAACTC-1	Lymphoid
ACTGCGGTCCTGTGGG-1	CM
GCTTGCTAGAAAGCAG-1	Myeloid
CCCACATAGTAACATG-1	Endo
TTGCCCAGTGATAAGT-1	Pericyte
AACGGGACAGATACAA-1	Endo
GTTGGTACACTGATAC-1	Fib
GGCGAAATCTAAACGC-1	Myeloid
CACGTTCGTGGGTAGT-1	Myeloid
CTTGCCATCGCTATAG-1	CM
TGACAACGTAAAGCTA-1	Pericyte
TTCGGTCAGTAGCAAT-1	Myeloid
ACCAAACTCAAACCCA-1	Myeloid
CGATGATGTTTCGACA-1	CM
GGGTGTCTCCTGGGAC-1	CM
CCGAAGCGTTCCAGTA-1	CM
ACTGCAACAGGTCTGC-1	CM
GAACTTGGTAACGGCA-1	CM
TACTAGGAGACTTCCA-1	Endo
ATTGTGGAGATCTCAC-1	Pericyte
TACTGCCAGAGTTTGA-1	Endo
TGGCGCAAGGGACGTT-1	Neuronal
TCTCAGCTCCTCCTGA-1	Pericyte
TGCTTCGCAACGCACC-1	Myeloid
AGGCCCAAGGTCCTCG-1	CM
TTCTAACCATACAACC-1	Endo
GTTGGTACAACAACTC-1	Myeloid
AGCGTGCAGTCGTATC-1	CM
CATAACGCAGTGGTCC-1	Endo
GCGAGTCAGGAAGGTA-1	Myeloid
GCATTGAGTGAGTCGA-1	Pericyte
GATCATGGTAGTACAA-1	Endo
CAACGTAAGAGCCTGA-1	CM
GTCACTCGTCATCAAC-1	CM
ACAGGCCCAGTAGTCT-1	Pericyte
GGGTCTGTCGTCGCAG-1	Myeloid
CTTGCCAAGGATTTGA-1	CM
CTCTCGACAACTACTG-1	Myeloid
TGGCGCAAGTACCTCA-1	Myeloid
TTACTCAGTTTGCATG-1	Neuronal
TCACAAGTCGATGCAT-1	Endo
TAGCTTTTCGCGCTGA-1	Myeloid
CTGTATTTCGCGTTCT-1	CM
TCAGGTAAGTTGCGCC-1	CM
ACCGGGTAGCAGAATT-1	CM
AGCTGGCGTTATGCAC-1	CM
CATTCATTCGGACGAA-1	Pericyte
GCATTCCCAGCTATAC-1	Myeloid
TAGCATGGTACTTCGA-1	Myeloid
GGATGAGCAAGGGTAC-1	Fib
TCAAAGCGTCATCAAC-1	Endo
GCTGCGAGTCTGTTGA-1	CM
TGCATGAGTGAATGGC-1	Neuronal
ACGTTAGAGAAGCCGT-1	Pericyte
TTGCGGGTCCGGCGAT-1	CM
GGAATCTGTCTAACCA-1	Endo
AAACTCGCATCGACGC-1	CM
GCGAGTCTCGCTCGGA-1	Fib
TATGTTCAGAACCATA-1	Lymphoid
GACCCAGGTATCTGCA-1	Myeloid
GGATAGGCAATTAGGA-1	Myeloid
GTCACGGAGCTGAATA-1	Pericyte
ACAGACTGTCCTTATT-1	CM
AACGAGGAGGATCCTT-1	Endo
AGCGATTGTTCCTATT-1	Myeloid
GCAAAGGTCTATCTAC-1	Endo
GGGAACACATTCTCGC-1	Myeloid
GCGAGTCGTCATTGGT-1	Neuronal
GGGTTATAGACAGTGC-1	CM
AGGACGATCGCGTTCT-1	Endo
GATTAGCGTCTCAAAC-1	Fib
GCGGTGTAGTACGCGA-1	Pericyte
AACTTGGGTGGCCTCA-1	Endo
TAACGGTGTCCAAGAG-1	Pericyte
CGGTGCAAGCAACTGG-1	Endo
GATTAGCTCACTTACT-1	Myeloid
AGGACGAAGCATTGGG-1	Endo
AACATCGTCAGATACC-1	Endo
TTGGTCCGTAACTGAA-1	Endo
GACTAACAGGAATGGA-1	vSMCs
CATGTTTGTCCAACCG-1	Myeloid
CCATACCCACACACAT-1	CM
ACTGCAATCCAATCCC-1	vSMCs
GTGCACGAGTACAGTA-1	Pericyte
CCTCCCTTCAGCACGC-1	Endo
TCACAAGAGGAGACTC-1	Myeloid
GAACTTGTCGATGTAC-1	Pericyte
CTTGAAGCATGCACTA-1	Pericyte
CTGTTCGAGAGAAGCA-1	Myeloid
CAACGGCAGTGAAACT-1	Myeloid
TTGAGTGTCTGTTTAC-1	Myeloid
GATGATCGTAACCATC-1	Endo
ACAAACCAGGGCTTCC-1	Endo
ATTGTCTGTTCTCGAA-1	Endo
AGTGCCGAGACTAGCG-1	CM
GTGTCAAGTCACTCTC-1	Pericyte
GAGGTCCTCCGGCGAT-1	CM
TAATCGGAGTACGCGA-1	CM
TAAGCCAAGGTCACTT-1	Endo
TCAGGTAAGAGGAAGT-1	Pericyte
ACATGGTTCACGTCAA-1	Neuronal
GCTCAGGAGGGTATCG-1	Lymphoid
GTCACGGGTCGATTAC-1	Endo
TTGCTATGTAAGCCGA-1	Myeloid
CCCGTTAGTCACCGCA-1	Myeloid
GGCGTTGAGAATCAGT-1	Endo
CATGCCTTCAAACCAC-1	Myeloid
ATAGTCGTCGTCTAGA-1	Endo
ATTGTGGCATCTCACC-1	Myeloid
CGTACAACAATTCTCT-1	Pericyte
CCCGTTACATCAGAAA-1	Pericyte
ATCCCTGAGATCGATA-1	Pericyte
CAGCTGGCAATGCCAT-1	Fib
CGTACAATCAGGCGCT-1	Endo
CCTAAAGTCTCGCGGA-1	Pericyte
TTCATTGGTCGTAGTT-1	Myeloid
TGATGCAGTGGCCTTG-1	CM
GGATGAGTCGGGTCCA-1	Myeloid
CTTGCTGTCGGTCGAC-1	CM
GAGGCTCTCCAAACCA-1	Endo
ACCGAATCAAATTCCG-1	CM
ATCGAGTAGAGGAACA-1	Myeloid
GCTGTTCCAAGGCGTA-1	Myeloid
GCAAAGGTCTGAGTAC-1	Endo
TTGCTATAGATGGGAA-1	Myeloid
AGATAGATCTACTTTG-1	Endo
TGAGCCGAGAGCTACG-1	CM
GGAACCCGTCCTTCAC-1	Pericyte
CTTCTAAAGGCACTAG-1	Myeloid
ACCGAATTCGCGTGAC-1	Myeloid
GAGACTTTCGTGATAC-1	Endo
TGGGTGCTCGTCGCAG-1	Myeloid
GCTGCGATCGCCGAAC-1	CM
TTACCCGAGAACTCCT-1	Myeloid
TTCAACTTCGCTTGAA-1	Myeloid
GGAGTAGAGTGTCGGA-1	Myeloid
TATTGCTCACACTAGT-1	Endo
GCATTGATCGTGGGTC-1	CM
CTTCCAGTCTCGCGGA-1	vSMCs
GGGAACACAGCAACAG-1	Myeloid
AGATAGACAAGTCTCA-1	Lymphoid
ATCGAGTCACAGCTTA-1	Endo
TGAGCCGAGGAGTAGA-1	CM
TTGCTTAAGTCCCGCA-1	Endo
CATTCCGTCGACTGGC-1	Pericyte
TAATCGGTCCTCCAGT-1	Myeloid
GCATGATAGACACTTC-1	Endo
AACCTGACACTCGTGG-1	CM
AACGGGATCGCAAACT-1	Myeloid
CTGCGTTTCCTGTGGG-1	CM
CAGGATTTCGTGCTTC-1	vSMCs
TTTACGTTCGACTATG-1	Fib
CGTTCCAGTTTCCTAT-1	Myeloid
CGGTGCACACCTCGTT-1	Pericyte
TAGCGGCTCTTGTCGC-1	Myeloid
AACTTGGCAGCTATAC-1	Lymphoid
TAAACCGAGAACGCCA-1	CM
GAAACAAAGTTGCGCC-1	CM
TAGCCCTAGCTACGTT-1	vSMCs
GGGAACATCCGGGCAT-1	CM
TGGTCAACATGGCCTG-1	Neuronal
TGACTCCAGTACCTCA-1	Myeloid
CCTTAATCAGAACGAC-1	Myeloid
AGCCTGGCAACTCAAC-1	Myeloid
TCCCACAGTACGACCC-1	Myeloid
CTCTACGTCCCACTAC-1	Myeloid
AGCCAGCGTGGATTTC-1	Myeloid
GCAACCGCAAGTCTCA-1	CM
CTTGTCGTCGGGTCCA-1	Neuronal
TGACAACTCCTATCAT-1	Endo
GGAGGATAGTAGGAAG-1	Myeloid
AGATTCGCAAACTACC-1	Endo
GGAGAACCAAACCCTA-1	Myeloid
CAGGGCTGTGAGGTCA-1	CM
AGCCAGCAGTCTCCAA-1	Pericyte
CTCGCTAGTGTCTCGG-1	Pericyte
AGTGCCGTCTCATCCG-1	Pericyte
GCAGCTGAGCAGAATT-1	Endo
ATGTCTTCATGGATGG-1	CM
GGATGAGCATTAAGGA-1	Neuronal
TGCTTCGAGTCTGCTA-1	Myeloid
CCGTGAGTCAAGAGAT-1	CM
TACCTATAGTTCAAGA-1	Myeloid
TCAAGCACAAGCCAGA-1	Myeloid
TTACGTTGTGATTCCA-1	Myeloid
TGTGGCGGTACGGATG-1	Endo
TAAACCGCACGGCCAT-1	CM
AGATTCGTCCAGAATC-1	Myeloid
GCATGATGTGAGGTCA-1	Lymphoid
ATCCAGACATGGGAAC-1	Myeloid
CCTTGCAGTGCCCAGT-1	Pericyte
TCTAGTTCACGCTGTG-1	Endo
TTCTAACCAAGGCGTA-1	Myeloid
GCAACCGAGAACGTCG-1	Pericyte
GCTTTCGGTTGGACGA-1	Myeloid
ACTACGAGTGCTTGAT-1	Lymphoid
CGCGCAACAAAGGTCG-1	Myeloid
AACATCGCATAGACGG-1	CM
CGCAATAAGAGAATTC-1	CM
TTTACGTAGTTGCCGC-1	Myeloid
CATGTTTTCTGACATG-1	CM
ACAATCGGTGTGCTTA-1	Endo
TTCTAACGTACTAGAA-1	Endo
CGCAATACATCATAGC-1	Endo
CTCAGAATCTGCCGAG-1	CM
CAAGGCCCACTGCTTC-1	Myeloid
GCGAGTCGTCCGTAGC-1	CM
TCGTTCGAGTGATAAC-1	Myeloid
GGATAGGCATGCCCTT-1	Myeloid
GTCACAACAATGGCAG-1	Endo
GTAATCGCAAAGCATA-1	Fib
TACTGCCCATCATGTG-1	Myeloid
TCAAGGTAGCATTGGG-1	Endo
TGCTCGTTCACTAGCA-1	Endo
ACTTTCAGTGCTTACA-1	Myeloid
ACTAACGCACCATTCC-1	CM
CCTTGGTCAATTGTGC-1	Myeloid
CACCTTGTCGATGAAA-1	CM
CTTGAAGTCTTCTCTC-1	Pericyte
GTGTGATCACTGCTTC-1	Endo
ACCCAAAGTTGGGAAC-1	CM
GCTGTTCAGTGAACCG-1	Myeloid
AGTCCGGCACTCCTCA-1	Myeloid
GCGGTGTCAACTACTG-1	Myeloid
TCCGACTGTGAGCTAG-1	Myeloid
AACCTGACATGGGTGA-1	Myeloid
GCCATAATCATCGCCT-1	CM
TACTGCCAGACTTGAA-1	Endo
CGATGATAGGTTAACA-1	Pericyte
TGCTCGTAGCCTGTAT-1	Myeloid
CATTCATGTCGGCTGT-1	Lymphoid
TGGCGCATCGCCCTTA-1	Endo
GAGCGCTTCTTACTCA-1	Myeloid
ACAGAAACAGGACCTC-1	Lymphoid
ACTAACGCATAGTCCA-1	CM
GCTGCGACAAGGACCA-1	CM
GAAATGATCCCGAAGC-1	Endo
ACTTTCACAGTATACC-1	CM
GCAGCTGTCCTTACGC-1	Pericyte
ATGTCGACAAACAGTA-1	Myeloid
ACCCAAAGTAGCGAGT-1	Lymphoid
AATGCCATCGCACCGA-1	Pericyte
CAGCTGGCAATTCGTG-1	CM
TGATCAGTCGATATGC-1	Endo
GCGAGTCGTCAATACC-1	CM
GCTCCTACATAGACGG-1	CM
TACTGCCTCGCCAGAC-1	Fib
CCCGTTATCGACCCGA-1	Myeloid
TTTGTGTTCGTGGGTC-1	CM
CCTGCTAGTACGCCCA-1	CM
CTCACCATCCCAGCGA-1	CM
TAGCGGCAGTTGGAAT-1	Myeloid
GACCCAGTCGGGATCC-1	Fib
ACGGATTTCAGTACAC-1	CM
AACAGTCGTACGACCC-1	Pericyte
ATTACCTTCTGTGTCC-1	Myeloid
CACCTTGCAAAGGAAG-1	CM
TAACAGCTCCCTAAAG-1	Myeloid
TCAGGGCAGTCCGTGC-1	Lymphoid
GGCACGTGTAGGGTCA-1	Endo
GTGTGATTCTGTGTCC-1	Lymphoid
CTCACCAGTTGGGAAC-1	Fib
ACTACGAAGGGTATCG-1	Fib
CCCACATAGTATCTGC-1	Myeloid
ACCAAACAGAGAATTC-1	Endo
GAAACAAGTCATCGTA-1	CM
AATGGAAGTCCGTAGC-1	Myeloid
TAGCCCTTCCGCGATG-1	Lymphoid
CCTTGCAGTTGCAGCC-1	Myeloid
TCGTTCGAGGTTCGTT-1	Lymphoid
TAAGCCAGTTGGGAAC-1	CM
TTTACGTAGGGAGTTC-1	Lymphoid
ACTGCGGTCTTCGTTA-1	Myeloid
GCAAAGGGTCCGTAGC-1	Lymphoid
ATCCTGCGTTACGCTA-1	Endo
GGGTTATAGTTCGCGC-1	Lymphoid
CAACGGCGTTGGGAAC-1	CM
GCTGTTCCACCTTGTC-1	CM
TCACTCGCAAACCTAC-1	CM
TATCTGTCAAGGAGTC-1	CM
GATGATCCAGGCATTT-1	CM
ACAAGCTTCATCGCCT-1	CM
GCGATCGGTGCAGACA-1	Pericyte
CCCACATAGAGCACTG-1	CM
GAGACTTGTCTGAGCC-1	Myeloid
ATCCAGACAAACCCTA-1	CM
TCTCTGGAGTTCGTTG-1	Lymphoid
GTGCTGGAGATACCAA-1	Endo
CCGTGAGTCGGCAATT-1	Myeloid
TGCTATTTCAGTAGTC-1	CM
TATTGCTCATGCGACC-1	CM
GACCTTCGTATCATGC-1	Myeloid
AGCGTATCAGCCGAAA-1	Neuronal
ACAGAAAAGGTCGTTT-1	Lymphoid
TACGGATCATAGACGG-1	CM
CACATGACAGGGTAAC-1	CM
GAAGTGGCAAACCTAC-1	Fib
AGACAAACATCCTCGT-1	Myeloid
TGATGCATCGAGGTCC-1	CM
CAGCTGGCACGCTGTG-1	CM
CACATGATCTGCCGAG-1	Fib
GCGAGTCGTGTTGGTT-1	CM
CTGCGTTGTTTGACCA-1	Myeloid
TCGGGACAGCCTGGTC-1	CM
GATCATGCATGATTGC-1	CM
ACTGCGGGTGCAGACA-1	CM
CTCATGCGTATCTAGC-1	Lymphoid
TAATTCCTCCATAGGT-1	Fib
CCCACATTCGTGGGTC-1	Fib
GAGCATTCACTCGTGG-1	Myeloid
AGTCCGGCATGTGGGA-1	CM
GTCACAAGTACTTCGA-1	Myeloid
AGATTCGTCGATGAAA-1	CM
AGATAGACATTTGTTC-1	Myeloid
AATGTCGTCCTCCATG-1	Myeloid
CTTCTAAGTGTACGCC-1	CM
CGGACTGGTGAGGTCA-1	CM
ACCGGGTGTCGATAGG-1	CM
AGTCCGGCAGGTAGGT-1	CM
GGATGAGAGCATGTGG-1	Endo
CCGTGAGTCTTAGTGG-1	CM
TTCATTGGTATGGATA-1	Myeloid
ATCCAGACAGAACAGC-1	CM
TCCAGAAAGAGGAATG-1	CM
GCGGAAAAGACCCTAT-1	Myeloid
TACGGATCAAACGACG-1	Fib
AGTCCGGCATTGCACA-1	CM
CAGCTGGTCCCGTAGG-1	CM
CACAGATAGCTCCGGT-1	CM
AAGGTTCTCAGCCGAC-1	Endo
ACTACGAAGTAGGAAG-1	Myeloid
GAGGCTCTCTGTCGTC-1	CM
TTAGCGATCTCTGACC-1	Fib
AATGCCATCACGGGTC-1	CM
GGTACCGAGGCTAAAT-1	Myeloid
CACCTTGTCACGGGTC-1	CM
TGCACCTAGCTCCGGT-1	CM
CTCATGCTCACCCTTG-1	CM
TGCTCGTGTTGGGAAC-1	CM
AACGGGAAGGGTAGTC-1	Pericyte
GAGGCTCCACAAGTGG-1	Myeloid
AGTTACGGTTAGGAGC-1	Myeloid
TGCATTTCAAGCAATA-1	CM
GGTGTCGAGAATAGTC-1	Fib
GCAGCTGAGCTACGCC-1	Myeloid
GTCTACCAGAACGCCA-1	Lymphoid
AGTGCCGAGGAAGAAC-1	Fib
TTCATCACAGTGCGTC-1	CM
TTAACGGAGTACAACA-1	Lymphoid
CTCGCTAAGTTGCCGC-1	Lymphoid
ACGGATTTCATTCTTG-1	CM
AGTGCCGGTAACCGAG-1	Myeloid
AACCGATAGAGGCCTA-1	CM
GCCCGAACAGGCAAGT-1	Fib
CGTGGCAAGGCGACTA-1	Lymphoid
TCACTCGTCAGTAGTC-1	CM
GAGCGCTTCATAGGTC-1	CM
AGCCCGAAGGGTAGTC-1	Fib
CGAGTTATCACGGGTC-1	CM
CACATGACAAGAGCGT-1	Fib
ATGTTTCAGTCGCGTC-1	CM
TTCGATTCAACCTCTC-1	Myeloid
TCAGGTATCCTGAAAC-1	Myeloid
TTTACGTTCAGTAGTC-1	CM
GGAGAACGTTAACTCG-1	CM
AGCCAGCTCATAGGTC-1	CM
GGAACTTAGAGGCCTA-1	CM
GCGAGTCGTAAACCCT-1	CM
GACTAGTAGACCTATC-1	Lymphoid
AGTCCGGCAGATACAA-1	CM
GTGTGATCACAGTAGG-1	CM
TGGGTTACACCTTGTC-1	Fib
GCTTGCTCAGACCTGC-1	Lymphoid
CTGTATTAGAGGCCTA-1	CM
GGAACTTCAGGTAGGT-1	CM
AACCGATAGTACAGAT-1	CM
TACATGGGTTGTCGGC-1	CM
CAGGGCTGTTTAGAAG-1	CM
TTGTTCAAGGATCCTT-1	CM
CGAGTTAGTCGCTAGC-1	CM
GGCACGTAGGATGTCG-1	CM
GCAGCTGTCCATAGGT-1	Fib
CAGCTGGGTTCAGTAC-1	Fib
GAAGTGGCAACTTGGT-1	Fib
TCCCACAGTCGATAGG-1	Myeloid
GGAACTTCATGTGGGA-1	CM
TCCAGAAAGAGGCCTA-1	CM
AGCTGTACATCAGCTA-1	Fib
CAACCAATCAAGAGAT-1	CM
GTAGACTGTAGTCCAT-1	CM
TATCGAGGTTGGAGGT-1	CM
GCTCACTAGTACAGAT-1	CM
CCCTAACTCGACTGGC-1	CM
GGAACTTCAGATACAA-1	CM
