Barcode	cell_type
TTGCCCATCTCCTTGG-1	CM
TGCACCTGTTCTTTCA-1	Fib
ATCGAGTCACAAACAA-1	CM
TACATGGCAAACTACC-1	Fib
TTTGGCCAGAGCACTG-1	CM
TTGGTCCAGTTCAACC-1	Endo
TGCTCACCACCTATTT-1	Myeloid
CACTGAACACTGCTTC-1	CM
TCGTTCGTCTGATCTT-1	CM
GCCAGCAAGGTCCTCG-1	CM
GAGGATGAGTCGATAA-1	CM
TGTACGACATTCCCGT-1	Myeloid
ACAGCGCCAAGCAGGT-1	Myeloid
ACCCAAACAAACGACG-1	CM
ACAGACTTCGTGGTAT-1	CM
TAACAGCCACGACGAA-1	CM
GTGGCGTAGATTCCGT-1	CM
ACCGAATAGCGAGAAA-1	CM
CTCAACCAGTCTAGAA-1	CM
GATTAGCAGCGTTAGG-1	CM
AGCCCGAGTCAAGACG-1	Fib
AGCCCGAGTCGAGGTA-1	CM
CTCTAGCGTAGGTCTT-1	CM
ACTCGGGTCGTGGAAG-1	CM
CACGTTCGTTACTTTC-1	CM
CCTCCCTCATCGTGAT-1	CM
GTTACGAAGACCGCAA-1	CM
GGAGAACTCAACTTGG-1	CM
GGGTGTCGTGAAACAT-1	CM
CCGAAGCCACGCGACT-1	CM
CAGTATGGTCTGGGAA-1	CM
AAGATAGAGGCAAGCT-1	CM
GGATGAGGTGCATCAT-1	CM
GTACTTTCAGGCACAA-1	Fib
CGCTAGGCAGATACAA-1	CM
GAAATGAGTTTCCGGG-1	CM
GGGTCTGAGTCACACT-1	CM
AACGTACGTAAACGAT-1	CM
TGATTTCGTTCCCTTG-1	CM
GGAACTTTCCGGACTG-1	Myeloid
TACCCTGCAAGTAACA-1	Endo
CGGACCATCTCTTAAC-1	CM
GAGTGAGGTACGCAAG-1	Endo
AAACTGCGTTGTATCG-1	CM
GATTAGCCATCAGCTA-1	CM
CCGTACTGTAGCGGTA-1	Myeloid
CTGGCAGGTTACGGAG-1	CM
TTAGCTTAGGAGGCGA-1	CM
ACGGATTCAAGAAACT-1	CM
TCGGGACTCAACTTGG-1	CM
GAGTGAGGTGTTTCTT-1	CM
CCGCATTGTAGTAACA-1	Endo
GAACTTGCAAGGAAGA-1	CM
TCGAGCGTCGGCAATT-1	CM
TGCTTCGTCTCATCCG-1	CM
GCAAAGGCAAGGCGTA-1	CM
CAAAGCTAGCCTTTGA-1	CM
CTTCCAGGTGGAAGCT-1	CM
GAGCGCTCAAGTTGCT-1	CM
TTAGCGAGTTAGAGAT-1	Pericyte
TACATGGGTTACGAAA-1	CM
TCCAGAATCGATGTGT-1	CM
TTGCGGGGTTGCCTGG-1	CM
TAACGGTCAAGTGGCA-1	CM
TCAATTCCACAGTTCA-1	CM
CCAGATATCTCTGCAC-1	CM
ACCGGGTTCACAGGGA-1	CM
CGTAAACGTACTTCGA-1	CM
GGGAACAGTCAATACC-1	CM
CTTTGCGCACCTATTT-1	CM
GCTCAGGGTTTGATCG-1	CM
ACCTGCTCAATTGGCT-1	Endo
TGGAAGGGTTAACCAC-1	CM
TAAGTGCAGGTACATA-1	CM
GGGAACACAAGACACG-1	Myeloid
GGTTGCGTCCAGGTAT-1	CM
AGCCAGCTCCGGCGAT-1	CM
AATGCCAAGTCGAGCA-1	CM
TACGGATCAAGCCAGA-1	CM
ACTCGGGCATAAAGTG-1	CM
TCAAGCAAGAGGCGGA-1	CM
TCACCACCATTGCGAT-1	CM
TGATCAGGTGCCCTAG-1	CM
CCCTAACAGTATACCC-1	CM
TAGACTGCATTTCACT-1	CM
GAGTGAGGTACGGTTT-1	CM
TGGCAATCATGATCGT-1	CM
GCCCAGAGTGAGTTGG-1	CM
TGCGTAAGTCATAGCT-1	CM
CCAGAATGTAGAATAC-1	Myeloid
GTTGGGCCATCCCAAA-1	CM
AGCTATGTCCTGGAAT-1	CM
GAGTGAGAGTGCTGAG-1	Pericyte
TAGTCCCTCGTGTGCG-1	CM
ATATTCCTCGCGATGC-1	CM
ACTTCCGTCTCGCGTT-1	CM
ACTGCAAAGACACAAT-1	CM
TTAGGTGGTCAGCTTA-1	CM
ACCGAATCAGGGTAAC-1	CM
CCTTAATGTGTTAGAA-1	CM
CAACGTAGTCGAGAAC-1	CM
TTAGGTGTCATGAACC-1	CM
CTCAACCGTATGGATA-1	CM
TCCAGAATCTTGTCAT-1	CM
TGCCTGTTCCTTGACC-1	CM
GAAACAATCTTACTCA-1	CM
GAACCGCAGATGGCAC-1	CM
GTAGTACAGTACAGTA-1	CM
ACAGAAAAGAGGCGGA-1	CM
GTTGGGCGTGAATCGG-1	CM
GAAACAATCGGGAATG-1	CM
GACTAGTAGGGAAATG-1	Myeloid
ACCCAAATCACTGATG-1	CM
CGCTAGGAGTGAGCTG-1	CM
CACTAAGCATGTATCG-1	CM
CGGTGCAAGCTAGCAG-1	Myeloid
TCAAGACCAGGTGTCC-1	CM
TCTAGTTCAAGCAACG-1	CM
AAAGATGAGTCCAGAG-1	Endo
TTGCCCAGTTTAGACC-1	CM
TTGCACCCACTAAACC-1	CM
AGCTGATCAACGACAG-1	CM
TAAGTGCTCTTGCGCT-1	Myeloid
TCACCACCACACACCG-1	CM
AATGCCAAGGAAACTT-1	CM
GGTGAAGAGTGGGACT-1	CM
TGAATCGAGATTCCGT-1	CM
GATGGCCCAAGTAATG-1	CM
GCTTAAGTCCAATCCC-1	CM
ACAGCGCTCTTACCTA-1	CM
AGCCAGCGTATTCGCA-1	CM
CAACGGCTCCAGGGAA-1	CM
TACGCAAGTTTGACCA-1	CM
TGCACCTGTGGCATAG-1	CM
CTGTTCGCACCATTCC-1	CM
CGTACAATCGTGGAAG-1	CM
ATGCATGAGCACACCC-1	CM
GCGAGTCCATTGAACC-1	CM
ACCGCAGTCTGGACAT-1	CM
CTTTGCGCAATGGCAG-1	CM
TTCGCGTGTGTCCCAG-1	CM
TTAACGGTCTCCCTTT-1	CM
ACTAGGTGTGCTTACA-1	CM
TGACAACCAAGTCCTA-1	Endo
GCGAGTCCAGAGCCAA-1	CM
ATGGATCTCGGGAAAC-1	CM
CCTGGGATCATCATGG-1	CM
CCAGATACAACACGGA-1	CM
ATTCGTTAGCTATCGT-1	CM
AACCTTTCAAGGCTTT-1	Fib
TTCATCAAGTACTCTG-1	Myeloid
TTTGGCCGTCTGCGCA-1	CM
GCTCCTACAGGTGTCC-1	CM
TAACGGTAGTCGTACT-1	CM
AATGGAACAGGATGTG-1	CM
TTGACGAAGGGAAATG-1	CM
CTCTACGCAAGTAACA-1	CM
GTGGATTAGGGCGAAG-1	CM
ATTACTCGTGCTTGAT-1	Endo
TACTGCCCAGGCAGAT-1	Fib
GTGCACGAGAGGTCCA-1	CM
TACGCAATCCCGAAGC-1	CM
TGTGACAGTTAGTAGA-1	CM
GGGTTATGTAACATAG-1	Endo
AGGACGATCGTGGCGT-1	CM
GTCACCTTCGATCTTT-1	CM
CTCAGAAGTTCCCTTG-1	CM
CGTACAACAACAAACA-1	CM
CCCTGATTCGTCCCAT-1	CM
GAGTGAGCATGGCCGT-1	CM
GTCACCTGTAAACGGC-1	CM
GCTTAAGAGCGAGCTA-1	CM
GACCTTCTCCATACGA-1	CM
GCGGGTTGTTTCTTAC-1	CM
CCCTCTCAGGCCAGTA-1	CM
TTTGCGCCAACGACAG-1	CM
GTTACGAAGAGAGGTA-1	CM
GATGATCGTCTGGTTA-1	Endo
TTGCGAATCGTGGAAG-1	CM
GTCACCTTCTAGCAAC-1	CM
TGCATTTGTTGGTAAA-1	CM
ACTGTCCTCCCTAAAG-1	CM
GGTGTCGGTAGTCTGT-1	CM
CTTCCAGGTAGCGTTT-1	Endo
TCGGGACCAGAGAGAA-1	CM
CAGCTGGAGACACAAT-1	CM
CGCTAGGTCTTACTCA-1	CM
TACTGCCTCCACGAGC-1	CM
GTCGTAATCAACGTGT-1	CM
ACAAACCCAGATACAA-1	CM
ACATGGTAGTGCAACG-1	CM
CTTCCAGCAACTACTG-1	CM
TATCGAGTCATCGCCT-1	CM
CCACGTTGTGAATGTA-1	CM
ACCGAATAGTGCTGAG-1	CM
TTTACGTGTCCCGTGA-1	CM
GCTGAGCGTAGCTGTT-1	CM
TGGCGCAAGAGTCCGA-1	CM
ACAAGCTAGGCCTCTG-1	CM
GGATAGGGTGCACCCA-1	CM
ACTAGGTTCACATCCC-1	CM
ACAAAGACATACCCGG-1	CM
AGTGTACAGGCCAGTA-1	CM
TGTAAGCCAAGGGAGG-1	CM
TTCTAACGTCTAACCA-1	CM
TTCTGTAAGCATTGGG-1	CM
AACATCGAGGTGTCGA-1	CM
TACAGCAGTAAGGTCG-1	CM
AACGAGGAGGATTTGA-1	CM
GGAATCTAGAGGCAGG-1	Fib
GGATGAGGTAAGGTCG-1	Myeloid
ATAGGCTCAAAGGTCG-1	CM
ACAATCGAGAACGTCG-1	CM
GGAGTAGGTAAGTGCG-1	Fib
TATCTGTAGAGAGTAG-1	CM
GGAGAACGTTCGGGAA-1	CM
ATGTCGACATTGAACC-1	CM
CGTAAACCATTACTTC-1	CM
GAACCGCTCACCACAA-1	CM
ATGTCTTGTTTCTACT-1	CM
CACTGAATCTTCATAC-1	Endo
TTTGAGGCAAGGTTCT-1	CM
GTAGACTTCAAATGGA-1	CM
CCTGCTATCGTAGCGC-1	Fib
TTACCCGTCCATACCC-1	CM
GTTATTCTCATCATGG-1	Myeloid
TTCTGTAGTAGTCTGT-1	CM
TCTAGTTAGCAATGTA-1	CM
ACTACGAAGAGGCAGG-1	CM
AGTGTACGTTTCTCTA-1	CM
ACCAAACTCCTGACCT-1	CM
CTCTAGCTCCTGTGGG-1	CM
CTTTGCGGTGCAAAGC-1	CM
CAGTGCGCATTTGGCA-1	CM
GATGATCAGATGCGAC-1	CM
ATTCGTTTCTGATCCC-1	Neuronal
CACATGAAGCCTTTGA-1	CM
GGTGCTGTCTTAGTGG-1	CM
CCCACATTCTCCCTTT-1	CM
TTCGATTCATGCGACC-1	CM
GTCACGGTCAAGGCCC-1	CM
GTCACGGGTCGGCTGT-1	CM
CCCACATCAGTCCTGG-1	Fib
GCTTTCGAGAGGTGGG-1	CM
CTTGAAGCAGCACATT-1	CM
AAAGGATTCGGTACTA-1	CM
ATTACTCTCCCAGCAG-1	CM
CAAGCTAAGGACTAGC-1	CM
CGCTATCTCCAGGTAT-1	CM
TCACTCGAGAAATTCG-1	Pericyte
GACCAATTCTTACGGA-1	CM
TAATCGGGTGCAAGAC-1	Fib
AGGCGTCTCCGATTGA-1	CM
AGTCAACGTCATCGTA-1	CM
TGGACATCAGGCAAGT-1	CM
TTCATCATCAGATACC-1	CM
GACTAACTCCGCTATC-1	CM
GTGGATTCATCGCCTT-1	CM
GCGAGTCCAATTAGGA-1	CM
CACATGACAATGAAAC-1	CM
ACTGCAAGTTCTGAAC-1	Fib
ATATTCCTCGGATAGG-1	Endo
GTGGCGTTCGCATAAC-1	CM
AGTCCGGGTACTATGC-1	CM
GAGAACGTCGTGGCGT-1	CM
AACGAGGCAAGACTAA-1	CM
AAACTCGAGCCATCAT-1	CM
GAACCTAGTTCTGATG-1	CM
GATGATCAGTGCACAG-1	CM
GCTCACTGTTCTTTGT-1	CM
TGGCCTTAGAGCTGTG-1	CM
TTCTGTAGTCTGGTTA-1	CM
ACAGCGCGTTGGACGA-1	Endo
AGGCGAATCAGATACC-1	CM
CTCCCAAGTAAACCCT-1	CM
TAGCGGCAGGCACTAG-1	CM
CTGCTCACACAGAAGC-1	CM
CCACGTTTCGCTCTAC-1	Myeloid
GAGAACGGTACGCCCA-1	CM
TATGTTCAGGTTTCTG-1	CM
CTCAGCTCAATGGTAA-1	CM
CACATGAAGATAGGTT-1	CM
GGATGAGGTTCCAGTA-1	CM
GTAATCGCAGTAACGG-1	CM
GGAATCTAGAAGCCTG-1	CM
TTGCGAATCAACACGT-1	CM
AACGAGGTCGGCAATT-1	CM
GCTGTTCCAAACAGTA-1	CM
GAACCGCCAGATTAAG-1	CM
AAATGAGGTTACACTG-1	CM
GCCTACTTCTGGACAT-1	CM
AACCTTTGTTTCGACA-1	CM
CATTGGATCCCGGGTA-1	CM
TCCGACTTCGAGAACG-1	CM
ATGTCTTAGAAATACC-1	CM
CCTAAAGGTGATTCCA-1	CM
AGTGTACAGAACCATA-1	CM
ATTGTGGTCAGTCACA-1	CM
GGATAGGAGGAACCGT-1	CM
CTTCCAGAGGTGAACC-1	CM
GCGCCAAGTTACTACG-1	CM
ATTGTGGAGGATTGCG-1	CM
TTGCAGAGTGATAAGT-1	CM
AACAAAGCACGGCCAT-1	CM
TCAAAGCAGCCCATGC-1	CM
AGCTATGGTGAATCAA-1	CM
TACGCCTTCGCCACTT-1	CM
TGGCGCATCACAAGCT-1	CM
ATCCTGCGTTTGTCTT-1	CM
ACCGCAGGTCACTCTC-1	CM
CCTTGGTAGGTTAGTA-1	Fib
ACCGGGTGTTCACGTA-1	CM
TCAGCTCCAGATTAAG-1	CM
CCATACCCATCGTACA-1	CM
CAGCTGGGTATTCACG-1	CM
ACTAACGTCACTGATG-1	CM
CAGCTGGCATAGATAG-1	CM
ATAGTCGTCCACGCTT-1	CM
GCACGCAGTAGAATAC-1	CM
TTTGGCCTCGATAGGG-1	CM
CGCACAGTCCATCGAA-1	CM
AATGGAAAGCAGTAGC-1	CM
TTACCGCAGTACGCGA-1	Endo
AAATGCCGTAGCCATT-1	CM
CAATCCCTCGACTTAG-1	CM
ACAAGCTAGGCCAGTA-1	CM
ATATTCCCATGCCCTT-1	CM
CGGTGCAAGAACGACC-1	CM
GCCAGCAAGAGTAAGG-1	CM
CCTATTAGTCCCTAAA-1	CM
GTCGTAATCACTACCC-1	CM
AGCCTTCTCGGTCCGA-1	CM
AACTTGGTCCGCTCTA-1	CM
AGCCTCTAGAGCCACA-1	CM
CCCAGAGCAGTTGCAT-1	CM
CAATCCCCACATATCG-1	Myeloid
AGTGTACGTAACACTC-1	CM
GCGCATGGTAGCGGTA-1	CM
ATGTACGTCATTCGGA-1	CM
TACAGCACAAGAGATT-1	CM
ATTACCTTCTCTCAAT-1	CM
GATTGACAGGGTATCG-1	CM
GGGTTATAGGCTTCGC-1	CM
TCAATTCTCAAGAGGC-1	CM
CTTCCAGTCCTCAAGA-1	CM
TAGCCCTCACCTGTGG-1	Fib
TGCTCGTGTGCCAAGA-1	CM
ACATGCAAGGAACCGT-1	CM
GCAGCCATCGTTCTAT-1	CM
GCGGGTTTCCACTAGA-1	CM
GCATGATAGACTCTTG-1	CM
TGTGTCCAGAGAGGTA-1	CM
GACTAACTCGGGACAA-1	Endo
GCAACCGGTTAGAGAT-1	CM
ATCCTGCCAGCTATAC-1	CM
CTTCTAAAGAGAGTTT-1	CM
ATTGTGGGTCCGCTTT-1	Myeloid
TAAACCGCAAGCAGGT-1	CM
GCACCTTGTCAATCCA-1	CM
CAGGGCTCAGGGTAAC-1	CM
CAACGGCGTCAGGTGA-1	CM
AACTTGGAGTCCGTGC-1	CM
CTACAGATCCAGGGAA-1	CM
GGAGGATTCACTTACT-1	CM
CCTTAATTCAAACCCA-1	CM
ATTGTCTGTGAGGGTT-1	CM
GAACTTGCAGCGTAGA-1	CM
TAGGAGGCATTTAGGC-1	CM
CATGTTTCAGTAACGG-1	CM
GGTAGGATCGATGCAT-1	CM
GTGGCGTCATCCCGGA-1	CM
TTACCCGGTATTCTGG-1	CM
TATCGAGGTTATCGAC-1	CM
AGGCCTGCACTGTTAG-1	CM
AAACTCGTCCTCCATG-1	CM
TCAAAGCCAATGATGA-1	CM
CGGTGCAAGCCAGAAC-1	CM
ACCTGCTAGTACAACA-1	CM
GGGTGTCGTGCTTTGA-1	CM
TAAACCGCAGGTAGGT-1	Pericyte
ACTCGGGTCAGTGTGT-1	CM
TAAACCGGTTCTTTCA-1	CM
AGCCTTCCATATACGC-1	CM
GAGGATGTCCCGGGTA-1	CM
TGCTTCGAGTTGTCCA-1	CM
AATGGAATCTGATCCC-1	CM
CGCGCAATCGACTCGG-1	CM
ACAGCGCGTGACAAGC-1	CM
CGCACAGTCCTAGAGT-1	CM
GTAGTACTCCACGGCA-1	CM
GTCCATCGTACGACCC-1	CM
GCCAGACTCACTTACT-1	CM
TTGCGAAGTATTCGAC-1	CM
TCAGTCCGTTTCAGCA-1	CM
CCCTCTCAGGAAGGTA-1	CM
AGCTGGCAGCTTTCCC-1	Endo
CGTACAAGTATCTGCA-1	CM
TAGCGGCGTCTGGGCT-1	CM
GTGTCCTTCCGAATTG-1	CM
GCAACCGGTACAAATG-1	CM
TTAGCTTGTTGAAGCG-1	CM
AACCAACTCGCGCCAA-1	CM
TTTGGCCCATCCTCGT-1	CM
CTGTATTCAGGCAAGT-1	CM
TCGAGCGAGCGGACAT-1	Myeloid
TCAAGACAGGGTTCTT-1	CM
TTTGGCCGTACAAGCG-1	CM
TGATTTCCATCAGAAA-1	CM
TTTGTGTGTCTGGATT-1	CM
CGTTCCAGTAGAAAGG-1	CM
GGTTGCGAGGTAGGCT-1	CM
TAACGGTGTACAAGCG-1	CM
CACCACTAGTTTACGC-1	CM
CACCACTGTCCAACCG-1	CM
CTCGCTATCACATCCC-1	Fib
TCCAGAATCTTCCACG-1	CM
TAGGAGGGTGCAAAGC-1	Myeloid
TACTGCCAGAACCATA-1	CM
CGCAATAAGCTCGTTA-1	CM
ACTAGGTAGGATTTGA-1	CM
GCTGAGCTCATGCTTT-1	CM
GTTCAAGTCTTGTACT-1	Fib
CCACAGGAGCTCCATA-1	CM
GTCGTAACATTACTCT-1	CM
TGACTCCTCCCTATTA-1	CM
ACAGCGCTCCAGTACA-1	CM
TGTTAGGGTCGACTGC-1	CM
GCGGTGTCAGCTGATT-1	CM
GGGAACAGTAGGTAAT-1	CM
GAACCTATCCCGTAGG-1	CM
GAGAACGCATAGAATG-1	CM
TTAGGTGTCGAGTGTT-1	CM
CAATCCCGTTACTTTC-1	CM
TGCTTTAGTGATAGAT-1	CM
CCTTAATGTCATCAAC-1	CM
TGCTTTAGTAGTCCAT-1	CM
TTGAGCACAGTAGTCT-1	CM
TAAGTGCGTATTGTCG-1	CM
CAGCTGGGTCCGTCGA-1	CM
TCCCACAAGACCATAA-1	CM
TCTATTGCATTCACGA-1	Myeloid
CTTGCCAAGTTGTCCA-1	CM
CCGAAGCTCTGGGCGT-1	CM
AACGGGACAGTGCTCG-1	CM
AGCGTATAGTCGAGCA-1	CM
ACATGCATCATCATGG-1	CM
TATGTGGTCGGGATCC-1	CM
CTCTACGGTAGCGTTT-1	CM
TGCGTAATCCGTTAGA-1	Endo
ATCCTGCCATTACTTC-1	Myeloid
GTCACCTTCCGGGCAT-1	CM
GCCCAGAAGCAGAAAG-1	CM
GACCTTCTCTCTATCA-1	CM
TGTAGCAAGGTTCGAG-1	CM
AACCAACCAAACCCTA-1	CM
TTACTCAGTGCCAAGA-1	Endo
ACTATTCCACAAGTGG-1	Fib
TGTAGCAAGGTTAACA-1	Endo
TGACAACCATTTGGTG-1	CM
TAGGAGGAGCGTGTTT-1	CM
TCAGTTTAGCCTATAC-1	CM
AACCTTTAGAGCCACA-1	CM
TGTTAGGAGTGAACCG-1	CM
ATCGAGTTCTAGCAAC-1	CM
AGACAAAAGAAATCTG-1	vSMCs
AGCCAGCTCACGTGTA-1	CM
ATGTCTTTCTGTTGCC-1	CM
AGTTTGGTCGACTGGC-1	CM
GGCGTTGTCCTTACGC-1	CM
TTGGTCCTCGTTGTAG-1	CM
TTTGCGCTCGATTACG-1	CM
GCACCTTGTTTCTTAC-1	CM
TTCGTTAGTATCTGCA-1	CM
AGCTATGTCAGTGTAC-1	CM
TTGCACCTCTCATCCG-1	CM
TCAAGCATCCTCTCTT-1	CM
GTGGCGTAGTTGCTTG-1	CM
ATGTACGGTTTCCTAT-1	CM
CTTAATCAGGAATGGA-1	CM
GCTCACTGTGCAAAGC-1	CM
AAACGAACAGCCACGT-1	CM
GTTCAAGAGTAGACCG-1	CM
GGTTGCGCAATAGTGA-1	CM
TGTAGCAAGCGAATAT-1	CM
ATTGTCTGTAGTCCAT-1	CM
ACTGCGGCAGAACTTC-1	CM
CTTCCAGAGAAATTCG-1	CM
GTGCACGAGTCGTACT-1	CM
GTGCCAGCAAACAGTA-1	CM
TTAGGTGCAGTTGCAT-1	CM
TACCTATAGCATTGGG-1	CM
CCACAGGGTAGGTAAT-1	CM
CTTGTCGCATGCCCTT-1	CM
AGTCAACGTCTAAAGA-1	Fib
CGGACTGAGTACCTCA-1	Myeloid
CCTTGCACAAGTCTCA-1	CM
CCTTAATGTAGTGATA-1	CM
TGGCGCAGTATCTAGC-1	CM
TCACTCGTCACCCTTG-1	CM
ATGCATGAGGGTGTTG-1	CM
TAACAGCGTCATAGAA-1	CM
CATTGGACATGCACTA-1	CM
AAAGGGCGTTACTTTC-1	CM
ACGGATTTCTTAATCC-1	CM
CCCTAGTGTCTGCACG-1	CM
TGACAACGTTAGGAAT-1	Neuronal
TGTAGCAGTTAACCAC-1	CM
CATTCCGCATGTCCCT-1	CM
CCTATTACACAGCTTA-1	Endo
ATCCAGAAGGGAAATG-1	CM
TGACAACCATGGCCCA-1	CM
TACAGCATCTGGCACG-1	CM
GGAGGATAGAGGTCCA-1	CM
ACCATCCGTTTGACCA-1	CM
AGATTCGAGTCGACCC-1	CM
TTGAGTGCATTCACGA-1	Lymphoid
CTAGGGCTCTCGGCGA-1	Myeloid
GACCCAGCAGGAGCAT-1	CM
TACGCCTGTGAATCGG-1	CM
CGGACCAAGAGCGGTT-1	CM
AATACGCCATCGCTAA-1	CM
GTTGGGCTCTCGGCGA-1	CM
GTTACTTCATGGTAAA-1	CM
ATGCATGCACGTTACA-1	CM
CTCAGAACAACATAAG-1	CM
GCAGATTTCGCGGCAT-1	CM
CGGACCACAGGACTGA-1	CM
GCAGATTGTCACCCGA-1	CM
TACATGGTCTGAGTCA-1	CM
GTCACTCCATTGCACA-1	CM
TTGTTGTGTTCCGGCA-1	CM
AGCTATGAGGATTAAC-1	CM
CAGCTGGGTGATAGAT-1	CM
TTCGCGTAGCCTTTGA-1	CM
TCGAGCGGTGCGACCT-1	CM
GCAAAGGGTGATTCCA-1	CM
TGGTCAAAGTATACCC-1	CM
TCGAGCGTCCGAGGAA-1	CM
ACGTGGCCAACACGGA-1	CM
AGTGTACAGAGATTAC-1	CM
ACTAGGTTCCAGTACA-1	CM
TAAGTGCAGAGTGGAA-1	CM
AACCTTTGTAGCGAGT-1	CM
CAGTGCGCAGAGAGAA-1	CM
CACAACAGTACGGATG-1	CM
TGTAAGCCATCGGCTG-1	CM
CCTTAATTCTCGCGGA-1	CM
ACTTTCACAGTAAGCG-1	CM
GCGTTGGCATTACTCT-1	CM
CCAGAATGTGGGTAGT-1	CM
ACAGGCCGTCCATTGA-1	CM
GCGATTACAATTGTGC-1	CM
GAGCATTTCCGAGAGA-1	CM
TACCTCGAGCACCATT-1	CM
ATGTACGCATCGGCTG-1	CM
CGTACAACAGCAGGTA-1	CM
GATGATCTCTTGTCAT-1	Myeloid
TTACGTTGTGGGTAGT-1	CM
TGGAAGGAGGAAGAAC-1	Endo
AACCTTTCACGCGCAT-1	CM
TAAACCGCAAGCGTCC-1	CM
CCACGTTCACTCCACT-1	CM
TCAAAGCGTACGTAAA-1	Myeloid
GCCAGCACAGGTCCTG-1	CM
TTTACGTAGGAGGCGA-1	CM
TGTGACAAGAAGAGTG-1	CM
TGGTCAACATTGCGAT-1	CM
AGATTCGTCGCGCTGA-1	CM
TTATGTCTCTCTGAGA-1	CM
TACCCTGCAAACTACC-1	CM
GTTATTCAGCCTTTGA-1	CM
GCTGAGCTCCCGAAGC-1	CM
ACTGCAATCTCTGAGA-1	Fib
ATCCTCGTCTTGTCAT-1	CM
AACGAGGAGTAGAAGG-1	CM
TATCGAGTCTAGCAGT-1	CM
ATGTCTTAGTATAGTG-1	CM
GAAATGACAGGCAGAT-1	CM
TTCGATTTCCGTGCGA-1	Neuronal
CGCTATCGTTCCTATT-1	CM
TGTAAGCCATACCCGG-1	CM
GGCGTTGAGCATTCCA-1	CM
TCGGGACCAACTCCCT-1	CM
TTCGATTTCTATATCC-1	CM
GCTCAGGAGTCTCCAA-1	Endo
TTCGATTTCGAGCGCT-1	CM
GATTAGCTCCGGACTG-1	CM
TTGTTGTGTAGCTGTT-1	Myeloid
GTTATGGAGACTAGGC-1	CM
GCTCCTATCCAACGCG-1	CM
ATCCCTGGTCCTTATT-1	CM
TTACGTTCACGCGACT-1	CM
TTAGCGATCGATGTGT-1	CM
TCAAGCACAGAACAGC-1	CM
CTCGCTAGTCGGCTGT-1	CM
CATTCATGTCAGGTGA-1	CM
TATGTGGCATGTGGGA-1	CM
TGGCCTTCATAGCAGG-1	CM
CCAGAATAGTGATAAC-1	CM
AACAGTCAGTCTCCAA-1	CM
GCTTAAGGTCGTCGCA-1	Myeloid
ACAAGCTCAGGTGTCC-1	CM
ATGTCTTAGGAATGGA-1	CM
AGCTGATCACCAAGGA-1	CM
TTGCTTAGTTATGCAC-1	CM
CGTACAACAATGGTAA-1	CM
CTAGGGCGTGGTAGAC-1	Lymphoid
AATGGCTTCAGGATCT-1	CM
GGGTTATCAAGTGGCA-1	CM
TCAAGCACATACAACC-1	CM
GTACTTTGTATCTCAG-1	CM
TTTACGTGTAATGCAA-1	CM
TGACTCCCACTAGGAG-1	CM
TGCTCGTAGATAGGTT-1	Endo
TAGCCCTCACGCTAAT-1	Pericyte
GATTGACAGAAGGGCG-1	CM
CACCTTGCAATTCTCT-1	CM
AGCCAGCGTTCAGTAC-1	CM
AGCCGCACACAGTTCA-1	CM
CCTTGGTAGGTAGGCT-1	CM
GTACTTTCACGATATC-1	CM
ACTAGGTCAAGGAACC-1	CM
GAAGAGCTCGGATCGC-1	CM
ATAGGCTAGGATGTCG-1	Myeloid
GCTCGAGGTTTCCGGG-1	CM
AATGGAAGTAGCCATT-1	CM
TCGATTTTCTATCCTA-1	CM
TTTACGTTCACTGGTA-1	CM
CGATGATCACGGTTAT-1	Fib
GCATTGAGTCTGCGCA-1	CM
AGCCTTCAGATTCCGT-1	Pericyte
TGCATTTTCGACCCGA-1	CM
ACTGCGGAGTCTCTAG-1	CM
TCGGGACCACCGAAAG-1	CM
GAGGATGAGAGCTACG-1	CM
CAACCAAAGAGGTGGG-1	CM
AAAGGATCACAGGTAG-1	CM
TATGTGGTCCGCTCTA-1	CM
CAAGCTAGTCATTGCA-1	CM
TTGTCTATCGAACCGC-1	CM
GCCCAGAAGTTGTCCA-1	CM
AGTCCGGAGAAATCTG-1	CM
GGCATTAGTTAACCAC-1	CM
TTGACGATCGTCAACA-1	CM
CTAGCGGAGACTAATG-1	CM
TAGGTGTGTCACCCGA-1	CM
TTTGTGTGTGTCCAGC-1	CM
CCATACCGTGGGTAGT-1	CM
TTTGAGGAGTCGTACT-1	CM
TACCCTGTCCATCGAA-1	CM
TTCGATTGTCACATTG-1	CM
AAAGATGTCTGAACGT-1	CM
GCGTTGGCACATTCTT-1	CM
TCTCAGCTCGGGTCCA-1	Fib
ACCGCAGGTCAAGACG-1	CM
CCTTAATCACAAGTGG-1	CM
TGTGGCGGTAGACACG-1	CM
CCCTCTCCACATGATC-1	CM
TGCTCACGTATTGTGC-1	CM
CCCTAGTTCGCATAAC-1	CM
TTTGGCCGTAGTGATA-1	CM
TCCATCGAGATTCCGT-1	CM
TCAGTTTCAGTGCTCG-1	Fib
ACTTCCGAGAACGTCG-1	CM
GCAAAGGCACTAGGAG-1	CM
GCTCCTATCCTTACGC-1	CM
CCTGGGACACACACCG-1	CM
GAACTTGCACATATCG-1	CM
AGCCAGCGTGTTAGAA-1	Fib
TGCTCACCATGTAGAA-1	CM
CTCGCTAAGGCAATTA-1	CM
GTTGGGCGTGAATCAA-1	Fib
TAAGTGCCAAAGGAAG-1	CM
GCAGCTGTCAGCACGC-1	Fib
ACAAGCTGTTGCAGCC-1	Endo
TCAGGGCAGGCACCTC-1	CM
AATACGCTCGAGTTAC-1	CM
GACCAATGTCCAAGTT-1	CM
GATGGCCAGGGCTTCC-1	CM
TAGCCCTCAACGGACA-1	CM
TAGGTCACATTACCTT-1	CM
GTCCATCAGTCTCGAT-1	Myeloid
GCGTAGCAGAAGACTT-1	CM
AACGAGGTCGGACGAA-1	CM
GTGCCAGCACGTTGTA-1	Endo
GGTGAAGTCAGTGTAC-1	CM
TTGACGACAATTGCCA-1	vSMCs
CCTGGGATCAACACGT-1	Myeloid
TACGGATCACACTAGT-1	CM
GCGAGAATCGGACGAA-1	CM
TTAGCGATCGTGGTAT-1	CM
TTGCTATTCTTAATCC-1	CM
GGTGAAGTCTAGCAGT-1	Myeloid
ATCCTGCTCTCGTGAA-1	Fib
CTTAATCAGTAGAAGG-1	CM
CATTGGAAGACCATAA-1	Myeloid
ACCATCCCAGAGTCGA-1	CM
CTTCCAGAGGAAGACA-1	CM
ACAAAGATCCGAATTG-1	Myeloid
TCAGCTCTCGCAGATT-1	Fib
TCGAGCGCAAACTACC-1	CM
AAACTGCGTCCCGTGA-1	CM
CAACGTAGTCTGAGCC-1	CM
CAAGCTAAGGAGAACA-1	CM
GGGAACAGTCAAGACG-1	CM
GTACTTTTCAGTCTTT-1	Fib
ACAGCGCGTCCATTGA-1	Myeloid
TTAGGTGCAGGTGGTA-1	CM
AGGCCCAAGAGCGAAA-1	CM
AACCGATTCCTAAAGC-1	CM
TGAATCGAGTCGTACT-1	CM
GCTCCTACAGAAAGAG-1	CM
TCACTCGTCTCTGAGA-1	CM
TGTGTCCCATCCGTGG-1	CM
AGCCGCACACGTACAT-1	CM
GGGAACAAGTCCCTCT-1	Myeloid
GCGAGTCGTTCCCTTG-1	Myeloid
GTCTACCTCTTCATAC-1	CM
TATGTTCAGTGTTCCA-1	CM
GCAGATTGTACTATGC-1	CM
CGAGTTAAGTGCCCTG-1	Lymphoid
GCCCGAACAATGAAAC-1	CM
GCAGCCACAGAAAGAG-1	CM
TTCATCACATAGTCCA-1	CM
TATTGCTAGCTTACCA-1	CM
GCCCGAAGTGCAAGAC-1	CM
ACTAACGTCAGTCAAC-1	CM
ACAGGCCCAGCGTAGA-1	CM
TCGTTCGGTCAGGCTC-1	Fib
TCCAGAAAGAGGTCCA-1	CM
TGTGGCGCAGATTTGC-1	CM
TTAACGGTCACTGATG-1	CM
TTCTAACAGATCTCAC-1	CM
CACAGATAGTCTCTAG-1	CM
AGCTGTACAGGACCTC-1	CM
GAACTTGAGCAGAGCT-1	CM
GCGTTGGCACTGCTCT-1	CM
CTCTACGTCAAACCCA-1	CM
TGATCAGAGGGCTTCC-1	CM
ACAGACTTCCCAGCGA-1	Endo
CTAGGGCCACTGAAGG-1	CM
CTCGCTAGTTGCAGAG-1	CM
TGTGTCCTCGCGTTCT-1	CM
AACAAAGGTGTCTCGG-1	CM
TGATGCAAGTGGACGT-1	CM
CGTACAATCTCTGACC-1	CM
TGTGACAAGCAGAGCT-1	CM
CCCTAACAGACCCATT-1	CM
TACCTATTCCAATCCC-1	CM
TACTGCCTCGGTGATT-1	CM
ACAGAAAGTATACGCT-1	CM
ACCGCAGCATTTGGTG-1	CM
CCATACCCAATCATCG-1	CM
CACTGAACAGGATGTG-1	CM
ATCCAGAGTTTAAGGA-1	Fib
CCTTAATGTGTGACCC-1	CM
TATCTGTGTCAGGCTC-1	CM
TGCATTTAGCTGAATA-1	CM
AGCGTGCGTGATGCGA-1	CM
AACCTTTCAACATAAG-1	Myeloid
AAATGCCTCGTCAACA-1	CM
TTCGGTCTCGAGTTAC-1	CM
TTACGGATCGCTTCAC-1	CM
TACTGCCGTACTAGAA-1	CM
AACAGTCGTTTGATCG-1	Myeloid
TGGCGCAGTGCTGTCG-1	CM
AAAGGATGTCAAGACG-1	CM
GCGCCAATCCATATCT-1	CM
GGTACCGGTTCGGGAA-1	Fib
TGAGCCGCACGTACAT-1	CM
TTTACGTTCCTCCTGA-1	CM
TGAATCGCAATTAGGA-1	CM
GTAGGAGGTCTGAGCC-1	CM
ATAGTCGCAAGCAGGT-1	CM
GTGTGATAGCCAGAAC-1	CM
CCCTGATCAAGCAGGT-1	CM
AGTGCGCCAACCTCCT-1	Pericyte
GTGATCAAGTTTGGAA-1	CM
ACTCGGGGTCGGCTGT-1	Fib
TGATGCACATAAAGTG-1	CM
CTTTGCGAGAGACTCG-1	CM
GTCACCTTCTAGTCGA-1	CM
CTTGAAGGTGAATCGG-1	CM
CGTACAACAAACGACG-1	CM
ATTACTCTCGAACACT-1	CM
CCCTAGTCATAGCCAT-1	CM
GAGGATGCATGATCGT-1	CM
ATGTCGACACAGTTCA-1	CM
TGAATCGGTGAGGTCA-1	Fib
CCAGATACATAGATAG-1	CM
AGCGATTGTGCTTACA-1	CM
TCAAAGCGTCTCTGCT-1	CM
TAATTCCGTCAGCTTA-1	CM
CCACAGGAGTGAATAC-1	CM
TCAAGACCACCTCGTT-1	CM
TTAACGGGTCCCTAAA-1	CM
GGATAGGCAAAGAGAG-1	Endo
GCAGCCAGTGGAAGCT-1	CM
ACCGAATAGCTCGTTA-1	CM
CAAGGCCGTTTCCACC-1	CM
CACGTTCTCCACACCT-1	CM
CTGCGTTTCTCCAACC-1	CM
CCATACCCAATGCACT-1	Endo
GTCACTCGTTCTCGAA-1	CM
GTGATCAGTTGTATCG-1	Fib
TGGGTTATCGTGATAC-1	CM
CGGACCACACTGTAAC-1	CM
AAGGTTCGTTTGCCAA-1	Endo
CGAGTTATCTCTTAAC-1	CM
AATGGAAAGTGCTAGG-1	CM
GCACCTTCAAAGGAAG-1	Myeloid
AACCTGAAGCAGGACT-1	CM
TACATGGGTTTAGGAA-1	CM
CTTTGCGGTAACAATG-1	CM
AGCCAGCCATCCCTCA-1	Fib
TACGCAAAGTCGAGCA-1	CM
AGACAAAAGGTACACG-1	vSMCs
TAGCCCTCATTGTGAC-1	CM
ACGTGGCAGTAGTCGG-1	CM
CTTCCAGTCATTGCCC-1	CM
GCAACCGAGTCGTACT-1	CM
CTCAGCTAGTGCAACG-1	CM
TAAGCCAGTGCACATT-1	Myeloid
ACATGGTAGAGACTCG-1	CM
ATCCAGAGTAAACGGC-1	CM
CTGGCAGAGATGAGGA-1	CM
GCCTAGGGTTAGGAGC-1	CM
GAACCGCTCAGCACGC-1	CM
GGAATCTTCCCAATGA-1	CM
CGTAAACTCTCATCCG-1	Pericyte
TCAGTCCGTGGTAAGC-1	CM
CCAGAATAGGTAGGAA-1	CM
TGCATTTGTGCTTGAT-1	CM
ACTATTCTCCTCCATG-1	CM
GCGAGTCGTGAGTAAT-1	CM
AAAGATGCATGCGTTA-1	Fib
CTTTGCGCAACAAACA-1	CM
ACAGACTAGTTCGACT-1	CM
TACCCTGTCCCACTTG-1	CM
TAGTCCCAGCGTAGCA-1	CM
TGTACAGCACGCGTTG-1	CM
GGATAGGTCATCGCAA-1	CM
GCCCGAACACTTATGG-1	CM
GTGACATGTTTCGATG-1	Fib
ATCCAGAAGGAGAACA-1	CM
TGGTCCTCAAGGCGTA-1	CM
TTTGCGCAGTTAGCAA-1	CM
GCAGCCAGTCGACTGC-1	CM
CTGGGACGTGTGTGTT-1	Fib
ATTCGTTGTAGGGTTG-1	Fib
TTTGGCCTCAACGTGT-1	CM
CTTGAAGAGACGTCAG-1	CM
CTGAATGAGCCATCAT-1	CM
CACCTGTCATCCCAAA-1	Fib
ACCGGGTAGCTGAAAT-1	CM
TTACCGCAGTAGTTCC-1	CM
GTGCACGAGGCCTCTG-1	CM
GCCAGCACAAACAGTA-1	CM
CCAATGAGTTGTGAGG-1	CM
TGCTTCGTCGGTACTA-1	CM
CGGTGCAAGTTCAACC-1	CM
GCACCTTGTGCACTTA-1	Fib
GCGGAAAAGGTCCTCG-1	CM
ACGGATTCACGTTGTA-1	Endo
CGCAGGTCAAGATGCG-1	CM
AGTTTGGGTCATCGTA-1	CM
GACCTTCAGTATAGTG-1	Fib
GTTATGGTCGCTGATA-1	Endo
TCACCACCAAGCTTTG-1	CM
GAGGCTCCACCCTTAC-1	CM
CACGTTCCACTGGGCT-1	CM
GAAGTGGCAAATTGAG-1	Myeloid
AAGGAGCTCCAGGTAT-1	CM
GAACGTTCAAAGAGAG-1	CM
CGCACAGAGCATGTGG-1	Fib
ACCGGGTCATCGCCTT-1	CM
CCACGTTAGTTCCCGG-1	Fib
CGGACTGAGAAGCCTG-1	CM
TGCTTTATCTCGTAGA-1	CM
TACATGGGTCTGTTGA-1	CM
TCAGGTAGTCAGCAAG-1	Endo
CAAGAAAAGCCCATGC-1	Pericyte
ACCGAATCAACGACAG-1	CM
AACCTTTCATTTGTTC-1	Myeloid
TACCCTGCATCTCACC-1	CM
TGGCAATAGTCCGTGC-1	CM
AAAGGGCGTAGAATAC-1	CM
CCCACATCACTAGGAG-1	CM
TTCGTTAGTACAACGG-1	CM
TAGCCGGTCCTGGGAC-1	CM
ATCCAGATCAGGAAGC-1	Myeloid
GTGGATTTCGCGTTCT-1	CM
GTTATGGAGAAGAGTG-1	CM
ACGTTAGCATGGCCTG-1	Endo
CAGTATGCATTAGCAC-1	CM
TGACAACAGAAGACTT-1	CM
CCAGAATTCTAGCTGA-1	CM
CAACCAAAGACTCGGA-1	CM
TAGGAGGGTAGAAGCC-1	CM
TACCTATAGGATCCTT-1	CM
AGCCTTCCAAGGGAGG-1	Endo
ATTACTCGTATCAGCT-1	CM
CCAGATACACTGTTAG-1	CM
GTTGGGCTCTGGCGCA-1	CM
TTCTGTAAGCATTCCA-1	CM
CATGCCTCACGCGTTG-1	CM
TCGAGCGAGAGCACTG-1	CM
TAGTCCCCAAGTCTGT-1	CM
CGATGATAGTGCTAGG-1	CM
CTAACTTCAGCACATT-1	CM
CTAACTTCAGTAGTCT-1	CM
TGGTCCTAGTCAGGAC-1	CM
GCGGTGTTCACTCCCA-1	CM
TAGCTTTCAAGTTCGT-1	CM
ACTAGGTCATACTGCA-1	CM
GCGGAAAGTACGTAAA-1	CM
TCACTCGAGAAGCCGT-1	CM
CGTTCCAAGGATTAAC-1	Fib
GATTGACCAACTCCCT-1	CM
TGATCAGTCATGAACC-1	Fib
GGAACCCGTCACCCGA-1	Myeloid
GCAGCTGCATGTATCG-1	CM
CTGTATTGTACGTAGG-1	CM
TTGCTTACAGTAACCT-1	Fib
GTCGTAATCGGTTCCT-1	CM
TTGCGGGAGAATCAAC-1	CM
CGTACAAGTGTGCTTA-1	CM
ACAAACCTCGTCAACA-1	CM
ATGTCGAGTGAATCAA-1	CM
TAGACTGAGTTACCAC-1	CM
CTCGCTATCTACCCGT-1	CM
TTGAGCAGTGCTGGCT-1	CM
CAGTATGCAGATTTGC-1	CM
TGATGCATCGCTAGTA-1	CM
TCACCACCACGCGCAT-1	Endo
GGTGAAGAGACCGCAA-1	Fib
GGGTCTGAGTTCAAGA-1	CM
ATGGATCGTTACTACG-1	Fib
ATCGAGTCATTCACGA-1	CM
AACCAACAGGGTTCTT-1	CM
CAAAGCTAGTTACCAC-1	CM
ACAAACCGTAAGCCGA-1	CM
CCTATTAAGAAATACC-1	CM
GGTGAAGTCGAGCGCT-1	CM
GCCAGCAAGCTTCAAC-1	CM
CAGTGTATCGACTATG-1	Fib
TTACCCGAGCAATGTA-1	CM
TAACAGCTCTCTTCCT-1	CM
CAGCTGGCAAATGTCC-1	CM
GGGTCTGGTGATAGAT-1	Fib
TGCATTTTCGTTCAGA-1	CM
CTAGCGGGTAGAAGCC-1	CM
GTTCAAGAGGTGAACC-1	Fib
GAAGTGGGTTCTGAGT-1	CM
TACATGGAGACACGGT-1	CM
GAACCGCTCTTACCTA-1	Myeloid
TTAGCGAGTGTAGGAC-1	CM
TGCTATTCATTCCCGT-1	Myeloid
CGCTGGAGTGATGTGG-1	Myeloid
ATGTCGAAGCCATCAT-1	Endo
GAGGATGGTATCTGCA-1	CM
CTTGCTGGTTTGAAGA-1	Fib
CAAAGCTAGGATGCCA-1	Fib
TTGAGTGGTATGAAGT-1	CM
TTACCCGGTCATCAAC-1	CM
GAAGTCTTCTCGGCGA-1	CM
GTCACGGTCGCTATAG-1	Fib
CAGGGCTTCCATGTTT-1	CM
AACGGGACATCGTACA-1	CM
TCCCACAAGCGTTAGG-1	CM
AAACTCGAGACACGGT-1	CM
TGATTTCCATATACGC-1	CM
GTCACAAAGTTATGAG-1	CM
TACCTCGGTTTCACCC-1	CM
GCAGCTGGTGGCATAG-1	CM
GTGTGATGTAACACTC-1	CM
ATGTTTCAGTCCGATT-1	CM
TTGTTCACAAGTAACA-1	CM
CATTGGAGTACCCATA-1	Myeloid
CTCTACGGTTCCAGTA-1	CM
GTGTCCTAGTGTGTAA-1	CM
AACCGATCAATACTGC-1	CM
CCCACATTCACTTACT-1	CM
TAGCGGCTCTGGCTAA-1	CM
AACAGTCCAACGCACC-1	CM
ACAGAAACATGGGTGA-1	CM
AGCGATTAGTGCTAGG-1	Myeloid
CACTAAGGTTTGACCA-1	Pericyte
GCTTGCTCAAGGAACC-1	CM
CTGTATTAGGGAGTTC-1	CM
GGGTGTCAGCCATTCA-1	Endo
AATGGCTGTACGGAGT-1	vSMCs
CATGCCTAGCCATTCA-1	CM
TGCATGACAATTGCCA-1	CM
CTTGCTGGTGGACCAA-1	CM
GTCACCTTCTCGCGTT-1	Fib
GCGGAAAGTCAACTGT-1	Endo
TAGGAGGTCCGAATTG-1	CM
GAAGTCTTCTATCTCA-1	Myeloid
TGTTAGGAGTGATATG-1	CM
AGCTATGAGTACAGTA-1	CM
CTCTAGCTCGACTGGC-1	CM
TTACGGACACTCCTCA-1	CM
CACAGATGTGATAACA-1	CM
TTATGTCAGTAACATG-1	CM
ACTTTCAGTCTGCGCA-1	Myeloid
GCAGCTGAGACTTGAA-1	Fib
GTTATTCGTATTCTCT-1	Endo
CCTTAATGTACGACCC-1	CM
GGAATCTGTCTAACCA-1	CM
TACTAGGAGGGTTCCC-1	CM
TCAAAGCGTCCCTAAA-1	Fib
CAAGGCCCAAACCGAG-1	CM
TACTAGGCACACACCG-1	CM
TGTGGCGTCCATATCT-1	Fib
GCGATCGCATGGTATC-1	CM
TGCTCGTCATAGTCCA-1	Fib
TAGGTGTAGCATTCCA-1	CM
TTCGCGTGTTTCAGCA-1	CM
AAGGAGCCACCACCAG-1	CM
ACGGATTGTATTCACG-1	CM
CCATACCGTACTTCAG-1	CM
GCATTGATCCCACGGA-1	Fib
GACCTTCGTAGTATCC-1	CM
GCCTACTAGAGGTGGG-1	CM
ACCTGCTGTGAATCGG-1	CM
GCTCCTATCATCGCAA-1	CM
GACTAACGTAACGGTG-1	CM
GAAGTGGGTGGTAAGC-1	CM
ATGTCGAAGAGGAAGT-1	CM
GCAACCGTCAGTACAC-1	CM
GCACGCAAGGCGACTA-1	CM
TGCTCGTGTCCAAGTT-1	CM
GTCACTCTCCATATCT-1	CM
TCGTTCGCATAGATAG-1	CM
AGGCCCACACTACACA-1	Myeloid
ACAATCGGTAAACCCT-1	CM
TTTGAGGAGCTTACCA-1	CM
AAAGGGCCAAGCACTT-1	CM
TGTGGCGCACAGCCAC-1	Myeloid
AAGATAGCAAGGAAGA-1	CM
ATTCGTTTCTGGCTAA-1	Myeloid
TAGCATGTCTGTGTGA-1	CM
AGCCGCATCCACGCTT-1	CM
CTAGCGGTCGTCCCAT-1	Myeloid
CCTGCTATCAATTCCT-1	CM
TTCATTGAGTACGCGA-1	CM
GCTGAGCAGTTCTCCC-1	CM
CTTCCAGTCGGTCGAC-1	CM
TGTAAGCTCAGTCTTT-1	Myeloid
GTGTCAAAGTTTACGC-1	CM
TGGGTGCTCAATTGGC-1	CM
GAAAGTATCCACGCTT-1	Endo
AACCGATGTACGAGAC-1	CM
GGGAACACATGGATGG-1	CM
TTGCGGGGTCTGATTG-1	CM
GCCCGAAGTAACCATC-1	CM
TTACTTGAGGAGACTC-1	Myeloid
CCAATGATCTTGTACT-1	CM
CTTGCTGAGAGCTACG-1	CM
GGAACTTAGAATCAGT-1	Fib
GTCACTCTCCGATGCG-1	Fib
AGCCTCTGTAACATAG-1	Endo
AGCTGTATCACGATTG-1	Pericyte
ACTAGGTTCCTGACCT-1	CM
CTCACCACAATGTAAG-1	Fib
TTCGGTCTCCGTTAGA-1	CM
TTGTCTATCCTCCATG-1	CM
CTGCGTTTCGTCCCTA-1	CM
GGAGTAGTCTCTGTTA-1	CM
AGCCAGCTCCCGATTC-1	CM
TCGTTCGTCGCAAACT-1	CM
TGTGTCCAGCCATTCA-1	CM
TTTGCGCTCGCACAAT-1	Fib
AACGAGGGTACGACCC-1	CM
CAGCCTTAGGCCTCTG-1	CM
GTACTTTGTCTGGTTA-1	CM
CGTGGCAAGCTGAATA-1	Myeloid
TAAGCCACAGAGAGAA-1	Myeloid
CGTTCCAGTCTCTGCT-1	Myeloid
CACCACTAGCGAGCTA-1	Lymphoid
AAGGTTCTCTGACTTT-1	CM
CAATCCCAGAGCAGCT-1	Pericyte
GATGGCCAGGTTTCTG-1	CM
AACGGGAAGAGAGTTT-1	Fib
CGGACTGGTTATCGAC-1	CM
GCTTGCTCAAGCGACA-1	CM
CAAAGCTTCTTCCGTG-1	CM
ACAGAAATCAGTCAAC-1	CM
CCTAAAGCACGTTAGT-1	Myeloid
GAGTGAGAGGTTCGAG-1	CM
ACATGGTCACTAGGAG-1	CM
GCATTCCGTGCACATT-1	CM
CCGTGAGGTAAACGGC-1	CM
TATGTTCAGACGACTG-1	CM
CCGTGAGCAAGGCTTT-1	CM
GAAAGTATCTATCTTG-1	Myeloid
TGCTTTAGTTAACCAC-1	CM
TAGCCGGCATAGACGG-1	CM
ACTGCAAGTGAATCGG-1	CM
GAACTTGTCGGCAATT-1	CM
TGACTCCCAGCGCGTT-1	CM
GTCTACCCATGCTATG-1	CM
CCCAGAGGTAAGCCTT-1	CM
GAACCGCAGAGTAAGG-1	CM
TGCCTGTCATAGGCGA-1	CM
GCTCAGGAGACGCCCT-1	CM
AATGCCAAGTCTCTAG-1	CM
GAGCATTAGTAGAAGG-1	CM
TCAAGCATCCGTTTCG-1	CM
TAACAGCTCCCGCAAG-1	CM
GCTGTTCCAACGGGTA-1	Myeloid
TACTAGGGTGCGTCCA-1	CM
TCGGGACTCGCGCTGA-1	CM
TTTGGTTGTTGAAGCG-1	Fib
GTTATGGAGCTTACCA-1	CM
TTGCACCTCGCGCTGA-1	CM
CTCAGCTCATGGCCGT-1	Fib
GAGAACGGTGGTACTT-1	Endo
AACGAGGCAAGGGTAC-1	CM
CATGTTTCATGTGGGA-1	CM
GATTAGCTCCACTAGA-1	Myeloid
AATGGAAAGTTCAGGG-1	CM
CTAGGGCGTTAGAGAT-1	CM
CCCTAACTCATTGCCC-1	CM
AGTTACGAGATGCGCA-1	CM
GCCCGAATCCACACCT-1	CM
TTGGTCCAGTAGTGTA-1	CM
CGGTGCAAGCGTCTGC-1	CM
AACATCGGTTCCAATG-1	Pericyte
GAACTTGTCATGTTCT-1	Pericyte
ACCAAACGTCAGAAAT-1	Myeloid
TAGGAGGTCGACGGAA-1	CM
AAATGAGTCCATGTTT-1	CM
TACGCAACATCGGCTG-1	Endo
GGCATTACAAGGGAGG-1	CM
TTTGCGCAGAACCCGA-1	Fib
ATTGTCTGTCAGCAAG-1	CM
GATCGTAAGTACTCTG-1	Fib
GATCGTACACCACAGC-1	CM
TCAAGCAAGATGCGCA-1	CM
TGCTATTGTGCGTAGA-1	CM
ACGGATTTCTCTGCGT-1	CM
GCGGGTTAGGGAAATG-1	CM
GCGCCAACAGCACATT-1	CM
CAAAGCTCAAGTTGCT-1	Pericyte
AGCCAGCAGAACTAAC-1	CM
ACAGAAAAGCGATACG-1	Fib
CCTTAATTCGACTTAG-1	CM
GTGTCCTTCGCCAGAC-1	CM
CTGGGACGTCAACAGG-1	CM
TAGCCGGTCATTCATC-1	Pericyte
ATGGATCAGGGTCTGA-1	Fib
GGAGTAGTCCAGGGAA-1	CM
GCTTGCTGTCAACTGT-1	CM
CAAGAAACAGGTGTCC-1	Endo
CGGTGCAAGTCGTGAG-1	Myeloid
CTCGCTAGTAACACTC-1	CM
GTAGGAGTCTTGGCCT-1	Endo
TACCCTGAGAACGTTA-1	Fib
AGCCTGGGTAATGCAA-1	CM
AACAGTCCAAGGTTCT-1	Myeloid
CCCAGAGGTTTGGATC-1	Myeloid
GAACTTGCAAATGTCC-1	CM
GACCAATCAAGTTGCT-1	CM
TTGCGGGGTTACCACA-1	CM
GAAACAATCTCTATCA-1	CM
GCGCCAACACGCGTTG-1	CM
GCTGAGCGTCAATCCA-1	CM
TCGATTTTCGCCCTTA-1	Fib
CTCTCGAAGGGTGTTG-1	CM
ACAAGCTTCCAGAGAG-1	Fib
GCACCTTTCCCGAAGC-1	Fib
TAGGAGGTCAAGGCCC-1	CM
CTCAACCCACAGAAGC-1	Fib
TTGCTATTCGGTACTA-1	CM
GCTCGAGTCAGTTGAC-1	CM
GGCGAAAAGTAGAAGG-1	CM
TTGCACCGTGCTTTGA-1	CM
GTTGGGCGTTTCTCTA-1	CM
CACTGAACAAGGGAGG-1	CM
CCCTAGTGTGGCCTCA-1	CM
TGTGTCCGTTCCCAAA-1	CM
GGTGCTGGTTCCCTTG-1	CM
TAGCCGGCATGCTATG-1	CM
TTTGGTTCAGGGTAAC-1	CM
TTCGATTAGTTGAATG-1	CM
GTTATTCCATGGCCGT-1	CM
CCCTCTCTCAGTCTTT-1	Pericyte
ACCAAACGTAAGGTCG-1	CM
GCAAAGGTCGCTTACC-1	CM
AACTGTGCACACATGT-1	CM
CTTGTCGTCTGACATG-1	Fib
AATACGCTCAAGGCCC-1	CM
CTTGTCGGTTTGCCAA-1	CM
CTTAATCGTTGGTAAA-1	CM
ACTGCAACAATGGTCT-1	CM
GCAGCTGTCAGAATGA-1	CM
GGCACGTTCCATATCT-1	CM
ATGTCGAAGTTAGCGG-1	CM
CCACGTTTCAACGTGT-1	Pericyte
TTACTCAAGGAAGACA-1	Neuronal
TGCCTCATCGACTATG-1	CM
CTCAACCGTTCCCGGA-1	Myeloid
GGATGAGAGTCAGGAC-1	CM
GAAAGTAGTTGCAGCC-1	CM
TCACCACTCGATATGC-1	Endo
GAACGTTTCGCCAGAC-1	CM
GTGTGATAGACGAAAG-1	CM
AGGCGAACAAACTACC-1	CM
TCAGCTCCACATTGCA-1	Lymphoid
CCTTGGTTCAGGAAGC-1	CM
CTCCCAAGTAGCGAGT-1	CM
CAACCAAGTGTTAGAA-1	CM
GTGTGATCAAAGGTCG-1	Endo
AGTTTGGTCGTTGTAG-1	CM
GTGTGATTCGGGAAAC-1	CM
GAGGCTCAGACACGGT-1	CM
TAGCATGAGAGCTACG-1	CM
CTGCGTTCACGTTAGT-1	CM
CAAAGCTCAGTTCGGC-1	CM
TCAAAGCTCCGAGAGA-1	CM
TCTCAGCTCACTAGGT-1	CM
TCGCCTAAGACTCGGA-1	CM
TGCATTTCATCAGAAA-1	CM
TACATGGGTACAAGCG-1	CM
CCGTAGGTCAAGAGAT-1	CM
GACCCAGTCTACCCGT-1	CM
ACTGTCCCATGGGAAC-1	CM
GCAACCGCACTGCTCT-1	CM
ACTAACGGTCCCGTGA-1	CM
ATGTCGACAAGGAAGA-1	CM
GTGCCAGAGTGCCCTG-1	CM
GCTGCGAGTACTTGAC-1	CM
TAATTCCCACACTAGT-1	CM
CGCAGGTCAGGTGGTA-1	Endo
ATGGATCAGAGGCAGG-1	Myeloid
TGATCAGCAGTCCTGG-1	CM
CTCGCTACAATTCTCT-1	CM
CAGGGCTCAATAGTGA-1	CM
ATTGTCTTCTCGACCT-1	CM
GTTATTCTCACTAGGT-1	Fib
TGGTCCTGTAGCGTTT-1	Fib
AAAGATGTCCAAGAGG-1	CM
TAGCACACAATGTGCT-1	CM
AGTGCCGTCCGCGATG-1	CM
TGCTCACAGACTAGGC-1	CM
TCCGACTCATGCGACC-1	CM
TTGAGCAGTAGCAGCA-1	CM
CCCTCTCAGTCGTGAG-1	Fib
GAACCGCTCTCTGACC-1	CM
CGCAGGTGTCAGTGCC-1	CM
GGAATCTGTTACCCAA-1	CM
TTGTTCATCAACTTGG-1	CM
TATTGCTCACTTATGG-1	Fib
GTTACTTCAAACAGTA-1	CM
GTGGCGTGTAGCTGTT-1	Endo
ATGTCGAAGAAGCCTG-1	CM
AATGTCGTCTTCCGTG-1	Endo
ACGGATTGTACAACGG-1	CM
TACGCCTGTACGGTTT-1	CM
AGTCAACAGACACGGT-1	Endo
AGTGCGCTCAAGGCCC-1	CM
TACGCAATCGTCGCAG-1	CM
AATGGAAAGTTGACAA-1	Myeloid
AGCTGATTCGCTTGAA-1	CM
GAACCGCAGAGAAGCA-1	Fib
CCCTCTCCACAATAAG-1	Fib
GGCGTTGTCACCCGGA-1	CM
CGGTGCAGTACTATGC-1	Fib
CCCAGAGTCTTACTCA-1	CM
AGCCTCTTCGCGATGC-1	Myeloid
GTGGATTTCACAGGGA-1	CM
TCGCAGGGTATGTTCG-1	CM
AGGACGATCTTACTCA-1	CM
GCAGATTCATAGCCGC-1	CM
AGCCGCAGTAGCGTTT-1	CM
TATCGAGTCGCGCCAA-1	Fib
AGTTTGGGTTAACCAC-1	CM
TGCTCACAGTTCTCCC-1	CM
GGAACTTGTCAGTGCC-1	CM
CGTACAAGTGCTTACA-1	Myeloid
ACTGCAAAGTGCAACG-1	CM
TACATGGAGACCATAA-1	CM
TTGCCCAGTACTTCAG-1	CM
AATGGAACATCATAGC-1	CM
ACTACGAAGGGTAATT-1	Myeloid
AAATGAGCAAGGATGC-1	Fib
AGCGTGCTCGCGCTGA-1	CM
GCACGCAAGTCTTAGC-1	Endo
GCAGCCAAGCAGGAGG-1	CM
ATTGTCTGTTGCCTGG-1	Fib
CTCTCGAAGGCTCAGA-1	CM
GCGAGAAAGCGCGTTC-1	CM
TCAAGGTGTCACTCTC-1	CM
GTGCACGCATGCACTA-1	CM
GATGGCCGTAACCCAT-1	CM
AACGTACTCCCAGCAG-1	Fib
GCTTAAGCAACGCAAG-1	CM
AAACTCGGTGTAGGAC-1	CM
TTGACGACACTCAAGT-1	CM
TTGTCTACAGAGCCAA-1	CM
CTCATGCGTTAACTCG-1	CM
GGCGAAAGTCATAAGA-1	Fib
TTGCCCATCAGGTCTA-1	Endo
CCAATGACACCACGAC-1	CM
TGCACCTGTGACCAGA-1	CM
GTCACAAGTGTGTGCC-1	Endo
CAATCCCGTGTCTACA-1	Fib
GAGGATGGTAAGTCTC-1	CM
TACCTCGCACTGTTAG-1	CM
TTCGCGTAGTGAACCG-1	Pericyte
ACGTGGCCACGCTAAT-1	CM
TAGCTTTTCAAACCAC-1	Endo
TCCGACTAGACGCCCT-1	Fib
GCCATAATCGCGCTGA-1	CM
GCACGCAAGTGTCCCG-1	CM
ACAGGCCGTTAGTAGA-1	CM
GTGGATTAGAATATCG-1	CM
TAGGTCACAGACTAAA-1	CM
CATGCCTTCCGCGATG-1	Myeloid
AATGGAACATTTAGGC-1	CM
ACTACCCCATCTGCAA-1	Myeloid
GCCAGCACACTCGCAG-1	CM
GAAGTCTGTACCAAGG-1	Fib
ACTAGGTTCTGACTTT-1	CM
GTCGTAATCCAGAGAG-1	Fib
ATAGTCGGTTAACCAC-1	CM
TTGCCCATCGAGGTAG-1	Pericyte
TGAGCCGTCCGCCTAT-1	CM
ATAGTCGCACTGTAAC-1	Myeloid
AACTGTGGTTTGTAGC-1	CM
GCTTGCTGTTTAAGCC-1	CM
CCTTGCATCGTTTGAG-1	CM
TGTTAGGCAGTGCTCG-1	Myeloid
TGGCAATCATACTGCA-1	Myeloid
AGCCGCACAAGGCGTA-1	Fib
TTGCCCAGTAAAGGCC-1	CM
GCCAGCAGTGCACTTA-1	Fib
CTTGAAGGTGGGTAGT-1	Fib
TGGCAATGTTTCGTTT-1	CM
CGATGATAGCTGGAGT-1	Fib
GTCACGGTCACTTACT-1	CM
AGTTTGGGTCTGGTTA-1	Myeloid
CGCACAGAGTGCTGAG-1	CM
CTTGCTGAGTTAGAGT-1	CM
GCAGCTGAGATGTTCC-1	CM
AGTGTACCAAGGACCA-1	Endo
TTCATTGCACGATTAC-1	CM
TTTGGTTTCGAAGCCC-1	CM
TCAATTCCACACTAGT-1	CM
ATGGATCAGTTCGTTG-1	Fib
GTAATCGAGTTCGTTG-1	Endo
CAGCTAAGTTTAGAAG-1	CM
GTCACAACAGTTCGGC-1	CM
TAGGAGGCAAGGCGTA-1	Pericyte
GTGGCGTGTCTGGTTA-1	Fib
TAGCTTTCAGTGGTCC-1	Fib
TTAGCGACATGGAGGT-1	Fib
CCTTAATTCTATATCC-1	Myeloid
GCAAAGGAGGGAGATA-1	CM
AAAGGGCAGGTCTTTG-1	Fib
CAAGAAATCGACTGGC-1	CM
CTCTACGGTTCATTTC-1	CM
AGTGCGCCACCGAATT-1	CM
GCAGCCATCGTCAACA-1	CM
TACGCCTTCATTGCCC-1	CM
CCAGAATCATTGATGC-1	Endo
AGCCCGAAGTTGCTTG-1	Myeloid
GTCGTAACAAGAAACT-1	Fib
TCACAAGAGAAAGCAG-1	Fib
CCCTGATCACGTGAAG-1	Myeloid
CACCTGTGTTCTACGA-1	Pericyte
GACTAACGTACGACCC-1	Fib
AGGACGAGTTACGCTA-1	CM
CGCTATCTCTCTTCTC-1	CM
GCCTAGGAGTACGCGA-1	Fib
TGCCTGTCAGTAAGAT-1	CM
TGGGTTACAATGTGCT-1	Myeloid
TTTGGTTGTACGCAAG-1	CM
ACGTTAGGTGAAACAT-1	CM
GCGAGAAAGCTAGTTC-1	CM
CGAGTTAAGTACTCTG-1	Fib
ACTTTCAGTGATAAGT-1	Endo
GTTGGGCTCGGTTAGT-1	Fib
TACCTATCAAGATGCG-1	Neuronal
AGTCAACAGAACCCGA-1	CM
TGCTTCGGTTTCTTAC-1	CM
CTTTGCGAGAACCATA-1	Myeloid
GACCAATGTATGGGTG-1	CM
TGTGTCCCAACCTCCT-1	CM
CTGTATTAGTGCTAGG-1	CM
TGCCTGTAGCGTTAGG-1	Fib
CTAGGATGTCAGAAGC-1	CM
CATAACGAGTCCGATT-1	CM
GTCACAAGTGGATTTC-1	CM
CGCGCAACATTTGGCA-1	CM
TAGCTTTTCTCTGAGA-1	CM
TTACTCAGTGTGTGTT-1	CM
TCAAGGTCACAACGGA-1	Endo
GTTACTTTCGGTACTA-1	CM
TTGAGCAGTGTGTGCC-1	CM
GAACGTTCAATTGGCT-1	Fib
TGGGTGCGTCAATCCA-1	Endo
CCAATGATCGCTTACC-1	CM
TTCGATTAGTTCCCGG-1	CM
TCGCCTATCGCTAGTA-1	Fib
TGAATCGTCGCGGCAT-1	CM
AGCTGATGTGCTGTCG-1	CM
TTCGATTAGTGATCTC-1	Fib
GCTGCGAAGCATGATA-1	CM
ATTGTCTTCGAGTTAC-1	Pericyte
CAATCCCCAGAACGAC-1	CM
TACAGCATCAGAATGA-1	CM
CCCTAACTCAACGTGT-1	Fib
TGATGCAGTAGAGAGA-1	CM
TTGACGAGTATGGTTC-1	CM
ATTTGTCAGCCTATAC-1	Fib
TAGCCCTCAGCGTCGT-1	CM
GAGACTTTCCATCGAA-1	Endo
CTTGAAGAGTACTCTG-1	Fib
GGAGAACGTGTTAGAA-1	Endo
GAACTTGAGAGAACCC-1	CM
ATGTTTCGTGGTAAGC-1	CM
TTGTTCACAGCAACAG-1	Endo
TCGATTTGTTTCACCC-1	CM
CTGTATTTCCTGAAAC-1	Fib
TCAAAGCTCGGATCGC-1	Pericyte
CATTCCGGTGTACGCC-1	Pericyte
ACGTGGCGTCGCTAGC-1	CM
CAACCAAAGTAATGTG-1	CM
GAGTGAGCATGGATGG-1	Endo
ACAGCGCCAGAGATGC-1	Fib
AACGGGATCTGGAAGG-1	Fib
AACCTGACATGCGCTG-1	CM
CCGTACTGTAGATGAT-1	CM
ATGTACGCACTGATTG-1	Fib
TTACGGAGTCTCTGCT-1	Endo
GCTTGCTCATACAACC-1	Fib
TTAGGTGGTAAAGCTA-1	CM
CTTGTCGCATTGCACA-1	CM
TGCCTGTTCGTTCCGT-1	Fib
GACTAGTTCGATAGCT-1	CM
ATTTGTCAGCTCCATA-1	CM
TGGTCAACAGTTACAC-1	Fib
CACCTGTAGGAGTCTG-1	Myeloid
CCTATTAAGTAGCAAT-1	Fib
CTCTCAGGTGATAAGT-1	Fib
GGTGAAGAGATCGAGC-1	Myeloid
CTACAGAGTGGAAAGA-1	CM
TAACGGTAGGATATCA-1	Myeloid
TAATCGGCATTGCCTC-1	CM
GGAATCTAGGCAAGGG-1	CM
CAGCTGGAGTAGCAAT-1	CM
TAGGTCAGTGGATTCT-1	CM
TTCGGTCGTATCATGC-1	Pericyte
GCCAGCAAGTCAGCCC-1	CM
AACATCGTCTTCACTA-1	Pericyte
AGTTACGTCCAGGTCG-1	Pericyte
GTCCATCGTCAGGCTC-1	CM
ACATGCACATCGCCTT-1	Fib
GCTGAGCTCTGAACGT-1	Fib
TCTCAGCTCGGTCAGC-1	Fib
GCTTAAGCAACGTCCG-1	Endo
GCAACCGGTGCATTCA-1	CM
TAGGTGTCATTCACCC-1	Fib
GCAGCCACAAACCGAG-1	CM
GTTATTCAGGCCTAAG-1	CM
GAGACTTCACAGTAGG-1	Myeloid
AAACTGCCACCTATTT-1	Fib
GGGTTATAGTCCCGCA-1	CM
GTTGGTAGTACGTAGG-1	CM
CTCACCACACCTATTT-1	Myeloid
TGGTCAACACGGTTAT-1	CM
ATGCATGAGAGCTCCC-1	CM
GCGCATGCAGTTAAAG-1	CM
GGGACCTGTGTCCAGC-1	CM
ACCTGCTGTAGTCCAT-1	CM
TGACTCCGTACGAGAC-1	CM
GCCAGCATCCAGGTAT-1	Fib
CACGTTCAGTGGTGTG-1	CM
TTTGAGGTCCCACGGA-1	Fib
GGGACCTCATCACAAC-1	Fib
ACTGCAAAGACTAGGC-1	CM
TCGGGACAGTATACCC-1	CM
TTTGTGTAGCAGAAAG-1	Myeloid
TCAAGACCATATTGGC-1	CM
GCATTCCCAAGCACTT-1	Fib
AAATGAGTCAACTTGG-1	CM
TTACCGCTCGCTCTAC-1	Endo
CAGGATTGTTGGACGA-1	CM
GCAAAGGCACGCTCAG-1	CM
CTCTCGAGTCATTGGT-1	CM
GAACCTAAGTTCGACT-1	CM
GCCAGACGTCGAGGTA-1	Fib
TTAACGGGTACGAGAC-1	CM
TTGGTCCAGTACGCGA-1	Endo
TATGTGGAGCGTCTGC-1	CM
CAATCCCAGCAACTGG-1	Fib
GTTACGAAGTCCGGAA-1	Myeloid
AGCTGTAAGACCGCAA-1	Fib
CTCACCATCTTGTGCC-1	CM
CTTCTAATCCATATCT-1	vSMCs
GGGAACATCGTGATAC-1	CM
ACGTTAGTCGGATCGC-1	CM
TTGCCCAAGAAATCTG-1	CM
AAAGGATAGTACTCTG-1	CM
CAAAGCTAGGCAAGGG-1	CM
TTCAACTCACTGTCGG-1	Endo
CACTGAACAGTGCGAA-1	CM
AGCTATGCAAGGAACC-1	Pericyte
ATCCTGCCAAGGGAGG-1	CM
ACAAACCGTCTCTAAG-1	Fib
CTCTACGCAGGTCCTG-1	CM
CTGTTCGCATTAGCAC-1	CM
GTGACATTCAAGTTGC-1	CM
GCCATAAGTGCGACCT-1	CM
CGTAAACGTAGTGATA-1	CM
AGCCCGATCTTCTTCC-1	Pericyte
TTGTTGTGTAACATAG-1	vSMCs
GCAGATTTCTGTCGGG-1	CM
AAGATAGTCGCACCGA-1	Fib
GACTAGTGTGCCCGAT-1	Pericyte
TACGGATTCGAGAACG-1	Endo
AAAGGGCCACTCAAGT-1	Endo
CGTGGCAAGGAAGAAC-1	Fib
GCCCGAAGTAGTATCC-1	CM
ACATGGTCAAACTACC-1	CM
AGCCGCAGTAAACGGC-1	Fib
GATGGCCTCGAACCGC-1	Fib
TAGCCGGCAAAGCTGG-1	CM
TTGGTCCGTGTAGGAC-1	Endo
TGTTAGGGTATCCCTC-1	CM
GCCAGACCATGTAGAA-1	CM
ACGTTAGCAGGGCTTC-1	Fib
TGTAGCAGTACAAATG-1	CM
CGCTATCCAATAGCGG-1	Myeloid
ACTAACGTCAAGGCCC-1	Fib
AAGATAGAGGGCGAAG-1	Myeloid
AGTCCGGTCTACATCT-1	Myeloid
GCCATAACACAAACAA-1	CM
GGTGAAGGTTTCTCTA-1	Fib
ACTACGAGTGCGACCT-1	CM
GGTGAAGAGCGTCTGC-1	CM
ACTAGGTCACAGTTCA-1	CM
GGGAACACATGTGGGA-1	CM
AACCTGAGTACGCAAG-1	Endo
CGGACTGCACGTTACA-1	CM
GCTTTCGTCGCAAGCC-1	CM
GCTTGCTAGCAGGAGG-1	Fib
GGTGCTGTCACTAGGT-1	CM
GGTTGCGTCCGGAAAG-1	Fib
ATGGATCTCGATGCAT-1	CM
CATTGGAAGCGCACAA-1	Endo
GTGCCAGGTCCGTGCA-1	Myeloid
CCTATTAGTGAATGGC-1	Fib
GGGTTATCACCTGAAT-1	Fib
CTTTGCGCATCATAGC-1	CM
ATGTCGAAGCGTAGCA-1	Fib
ACTGCAAGTGAAACAT-1	CM
TACATTCAGTACCTCA-1	Myeloid
TGGTCAATCCATACCC-1	Myeloid
TGCCTGTTCCGTACGG-1	Myeloid
AGCGATTGTCAGAAAT-1	Fib
TACAGCACAAGTAACA-1	Fib
AGTCCGGTCTCGACCT-1	Fib
CTTGAAGGTTATAGAG-1	Myeloid
TCTATTGCAATGGCTT-1	Pericyte
AATGTCGTCCATCGAA-1	Fib
TTCGGTCGTTGAAGCG-1	Fib
GCGAGAATCCGAGGAA-1	Fib
CTTGCTGAGTACAGTA-1	CM
TGCTCGTTCCACGGCA-1	Fib
AACGAGGCAGAATGCG-1	CM
CAGTGCGTCTCGGCGA-1	Endo
CCGTGAGGTACTATGC-1	Myeloid
CCTAAAGCACGTGAAG-1	Myeloid
AACAGTCAGGCCTAAG-1	Fib
CACCTGTGTAAAGCTA-1	Myeloid
GCCAGCAGTATCATGC-1	CM
TTGTTGTTCTATACCT-1	Fib
CCGAAGCGTGCTTTGA-1	Myeloid
CTGCTCAAGAACGCCA-1	Myeloid
CCCGTTACACGACGAA-1	Fib
TGTACAGCACTGAAGG-1	Fib
TAGACTGGTTCGGGAA-1	CM
CCACAGGGTACAAGCG-1	Endo
CGTTCCAAGTAACATG-1	CM
GCAAAGGGTAGTTTGC-1	CM
GGCGAAAGTACCCACG-1	Myeloid
GCATTGAAGGTTAACA-1	Fib
CGTGGCAAGACCCATT-1	Pericyte
TCCGACTAGTCTGGGA-1	CM
TCAGTTTCAGCGTGAA-1	CM
AACAGTCGTTCCATCC-1	CM
AAACTGCTCGGTTAGT-1	Myeloid
TCAGGTATCTTTATCG-1	Fib
TATTGCTCAGCACATT-1	CM
GTGTCAACAAGAGATT-1	CM
CTTCCAGGTCCTATTT-1	Fib
GGACACCAGAGAATTC-1	Fib
TTCGCGTGTGTCTACA-1	CM
TCAAGCACAAGGAGGG-1	Fib
TATGTTCGTGTACGCC-1	Fib
CCGTGAGCACATATCG-1	CM
GGGTTATTCCTTCGAC-1	CM
TGAGTCAGTCAAGACG-1	Fib
ATGTCGAAGGTCACTT-1	CM
CACCTGTCATACCCGG-1	CM
GGGCCATTCGAACCGC-1	CM
CTAGGGCGTAACTGAA-1	CM
AATGGAAGTGGATTTC-1	CM
GACCAATTCATGCTTT-1	CM
AGCCTCTAGTTGCGCC-1	CM
AACAAAGGTCTGTGTA-1	Fib
GATGATCGTAAACGTA-1	Fib
GTCACGGGTCTCTAAG-1	CM
AGCGTATGTGCTAGTT-1	CM
TCAGCTCTCGACTCGG-1	CM
GGATGAGGTAGGGTCA-1	Endo
AACGGGAAGTAGCAAT-1	CM
TACATGGGTACGCAAG-1	Fib
GTTATGGAGAAGCCGT-1	Fib
CTGTATTTCTAGTCGA-1	CM
TCCATCGTCCCAGCGA-1	CM
CTCTAGCGTTCTACCC-1	Pericyte
CAGGATTTCGTTTGAG-1	Fib
TCAAGCACAGATAAGT-1	Fib
GCTCACTAGTAATCAG-1	Myeloid
GATGGCCTCTGGCGCA-1	CM
TTACTTGGTACTTCAG-1	Fib
AACGGGAGTTCTCGAA-1	Fib
CATTCATAGTGTCCCG-1	Myeloid
CTAGGGCTCCACCTAC-1	CM
TTGCTTAGTAACCCAT-1	Fib
GGTAGGAAGCTCCATA-1	Endo
GTGACATTCGCCACTT-1	CM
TCAAAGCTCACTCGGG-1	Endo
CTCATGCTCTCAGATG-1	Pericyte
GTGACATTCGGTGATT-1	Fib
CATGTTTGTCAATACC-1	Fib
TTCTGTACACGCTGTG-1	CM
CTGCTCAGTAATGTGA-1	Myeloid
CCAGAATTCCAATCCC-1	Fib
GTCTACCTCACAACAC-1	Fib
TTCGCGTTCAGTCACA-1	Endo
TGCCTCAGTCTGGGCT-1	CM
TGGCAATCAAGCCTTA-1	Endo
CAAGAAATCTTGTCAT-1	CM
CGCTAGGTCCGCCTAT-1	Fib
GTCACCTAGCTGCTCG-1	CM
CCGCATTAGATCTCAC-1	Fib
GCGAGAAAGAATCAGT-1	Fib
ACTCGGGCACGCGTTG-1	Endo
AGTGCCGAGAACTCCT-1	CM
GAAAGTATCCTGACCT-1	Fib
AACATCGAGGCACTAG-1	Fib
CAGCCTTGTAACCGAG-1	Pericyte
TGGGTTATCTCCTTAA-1	CM
TCACCACTCTCGCGTT-1	Myeloid
TGATTTCTCTATCTAC-1	CM
TACGGATCATTAGCAC-1	CM
ATCCTGCGTATTCTTC-1	CM
CTCTCAGCATAGAATG-1	Fib
TGGTCCTGTACTTCAG-1	CM
CTTGCTGCACTGTAAC-1	CM
CTTTGCGTCGTGATAC-1	Fib
TACATTCAGAAATGGG-1	CM
ACATGCAGTAGACGCA-1	CM
TAGGTGTGTGCGCATC-1	CM
TGGCAATGTCCATTGA-1	CM
TGCTCGTAGGCATGCA-1	CM
CACGTTCAGGCACTAG-1	Fib
TACGCAACAATGGTCT-1	Neuronal
TTGTCTACACCACAGC-1	CM
GTCTACCAGCGCAATG-1	CM
CTACTTAAGACCATAA-1	CM
AGCTGTACAGGCATTT-1	Myeloid
CAAGCTAAGCTGGAGT-1	Endo
TTGAGTGAGCAGGACT-1	CM
CCTATTAGTGTCGTGC-1	CM
TGGCGCACAGTCCTGG-1	CM
GCGATTAAGTTCAGGG-1	CM
TCCGACTTCTGACTTT-1	Fib
CATTCATGTCAGTGCC-1	CM
GTGTGATCAACTCAAC-1	Fib
CCCTAGTCACACATTG-1	Fib
TCGCAGGGTGCCCTAG-1	Myeloid
GGACACCGTCTGCGCA-1	Fib
AACCGATAGCGTCAAG-1	CM
AGCCTGGTCCTTTGCG-1	Fib
AAACTCGCATTGATGC-1	Fib
GCCCAGAAGTATAGTG-1	CM
GACTAGTTCCCATAGA-1	CM
CACATGAAGAGTCCGA-1	Fib
CAGGGCTAGGATGTCG-1	Lymphoid
GCTGCGATCTTTATCG-1	CM
TGCACCTTCTCGGCGA-1	Myeloid
TAACTTCAGCAGGAGG-1	Fib
TGTAAGCTCTAGCAAC-1	Neuronal
GTGCACGTCATTCGGA-1	Fib
TGTAGCAGTTGTGAGG-1	Endo
GTGCACGCATTTAGGC-1	CM
CCTCCCTCACAGCTTA-1	Pericyte
ACTATTCAGGCTTTAC-1	CM
TCGTTCGGTGTTTCTT-1	Fib
GTCCATCTCGAGGTAG-1	vSMCs
ACAAAGAGTTCTGAGT-1	Fib
TAACTTCAGTGTCACT-1	Fib
AGATTCGTCTACTGCC-1	Fib
GCGTTGGAGTATAGTG-1	CM
TCAGGGCGTTCCAATG-1	Endo
CCGTAGGCACCATTCC-1	Fib
GGTCATATCACGTGTA-1	CM
TAAACCGAGCAGGAGG-1	CM
AACGTACCATCCCGGA-1	Fib
TTGCCCAGTGCCGGTT-1	Fib
ATCCTCGGTCGCTAGC-1	Fib
TACATTCGTATACGCT-1	Fib
AGGACGACAGTAAGCG-1	Myeloid
CAAGGCCAGTACAGAT-1	Fib
CCACAGGAGAGGAAGT-1	Fib
CTAACTTCAAGACTAA-1	Fib
TATGTTCTCCAACGCG-1	Myeloid
AACATCGTCCGTACGG-1	Fib
AAAGGGCCAGGACTGA-1	Myeloid
CAACGTACAAGGAACC-1	Fib
ACTGCGGGTTGTGAGG-1	CM
AGGACGAGTCAGCTTA-1	Endo
TGCTCGTAGCTTACCA-1	Pericyte
CCCTAGTGTCAACGGA-1	Fib
CGAGTTATCGCTTGAA-1	CM
CAGTGCGTCTAAACGC-1	Fib
TTCAACTTCTTTGCAT-1	CM
TCGAGCGAGGGAGTTC-1	CM
TCGTTCGGTGCATTGT-1	Fib
AGCTGGCTCTGTTGCC-1	CM
TCGATTTAGTCCCGCA-1	Pericyte
TAATCGGCAATGATGA-1	Fib
GAGAACGGTTTCGTTT-1	Fib
TACTAGGCATGCGTTA-1	Fib
CTTGCTGAGTGATTAG-1	Myeloid
CCGAAGCTCCCACTAC-1	Fib
GCATTGAGTCATTGGT-1	Neuronal
TTGCCCAGTGAGCTAG-1	CM
CCCAGAGCAACGTACT-1	Endo
AAATGAGCATTGCCTC-1	Myeloid
ATAGTCGGTTGTGACT-1	Myeloid
TTACTTGCACCGATCG-1	CM
ACTACGACATCGGCCA-1	CM
CAAGCTAGTCAAACAA-1	Fib
GTAGTACTCACAGGGA-1	Fib
ACGTTAGTCAATTGGC-1	CM
CTGCGTTCAAGAGCGT-1	CM
AAACGAAAGGGTAATT-1	Myeloid
TCCAGAACAAATTCCG-1	Endo
GCTCAGGGTTGTCGGC-1	CM
TGAATCGAGATCGAGC-1	CM
AGCTGTAGTTCCGCGA-1	CM
GCGTAGCTCTGTCGGG-1	Myeloid
CTCACCAGTACGAGAC-1	Myeloid
GTTGGTAAGGTTAACA-1	CM
CATTCATTCGCACCGA-1	Endo
CCTAAAGGTGGACGAT-1	Fib
TAGTCCCTCAGCCGGT-1	Fib
TTCAACTAGGAAGAAC-1	Fib
ATTGTCTGTTCAGTAC-1	Fib
AGGACGAGTGATAAGT-1	Fib
GAAGAGCTCTCTGCAC-1	CM
TCAGGGCAGCAATAAC-1	Myeloid
TACTGCCGTTTCTCTA-1	Endo
CTAGGATGTCATAGCT-1	Myeloid
ACGGATTTCATCGCCT-1	Fib
TTAGCTTCAAGTCTGT-1	Fib
TGAGTCATCACTCGGG-1	CM
TTGCTTAGTATCTAGC-1	CM
AACAAAGTCCTTTGCG-1	Fib
AAGGAGCAGAGCGAAA-1	Endo
AGCTGGCGTAACGGAC-1	CM
AGCCGCATCCAATCCC-1	Endo
CCCAGAGAGCACGTAG-1	CM
CCCAGAGCACGCTAAT-1	Fib
AGATTCGGTTCTTTCA-1	Endo
GCAACCGAGGTGATGC-1	Fib
TTGCAGAAGTAGCAAT-1	CM
ACTGCGGCAACCTCCT-1	Fib
CAGTGCGTCTGGGCGT-1	CM
CCGTAGGAGAAATCTG-1	CM
TCACCACAGAACGTTA-1	Endo
ACTAGGTAGATTCCGT-1	Fib
AAATGCCAGTGAAGGA-1	Fib
AGATAGAGTTCCGCGA-1	Fib
GGAACTTAGTCCCGCA-1	Fib
CACTAAGGTCTTAGCA-1	Endo
GAAAGTAAGAGTTCGG-1	CM
CTTCTAAGTTCAGAAA-1	Fib
AGGCCCAGTGGACGAT-1	vSMCs
AAAGGGCCATTATGGC-1	CM
ACTTCCGCACCGATCG-1	Neuronal
TTGCACCTCTACTGCC-1	CM
TGAGTCATCTACTTTG-1	Endo
ATATTCCAGGGAGTTC-1	CM
TCACAAGAGTGAGTGC-1	CM
AAACTGCAGTTCGCGC-1	CM
CAACGTAGTTGCCGCA-1	CM
TGCACCTGTAGATTAG-1	CM
AGTGCGCTCTGAAAGA-1	CM
GCCTAGGGTATTGTCG-1	CM
AGGCGTCGTACATGGG-1	Endo
AGCGATTTCGCGATGC-1	CM
TTCTAACGTCACATTG-1	CM
AAACTGCAGTCCGTGC-1	Fib
TCAGTTTAGAGAGTTT-1	Myeloid
GCGAGAACATAGAATG-1	CM
CTCTAGCTCTGATCTT-1	Fib
TAGGTGTTCGGATGTT-1	Pericyte
TCGCCTAAGCTACGTT-1	Fib
AGCCCGAGTAAAGCTA-1	Fib
CTCTCGACAAGCAGGT-1	CM
TCCGACTAGTCCTTCC-1	Myeloid
CGAGTTATCGCACCGA-1	CM
GATCGTAAGCAGAATT-1	Pericyte
CTTGTCGTCGCACAAT-1	Pericyte
GACTAACCATCCATAG-1	Fib
CTCAACCTCCAGGTAT-1	Fib
GAGCGCTCAAATAGTG-1	Fib
ACAGAAATCCAGTTAG-1	Pericyte
AGCCTTCTCTAAACGC-1	Endo
GGCACGTGTTCAGTTG-1	Pericyte
GAAACAAGTTCCGCGA-1	Endo
TATGTGGGTAGAAGCC-1	Myeloid
TGCATTTCATTTGGTG-1	Fib
AACCAACGTCAACTGT-1	Myeloid
GTCGTAAAGATTCCGT-1	Myeloid
AGCTGATGTATCTAGC-1	CM
AACGAGGAGCGCACAA-1	Endo
GTAGACTGTCAGGTGA-1	Fib
CTACAGATCCGGAAAG-1	Fib
GGGCCATTCCTTACGC-1	CM
CCTATTACACGTTACA-1	Fib
CACCTGTTCGCGCTGA-1	Endo
AGTCCGGAGGCGATTG-1	Fib
TAAACCGCACGAACGA-1	Fib
GCTGTTCCACAGCCAC-1	CM
GCTCACTGTCTAAGAA-1	Endo
TGACTCCCATGTAGAA-1	Fib
CCAATGAGTACTTCAG-1	CM
ACTGCGGGTTCGGGAA-1	CM
ATTCGTTGTAATGCAA-1	Fib
TGAGTCATCCACGAGC-1	Endo
CTACTTAGTTGGACGA-1	Fib
TAATCGGTCTGTTTAC-1	Endo
TTCGGTCGTTCAGTAC-1	Myeloid
AGCTATGTCTCGCGGA-1	CM
ACTTCCGTCCGAGAGA-1	Fib
ACGGATTCATCGTGAT-1	Fib
CGCTGGAGTGCTAGTT-1	CM
GCTCAGGCACTGTCGG-1	CM
AATACGCCAGTAAGCG-1	Neuronal
AGTCCGGGTGTCCAGC-1	CM
TGCTCGTGTGCACATT-1	Myeloid
TAGGTCATCTCATCCG-1	Pericyte
GTGATCAGTGCATTGT-1	CM
ATTCGTTAGAGCGAAA-1	CM
CCGTAGGTCCTGTAGA-1	Fib
AGGACGAAGACAGTGC-1	CM
TGAGCCGAGAGTAAGG-1	Fib
GATCGTACATCAACTG-1	CM
AGTCCGGGTTCTACGA-1	Fib
ATCCAGATCCCTAAAG-1	Myeloid
GTGTCCTAGTCATCTG-1	Fib
GTCTACCGTGCACTTA-1	Pericyte
TGATCAGGTCCTTATT-1	CM
TTTGGCCCAACGTACT-1	CM
ATAGTCGTCAATGCAC-1	Fib
GTGTCAAAGAAATCTG-1	CM
CCGAAGCAGGAGACTC-1	Fib
GCTCGAGAGTCGAGCA-1	CM
ACATGCAGTGGTCGAA-1	Myeloid
TAACGGTTCAATTGGC-1	CM
GTAGTACAGCAATAAC-1	CM
CCGTGAGCAGGAGCAT-1	Fib
ATAGTCGGTGAGCTAG-1	Pericyte
GAGTGAGGTACCCATA-1	Myeloid
AATGGCTCATCCTGGG-1	Fib
GTAGTACAGCGTTGCC-1	Endo
TGTGACAAGCATTGGG-1	Fib
ATGTCGATCGTGCTGG-1	Fib
TACGCAAGTAGACACG-1	CM
GCTTGCTGTTTGAAGA-1	Fib
AGTCCGGTCAGAGTGG-1	Myeloid
TCGTTCGTCGACTGGC-1	Endo
CACGTTCGTGCATTGT-1	Fib
TTGAGCACAACGACAG-1	Fib
AGCCCGAAGTCTTAGC-1	Pericyte
TTCGATTAGACGCCAA-1	Endo
AAGATAGGTAAACGAT-1	CM
AGCCTGGTCGACCCGA-1	Fib
ACCTGCTTCCCATAGA-1	CM
CGCTGGATCATTCGGA-1	CM
TGGCGCAGTTTAAGGA-1	Fib
ACTACGAGTTCTTTCA-1	Fib
AGCCTGGTCACGTGTA-1	Pericyte
TTGCAGACAATCACTG-1	CM
AACGGGACAATTAGGA-1	Pericyte
TTATGTCCACAGATGG-1	Fib
GGATAGGTCCAAGTCA-1	Pericyte
AGCGTGCTCCCGTAGG-1	Fib
CTCTCGAGTCAATACC-1	Fib
GGGCCATGTACCAAGG-1	Myeloid
GCCAGCATCCCGAAGC-1	Fib
TAACTTCAGGTCACTT-1	Fib
AGCGATTAGAGAGTTT-1	Fib
CATTGGACATGTATCG-1	Endo
TACTAGGGTCTAAGAA-1	Fib
CAAGGCCAGGCATGCA-1	CM
GCGATCGCAATGCATC-1	CM
TGCTTTACATCGGCTG-1	Neuronal
TGAGTCATCTCCTTGG-1	CM
GGTAGGAAGAGAATTC-1	CM
GTTCAAGGTGATGCGA-1	Myeloid
GAGCGCTCAAGCCCTG-1	CM
TAGGTGTAGGAGTCTG-1	Pericyte
TCCGACTCAATGTAAG-1	Pericyte
GTGGCGTGTTTAAGCC-1	CM
TGAGCCGAGTTAGCGG-1	Myeloid
GTAGGAGCACTGATTG-1	Myeloid
CAGCTGGCAAGAAACT-1	Fib
ATAGGCTCACTAGCCG-1	CM
TCCAGAATCGCTTGAA-1	Endo
TGAGCCGAGAGGCGGA-1	CM
ACCAAACAGCACACCC-1	Fib
TACCTATTCTTCCAGC-1	CM
GAGGATGTCAGTCTTT-1	Pericyte
TCAGGTAAGTATAGTG-1	vSMCs
CGTACAAGTAGCGAGT-1	Fib
CGAGTTAGTGATAACA-1	Endo
GAGTGAGCAGGGTAAC-1	Endo
AGACAAAAGTGCTCGC-1	CM
TCACCACAGATGAGGA-1	Endo
TCAAGCATCCGGCTGA-1	Pericyte
GTGGCGTTCCGTTTCG-1	Fib
CACAGATGTTGGCTAT-1	Fib
CCTCCCTAGCATGTGG-1	CM
AGTCCGGTCGAGTTAC-1	Myeloid
CGGACCACACGTGAAG-1	Fib
TGGCCTTTCGAGAACG-1	Fib
ACGGATTGTCAGAAGC-1	Fib
TTCTGTAAGTCCCTCT-1	CM
TCAGTCCAGGTTCGAG-1	Endo
GTACTTTTCCTATCAT-1	CM
ACTATTCCAAAGAAGG-1	Fib
AACTGTGGTCACTCTC-1	CM
GAAGTCTAGCTACGCC-1	Fib
TTGCAGATCCCAGCAG-1	Myeloid
TCGTTCGAGTCAGCCC-1	Myeloid
GTGCCAGAGCTATCCA-1	Endo
GAGACTTGTTGTGACT-1	Endo
CACCTTGTCTTCATAC-1	Fib
TCGATTTAGAATCAGT-1	Pericyte
TACTAGGAGACAGCTG-1	CM
GAGGATGAGTCTGGGA-1	Fib
TTGTTGTAGGGTTCCC-1	Endo
TACATTCCAATCATCG-1	Endo
TTCATTGAGTGAGTTA-1	CM
TCTCAGCGTTCTTTCA-1	Myeloid
TGGGTTAGTACGGTTT-1	Fib
TCTCTGGAGATCTCAC-1	Pericyte
CAGTGCGCATGCGCTG-1	CM
TCAGGGCAGCTCGTTA-1	Fib
TCGGGACCATCCCTTG-1	Fib
TTTGAGGAGATCTCAC-1	Fib
AATGGAACAATACTGC-1	Fib
TCCCACAGTTAAGGGC-1	CM
ATGGATCCACCAAGGA-1	CM
TGGCCTTGTACCAAGG-1	Endo
TCTCAGCTCTACTTTG-1	Pericyte
AGTGCGCGTAGATTAG-1	Fib
TACCTATAGTTCAACC-1	Myeloid
GGAGTAGAGAGTAAGG-1	Pericyte
TAACAGCAGCTGCTCG-1	Fib
CCCAGAGAGTGAAGGA-1	Fib
TCACCTGGTGATAAGT-1	Fib
GAGGTCCGTTTGTCTT-1	Myeloid
ACATGGTTCCATGTTT-1	Myeloid
TTGCTTAAGACACTTC-1	Fib
ATAGGCTGTGAATGGC-1	CM
ATAGTCGCAGCGCGTT-1	Endo
CCCGTTACATGGTTTG-1	Fib
TCTCAGCCAAGAGATT-1	CM
TACGGATTCGGGTCCA-1	Pericyte
TCCATCGTCCACGAGC-1	CM
TGCATGACAAGCAACG-1	CM
ACTACCCTCGTGAACT-1	Neuronal
ATTACCTGTTCTGATG-1	Myeloid
TCGAGCGTCGAGAACG-1	Endo
CTACAGACATCCTCGT-1	CM
TCCCACATCACAACAC-1	CM
TTTGGCCAGAGGAAGT-1	CM
GTTGGTATCAGTCTTT-1	CM
GGCATTATCGCAACTA-1	CM
AGATTCGAGACAGCTG-1	Myeloid
ACAGAAAAGTCTCGAT-1	Fib
CTTAATCTCTGGCACG-1	Fib
TGATTTCGTCAGCTTA-1	Endo
CCGTACTAGTTTGGAA-1	Endo
GCATGATGTATGAAGT-1	CM
GCCTAGGAGACGCCAA-1	Fib
CAGGGCTCAGTTAAAG-1	Fib
CCTTAATGTCTAACCA-1	CM
AAACTCGTCCGGCTGA-1	Myeloid
CATGTTTTCGGATGTT-1	Fib
GATGGCCAGACAACGC-1	CM
AGGCCTGTCGGTCCGA-1	Myeloid
TCTAGTTAGGCTCCTG-1	Lymphoid
TGGTCCTTCCTATCAT-1	Myeloid
GTAGACTAGTCTTAGC-1	CM
ACAGCGCTCACTGGTA-1	Fib
CAAGCTAAGCAGAGCT-1	Endo
CTGTTCGTCAGTGTAC-1	Myeloid
ACCATCCAGCTGAGGT-1	vSMCs
CACCTGTTCTCGACCT-1	CM
GAGGTCCTCGTCAACA-1	CM
ACAGACTGTACCAAGG-1	Fib
TAGCATGAGTTGGAAT-1	Fib
CGGACTGCACAGTTCA-1	Endo
TATTGCTTCCTCCATG-1	Fib
ACTACGAGTACGTAAA-1	Myeloid
TATTGCTGTTTGATCG-1	Endo
TCGTTCGGTAGCAGCA-1	Fib
TACCCTGAGACCCTAT-1	Pericyte
ACTGTCCTCGTCGCAG-1	Myeloid
ACGGATTCAAGGAGGG-1	Pericyte
CTTTGCGCAACTACTG-1	Fib
CACCTTGAGTTTACGC-1	Myeloid
GCTCGAGTCCAGTACA-1	CM
CTAGCGGCACCACAGC-1	Endo
CCGTGAGCAGTTACAC-1	Myeloid
TTGCCCACAACAACTC-1	Myeloid
CATGTTTTCTGGACAT-1	Pericyte
GAAGTGGGTGGAGTGT-1	Endo
GAATCTGGTATATGGA-1	Fib
GTTATTCGTACAAGCG-1	Pericyte
ATCCTCGCACCCATCT-1	Fib
GAACGTTCATAGCAGG-1	Fib
AACTTGGCACAGTTAC-1	CM
AACTGTGAGCGAATAT-1	Fib
CCCGTTAAGTGCCCTG-1	Endo
TCCGACTCACACTAGT-1	Fib
TGGTCCTGTGATAGAT-1	Fib
ATGTCTTAGGTAAGCC-1	CM
AGCCTGGAGCGTCAAG-1	Fib
GCAGCCATCTATATCC-1	CM
TCGAGCGTCCAAGAGG-1	Endo
TGGCGCAGTCTGAGCC-1	Myeloid
TGACTCCAGTTATGAG-1	Endo
GCGGTGTTCTTTGCAT-1	Endo
CTTCTAACAGCAAACG-1	Endo
AGCCTCTGTCGGCTGT-1	Fib
TCCAGAAGTGTCTCGG-1	CM
CAGCTAAAGCGATACG-1	Fib
TCTCAGCGTCTGTGTA-1	Fib
GAAGTCTGTTTGGATC-1	Endo
CTGCGTTAGTGCTAGG-1	Endo
CATGTTTTCTTAAGCG-1	Fib
GCTTAAGCACCTGTGG-1	CM
TCAAGACCAAGGCTTT-1	Fib
CTGCTCAAGTACGACG-1	Myeloid
AGCGATTTCGTTCCGT-1	Fib
CCTCCCTGTATTCTTC-1	Pericyte
TGAATCGGTTTGCCAA-1	Endo
TTCAACTGTGATGTGG-1	Fib
TAGGAGGCATAGAATG-1	Fib
TGCACCTAGTTATGAG-1	Fib
TCACCTGGTGTTAGAA-1	CM
GGTCATATCGCTATTT-1	Endo
CAGGATTAGACTCGGA-1	CM
TAATTCCAGCATTGGG-1	Fib
GCGCCAACACAGCCAC-1	Fib
GGTCATAAGGCTAAAT-1	Myeloid
GCTCCTAGTTTGCGAT-1	Fib
AACCTTTCATGCTATG-1	CM
CTGCGTTAGACTAATG-1	Fib
ATGTTTCCACACATGT-1	Myeloid
CTGTATTGTTGCCTGG-1	CM
CTTAATCAGCTAGCAG-1	Fib
CCTATTAAGGTGATGC-1	CM
TAGCATGTCCCACTTG-1	Fib
TACTCGCGTTCTCGAA-1	Fib
AAGGAGCTCTCCTTGG-1	Fib
CGGACTGAGTACAACA-1	Fib
AGCTATGGTAACTGAA-1	Pericyte
ATCCAGATCGAACACT-1	Fib
CCTTGCAAGGTAAGTT-1	Fib
ACGGATTTCGGTCTAA-1	CM
TGCCTCAAGTCAGCCC-1	Pericyte
ACTATTCGTCATGAGG-1	Myeloid
CTGTTCGGTAAAGCTA-1	Myeloid
TACATGGGTATGGGTG-1	Myeloid
TGGACATTCAGAACGG-1	CM
CTGTATTGTTCAGTTG-1	Fib
CCACGTTCATCCGTAA-1	Fib
TCGGGACAGGCGCTTC-1	CM
TCCCACAAGAGATTAC-1	Endo
GTAATCGTCGCTTGAA-1	Neuronal
GCGTAGCCACAACGGA-1	Fib
GAACGTTTCCCTAAAG-1	Pericyte
AGGCGAATCCAGGTAT-1	Myeloid
GAGGTCCTCCACCTAC-1	Fib
CAGTGTAGTGAGGTCA-1	Pericyte
GCGCCAACATGGCCCA-1	Myeloid
GCGTTGGCACTCGCAG-1	Fib
TGGGTTATCCTTCGAC-1	Fib
CACCACTCACAGTTAC-1	CM
CCCTAGTTCACTCCCA-1	Neuronal
CCTTAATGTTAGCTCA-1	Myeloid
AGCGATTTCCAGGTCG-1	Fib
ACAATCGCATGGTTTG-1	Fib
GCTCACTGTTGGGAAC-1	Endo
CAGCTAAAGTATGGGC-1	CM
CCGCATTAGCCTTTGA-1	Fib
ATGCATGTCGGACGAA-1	Fib
ACCTGCTCAACGTCCG-1	CM
GAGTGAGTCTCAGATG-1	Endo
CGTTCCAAGTAGACCG-1	Fib
ACTGCAAAGGCACCTC-1	CM
CGCTAGGGTGGAAAGA-1	Pericyte
TCGCCTATCCTCCAGT-1	Endo
CCCACATGTCACATTG-1	CM
TAAGTGCTCAGCCGGT-1	CM
TAGCCCTTCCGAATTG-1	Fib
TATCTGTGTAGACACG-1	Pericyte
ATTGTGGCATGTAGAA-1	CM
TTGCGAACAGCGCGTT-1	Fib
CGCAGGTGTTTCTCTA-1	Fib
CTTAATCGTTACCCAA-1	Endo
CGAGTTATCGGAAAGC-1	Endo
TCACAGAGTGTTAGAA-1	Fib
GAAGTGGGTTTCACCC-1	CM
ATGTACGGTCAACGGA-1	Myeloid
GTTATTCCACAGCCAC-1	Fib
CTCAGAACATGGGAAC-1	CM
CCCTCTCGTTACTTTC-1	Fib
TGCTTCGCAGACTAAA-1	CM
TTAGCGACAAACCTAC-1	Endo
CTCAACCTCGCTTACC-1	Fib
AGTGCCGAGATGTTCC-1	Fib
GCCAGACTCCACGCTT-1	Myeloid
TTCTGTACAACTCGTA-1	Endo
TCAAAGCTCCTTTGAT-1	Fib
GGAGGATGTTCAGAAA-1	Fib
CACGTTCGTCCGGTAC-1	Fib
ATCGAGTAGGCCTCGT-1	Fib
ATCGAGTGTCGCTACG-1	Fib
GCAACCGGTAACAATG-1	Endo
CTGGCAGGTTTGTCTT-1	Fib
TACCCTGTCCAACGCG-1	Lymphoid
TTGGTCCCAGGTGGTA-1	Myeloid
TTCTGTAAGTAGACCG-1	Fib
GAACTTGGTAGAACGC-1	Fib
GACTAACCATTCACCC-1	Endo
TTTGGCCAGGCTGGAT-1	CM
TGATCAGTCTACCCGT-1	Myeloid
GATTGACCAGAACTTC-1	Fib
ACCATCCAGAGCAGCT-1	Pericyte
TGTGACACACTTTGGA-1	Endo
GCTGCGATCCTGGGAC-1	CM
CACAACATCATTCGGA-1	Fib
CGTAAACCATTGTTCT-1	Endo
TGCTATTAGCCGCTGT-1	CM
TATGTTCAGGGAGTTC-1	Pericyte
CTACTTAAGGCTTTAC-1	vSMCs
TAGCGGCAGTGAAACT-1	Endo
CTCAACCTCCGTTAGA-1	Myeloid
CAATCCCAGTCATCTG-1	Fib
TTGCACCTCGCTTCAC-1	Fib
TGCACCTCAGCAAACG-1	Fib
CCTCCCTCACGACGAA-1	vSMCs
GGCGTTGGTCTCAAAC-1	Pericyte
GAACCGCAGGGTTCCC-1	Pericyte
TACGCAATCTCAGATG-1	Endo
TGCCTGTCATCACAAC-1	Neuronal
TTGAGTGCACCCTTTG-1	Fib
CTGCTCACACACATGT-1	Endo
GACTAACTCTTAATCC-1	Myeloid
ACTGTCCGTATTCGAC-1	Endo
GCAGCTGGTAACCCAT-1	Pericyte
CACCACTGTCATAGCT-1	Fib
TTTGGTTAGTAATCAG-1	Pericyte
AACCTTTGTTGCCTGG-1	Fib
CCTGGGAAGTAGAAGG-1	Pericyte
GCTTTCGCAATGAAAC-1	Endo
GATCATGGTAACGGAC-1	Myeloid
GACTAACGTTCCGCGA-1	Fib
GTCACAAAGACCCTAT-1	CM
AGTTTGGGTCAGGCTC-1	Myeloid
ACAAACCTCGGCAATT-1	Myeloid
GCGAGTCCATGCGTTA-1	Fib
GTGGCGTTCACCCTTG-1	Endo
CCTGCTATCGGGAATG-1	Myeloid
TGATCAGTCCTGAAAC-1	Fib
GTCCATCGTAGTATCC-1	Fib
ATGGATCTCCAACAAC-1	Myeloid
CCGTACTAGTTGCCGC-1	CM
TGTGTCCGTGTCGTGC-1	CM
CTACAGACAGAAAGAG-1	Myeloid
TTTGGTTCATCGACCG-1	Endo
TGCATGAAGGAAGACA-1	Fib
GGGTTATGTTTGTACG-1	Endo
GCCCGAATCCTATCAT-1	Fib
TGAATCGAGTCAACTC-1	Myeloid
TGCTTTACAAGTCTCA-1	Endo
CGCTAGGAGAAGACTT-1	Fib
CTGTATTCAATAGCGG-1	CM
TGTACAGAGCAATGTA-1	CM
TCCGACTGTCTGGGCT-1	Fib
TGTAAGCGTTACGGAG-1	Fib
TTTGAGGTCCAACAAC-1	Endo
GAACCTAAGAGAGGTA-1	Fib
CATAACGTCCCGATTC-1	CM
CATTCATCAAATAGTG-1	Fib
GTGCACGTCAATCGTG-1	Neuronal
AGTCAACAGCCGCAAA-1	CM
GTGCCAGCAAACTACC-1	Pericyte
GGAGTAGGTGAATACA-1	Fib
GTAATCGTCAGCCGGT-1	Endo
TAGCCGGGTTTAGAAG-1	Fib
AACTGGTAGTGTCACT-1	Myeloid
GCAACCGTCAATCGTG-1	CM
TAACAGCAGTACGCGA-1	Myeloid
TCACAAGGTATCCCTC-1	Fib
CCCTAACAGCTGCCAC-1	CM
TGGGTGCCACCTATTT-1	Fib
ACTACCCTCGGTCGAC-1	Fib
GGGACCTCAAGCGTCC-1	Endo
GAACTTGTCTATAGGC-1	Fib
TCACTCGGTTTAGAAG-1	Myeloid
TCACCTGTCCATAGGT-1	Endo
GGAACTTTCACGTGTA-1	Fib
CCTCCCTGTTCCCTTG-1	CM
TCCAGAACATAGCCGC-1	CM
AGCCCGACACGATTAC-1	Fib
ATCGAGTGTTCCCGGA-1	Fib
GTAGACTAGGTTAGTA-1	Fib
TGCGTAAAGAACGACC-1	CM
CGCTAGGGTCAGGTGA-1	Myeloid
CCTAAAGTCAAATGGA-1	Fib
AACCGATCACGTGAAG-1	Endo
CCTAAAGCACAAACGG-1	Myeloid
ATAGGCTGTATGAAGT-1	Fib
AAAGGGCCAGAACAGC-1	Fib
TCACCTGGTAAACGGC-1	CM
ACTACCCGTACGGAGT-1	Fib
GCGTAGCAGGACTAGC-1	Fib
GAGGTCCGTATTCGCA-1	Fib
CATGCCTTCCATATCT-1	Pericyte
CATAACGGTGAGTCGA-1	Fib
CATGCCTTCCTAGAGT-1	Fib
GACCAATTCGAGAAGC-1	Fib
AATACGCGTCAACAGG-1	Endo
CCTTGCACAGGGAGTT-1	Myeloid
TCTCTGGGTCCGGTAC-1	Endo
GGAATCTAGCATGTGG-1	Myeloid
TCGCAGGCAAGCCTTA-1	Pericyte
ATGCATGAGAGGTACC-1	Pericyte
GTTGGGCTCGATTACG-1	Fib
GGAACCCCATTAGCCA-1	Myeloid
TTACCGCCAAGATGCG-1	Endo
ATGTACGCAAGTAACA-1	Myeloid
AATGCCATCTCTCAAT-1	Fib
AGTGCGCTCACTGGTA-1	CM
CCATACCTCTTCAGAG-1	CM
TCAATTCCACAGGAAC-1	Endo
GAGTGAGGTGGAGTGT-1	Fib
GCAGATTGTACAAATG-1	Fib
CACTAAGGTATCTCAG-1	Fib
TTAGCTTAGTAACTCC-1	Fib
AGTCAACAGACACAAT-1	Fib
AACTGGTCAGTATACC-1	Fib
TTTGGTTCATTACTTC-1	Myeloid
TGTGGCGCATTACCTT-1	Endo
GAGAACGAGACAACGC-1	Endo
CCCTGATAGATGTTCC-1	Pericyte
TTCTGTAGTCATCAAC-1	CM
AGTGCCGGTCATAGCT-1	CM
TTCATTGGTAAAGGCC-1	Fib
TACTCGCCAAGACACG-1	CM
TTAACGGGTTGGCTTA-1	Endo
CAAGAAACATTTCTTG-1	Pericyte
TGTGTCCTCTCTGTTA-1	Pericyte
TCGAGCGGTTTGGATC-1	Myeloid
GCAAAGGGTAACTCCA-1	Pericyte
TAATTCCTCGACTATG-1	CM
AGGCGTCGTTCATTTC-1	Endo
TCAAGCACATCCGTAA-1	Pericyte
TGAGTCAAGTTAGCAA-1	Endo
CCGAAGCGTTTGTCTT-1	Fib
CCCTCTCGTCAGTGTT-1	Myeloid
CAAGAAATCGTCCCAT-1	Myeloid
TGGCCTTCACTGAAGG-1	Fib
CGGTGCAGTTAAGTCC-1	Fib
ACAGCGCGTCTGGTTA-1	Fib
ACTGTCCAGCATGATA-1	Pericyte
TGATGCAAGTCTGTGT-1	Myeloid
TCGTTCGCACGATTAC-1	Myeloid
CCCTCTCAGGTCTTTG-1	Endo
AGCCTTCCACCACAGC-1	Endo
TCTATTGCACGTGAAG-1	Fib
GAAATGAAGGGTAATT-1	Fib
CGGACTGCAGGTGTGA-1	Pericyte
TCCCACAAGCCGCTGT-1	Myeloid
GCGATCGGTCTAAAGA-1	Endo
GTTGGGCGTATCCCTC-1	Fib
ATGTTTCCAGAGATGC-1	Endo
CTCTCAGCATTTAGGC-1	Fib
CGTTCCAGTCCGCTTT-1	Fib
CTGCGTTAGTCGATAA-1	Fib
GTCTACCGTGTAGGAC-1	CM
TGTAGCACAGTCCTGG-1	CM
AGATTCGAGGGTCTGA-1	Fib
GAGAACGGTGCAAAGC-1	Neuronal
GGTGAAGAGTGAGCTG-1	Fib
GAAACAAAGAACGCCA-1	Pericyte
GTCACCTAGGTCTTTG-1	Myeloid
CGCTAGGCATGGCCCA-1	Fib
GGAGTAGAGTGAACCG-1	Fib
AATGGAATCGAGAACG-1	Endo
CTTAATCCAGATAAGT-1	Pericyte
TGCACCTGTAGTTTGC-1	Myeloid
TACCCTGGTTACTACG-1	Fib
TGTGTCCGTTCTGATG-1	Fib
GAAACAACACGATATC-1	Fib
CGTTCCAGTGTCTACA-1	CM
CACGTTCTCTGGCTAA-1	Fib
AGCCTTCCAAACCTAC-1	Endo
CAGGATTAGATCTAAG-1	Fib
GAACCTAGTTGGGAAC-1	CM
TCCCACATCTGATCCC-1	Fib
ACCTGCTCAGCAAACG-1	Fib
GTCACCTCACGGTGTC-1	CM
TACGCAATCTGGAAGG-1	Fib
TGTGTCCCAAGCCAGA-1	Myeloid
TCGGGACCAGGTCCTG-1	Pericyte
GGGTCTGAGACAACGC-1	Endo
CTGTTCGAGTCCGATT-1	Endo
GAGGTCCCACATTGCA-1	Fib
GATCGTACACCGATCG-1	Fib
GTGTGATAGGGAAGCG-1	Myeloid
TAAACCGTCTATCCTA-1	Myeloid
TCCATCGGTACAACGG-1	Myeloid
ATGCATGGTACGTATC-1	Fib
TAGGTCAAGGTTGTGG-1	Fib
TCAGGGCCAGTAGTTC-1	CM
TCAAGGTCAGGCAAGT-1	Neuronal
GCAGATTTCCTATCAT-1	Fib
TAGGAGGAGGATTTGA-1	Endo
TTCATCAAGGACCGAT-1	Endo
GGAGTAGGTGTGCTTA-1	Endo
GATTGACCACCGATCG-1	Fib
CAACCAAAGTTAGCGG-1	CM
TGTGTCCGTATACGCT-1	Lymphoid
CACAACAAGTCAACTC-1	Fib
GAGGCTCTCGGCTATA-1	Endo
ACTGTCCAGCCAGAAC-1	Myeloid
GAGATTCAGCGTATCT-1	Endo
TGAATCGAGCATTCCA-1	Fib
TCGCAGGCAAGGACCA-1	Fib
AGCTGTAGTACATGGG-1	Pericyte
CAACGTACATAGATAG-1	Lymphoid
TCTCTGGTCCTGTAGA-1	Fib
CCTTAATGTCCTATTT-1	Fib
AGCGATTGTTTCCACC-1	Myeloid
GTCGTAACAGTAACTC-1	Fib
TTACCGCGTTCTGATG-1	CM
CCCTAACGTGCAAGCA-1	Myeloid
AGCTATGAGGATTTGA-1	Fib
GCGGTGTAGTAGTTCC-1	Fib
TGACTCCCATGCGCTG-1	CM
GGAGTAGCAGTGGTCC-1	Endo
CATTCATGTGTGACCC-1	Myeloid
GCACCTTTCGTGTGCG-1	CM
TTCTAACTCAGGTCTA-1	Endo
TTTGCGCAGTTCTCCC-1	Fib
GCTTTCGAGGTGTCGA-1	Endo
GTGACATGTCAGTGCC-1	Fib
TACATGGAGAGCGGTT-1	Fib
CTTGCTGCATTTGTTC-1	Fib
CTTGTCGCAGGGTAAC-1	Myeloid
TACGGATGTCTCTGGG-1	Fib
AGTCCGGAGCTTCAAC-1	Endo
ATATTCCAGGTCTTTG-1	Fib
TGCTTCGGTTCTTATC-1	CM
AGTCAACTCTTTGCAT-1	Fib
CTCCCAACACGTTGTA-1	Endo
TAATCGGTCACTTACT-1	Myeloid
TAACAGCTCTTTATCG-1	Pericyte
CTGCTCATCACAAGCT-1	Pericyte
CCCTAACTCTTGGCCT-1	Fib
CCCTAGTTCTATGAGC-1	CM
GGATGAGGTGCTTACA-1	Fib
CGTTCCATCCTCCCAA-1	Lymphoid
CTGTTCGCACTGGGCT-1	Endo
TCTAGTTTCTGGCGCA-1	Endo
GTCACAACAGTAGTTC-1	Pericyte
AGGCCCATCCACGAGC-1	Pericyte
TCCCACACACTTACAG-1	Fib
CCTAAAGGTGCGTCCA-1	Fib
TAACAGCCAAAGCATA-1	Fib
TACCTCGGTTCCCGGA-1	Fib
TTCGATTTCAGCCGGT-1	CM
GCAAAGGGTACGCCCA-1	Myeloid
AGCCTCTGTATGTTCG-1	Pericyte
CTAGGGCCAAGCCAGA-1	Pericyte
TGCATGAGTCAGACGA-1	CM
ATTCGTTCACGATTAC-1	Fib
TAACAGCCATGTGGGA-1	vSMCs
GGTGCTGAGTGCTAGG-1	Fib
TGAGTCAGTACAAATG-1	Myeloid
ATCGAGTGTAGAGAGA-1	Endo
GTCACTCCACCGTTGG-1	Pericyte
GGTTGCGGTTGGCTTA-1	Pericyte
TCTAGTTCAAGCGAAC-1	Endo
AGCCTCTCAAGCCCTG-1	Endo
ATTGTGGAGAATCAAC-1	Pericyte
CCCGTTACAATGGCAG-1	Myeloid
GAACCTAAGGGCTCTC-1	Fib
TAGCATGCATGGGTGA-1	Fib
CTGTTCGTCGCTATTT-1	Fib
CTTCCAGTCCCGTAGG-1	CM
TAGCCGGCACCATTCC-1	Fib
GCTTTCGGTCAGTGTT-1	Fib
CGCACAGGTCACAGGA-1	Myeloid
ATGTACGTCTTCCAGC-1	Fib
GATGATCAGATGCGCA-1	Endo
AGATAGAAGAGGCGGA-1	Endo
ATGTCTTGTGCGACCT-1	Fib
TTGCTATAGACACGGT-1	Pericyte
TCAAAGCCAGGTTATC-1	CM
GCAGATTTCGCATAAC-1	Myeloid
GCATGATCACAGTTAC-1	Fib
TTGCAGATCCTTCGAC-1	Endo
GCAGCCAAGATCGCCC-1	CM
ATAGGCTGTCGATAGG-1	CM
TGGGTGCAGTCTTAGC-1	Fib
CAACGGCGTCCTTATT-1	Endo
AATGCCATCTTTGCAT-1	Fib
CCGAAGCTCTTACCTA-1	Fib
CCTAAAGGTAAACGTA-1	Myeloid
TGGAAGGTCGAGGCTC-1	CM
CCACGTTGTAGACACG-1	Fib
ACATGGTTCGTATAGC-1	Endo
GAACCTACATCGGCTG-1	Myeloid
TGTGTCCAGCTTACCA-1	Fib
GAAAGTAAGGGTCTGA-1	Myeloid
ACCTGCTGTACTTGAC-1	Fib
CTCGCTATCCATGTTT-1	Fib
GTCCATCCAATAGCGG-1	Fib
CCTGCTAAGCAACGGT-1	Fib
CTTGTCGTCGTCGCAG-1	Endo
CGCTGGAAGCGTATCT-1	CM
CACTAAGTCAGTGTGT-1	Fib
GCAGCTGGTGCGTTTA-1	Myeloid
TAGGTCAGTATTCTCT-1	Pericyte
TCCCACAGTGTAGGAC-1	Endo
CTGTATTCATCATAGC-1	Myeloid
ACCGCAGCACATTGCA-1	Fib
TACTCGCCAAGCGACA-1	Myeloid
TCAAGCATCCCACTTG-1	Fib
CACATGAGTAGTAACA-1	Myeloid
GAGCGCTTCGTATAGC-1	Pericyte
GGAACTTGTGCACCCA-1	Pericyte
TAAGCCAGTGTGAGGT-1	Endo
CTCGCTAAGTGTCCCG-1	Endo
TCAAGCAAGCACCATT-1	Myeloid
TGTAAGCCAATGACTC-1	CM
AAACTGCAGCACCATT-1	Endo
TCCCACAAGTCTAGAA-1	Myeloid
GCTGCGAGTTGAATAG-1	Fib
AAAGATGCAGGTGTCC-1	Fib
TTCGTTACAGCCGAAA-1	CM
TAGCGGCAGGTTGTTC-1	Fib
GTGCTGGCAAGGGAGG-1	Fib
CTTTGCGGTACTAGAA-1	Myeloid
CGCACAGGTGAATGGC-1	Fib
CGTAAACAGAAATACC-1	CM
GTTATGGGTATCTGCA-1	Fib
TCAGGTAGTCCGCTTT-1	Endo
TGGTCCTGTATCGCGC-1	CM
AATGTCGCAGTATCTG-1	Endo
AAGGTTCCAAGAAACT-1	Fib
CTTGTCGCAATGACTC-1	Pericyte
AGATAGACACAGTTCA-1	Endo
TCTATTGTCCAGTTAG-1	Fib
GTCACAAGTCACAGTT-1	Endo
TACTGCCTCAGTTGAC-1	Fib
GGAGGATTCGCAAACT-1	Fib
AGCCCGAGTCGCTAGC-1	CM
GACTAACAGCAGAAAG-1	Myeloid
GCAGCCATCTATCTTG-1	Endo
GTAGTACCACCGAATT-1	Pericyte
GCCTACTGTCGCTAGC-1	Myeloid
ACAAAGACAGTTGGAG-1	Fib
TTACCCGCACCCTTTG-1	Endo
CTTGCCATCGTGGAAG-1	Endo
CATAACGAGCATTGGG-1	Endo
AAAGGATTCCAAGAGG-1	Endo
ATGGATCCAGAGAGAA-1	Pericyte
ATGGATCTCATGCTTT-1	Pericyte
TGCATGAAGACTAATG-1	Endo
AGATTCGCATTACCTT-1	Pericyte
GCCAGCAGTAGGGTCA-1	Myeloid
CGTGGCATCTATACCT-1	Pericyte
GCTGAGCGTAGCCATT-1	Fib
GAGAACGCACTCCCAT-1	Endo
TGGAAGGTCTGGCGCA-1	Endo
GGATGAGGTTCACGTA-1	Fib
TCAGGTACAGGCTACC-1	Fib
ACTGCAAGTATTGTCG-1	Fib
AGCTGGCGTCAACTGT-1	Pericyte
AAATGAGAGGGCTTCC-1	Pericyte
AGGCCCATCACTGGTA-1	Myeloid
TGTAGCATCTGTTTAC-1	Fib
AGGCCTGAGCGTGTTT-1	vSMCs
TAGGTCACAATACTGC-1	Pericyte
CCGTGAGGTACCCATA-1	Neuronal
GAGACTTGTTATCGAC-1	Endo
AAGGAGCCATTTGTTC-1	CM
CCGCATTTCGGTACTA-1	Myeloid
ACTACCCCAACTGCGC-1	Endo
TGGAAGGAGCGGACTA-1	Fib
GAAGTGGGTTAGGCTT-1	Fib
TGTAGCACACGTACAT-1	Fib
GAGACTTAGCTCGTTA-1	Endo
GCTCACTCAAACCTAC-1	Myeloid
ACTGCAACATCCGTAA-1	Myeloid
GCGTTGGCATCACAGT-1	Endo
TTGCCCAGTGCGTCCA-1	Myeloid
ATGTCGACATATACGC-1	Myeloid
TTACGGACATTAGCCA-1	Myeloid
CGCTATCCATGTAGAA-1	Myeloid
CTTGAAGGTTGCTTGA-1	Pericyte
CAACCAACAAAGGCCA-1	Fib
TGCCTCATCTTGTCAT-1	CM
CTAACTTTCGTTGTTT-1	Myeloid
AGCCTGGCACGTACAT-1	Endo
TAGCCCTCATATACGC-1	Endo
CAAGGCCCAGCAACCC-1	Pericyte
GCTCCTATCCCACTTG-1	Fib
AACTGTGTCACATCCC-1	Endo
CGCTGGAAGAAATGGG-1	Pericyte
GGTTGCGAGTTAGCAA-1	Fib
GCGATCGTCACTACCC-1	vSMCs
GAGCGCTTCCGATTGA-1	Fib
AAACGAATCCCAGTAA-1	Fib
CCTAAAGTCTTGTGCC-1	Fib
CTGCGTTTCCTGTAGA-1	CM
AGTCCGGTCCCACTAC-1	Myeloid
GCGATTAGTGCGTCCA-1	Fib
GAAAGTAAGCCTTTGA-1	Fib
GCCTACTTCCGTCAAA-1	Fib
TAGACTGTCAAAGTAG-1	Myeloid
GTCGTAAGTAGACGCA-1	Fib
TGTAGCAGTCTGGGCT-1	Myeloid
TCAGTCCGTGCATTGT-1	Endo
GAGGATGTCTTCCACG-1	Pericyte
CTTCTAAAGTTCCCGG-1	Fib
ACAGAAAGTCACTCTC-1	Myeloid
ATGTACGGTTCCAGTA-1	Endo
CATGCCTCACTCGGAC-1	CM
TGGCCTTTCACCGCGA-1	Endo
AAAGGGCCAGCAAACG-1	Endo
GCGGTGTAGGCAGATC-1	CM
AACTGTGTCTATACCT-1	Pericyte
GCGGTGTTCCATACCC-1	CM
AGCTGATTCTGGCGCA-1	Myeloid
CTTGCCACACAGATGG-1	Pericyte
TAACTTCTCCCTACGT-1	Pericyte
ACATGGTAGAACTCCT-1	Myeloid
TTTGTGTTCCATCTAT-1	Pericyte
TGCATTTAGTTATGAG-1	Endo
GTCACCTGTCAGTGCC-1	Fib
CCGTACTGTGTACGCC-1	Endo
CTTCCAGTCCTGAAAC-1	Myeloid
CTTTGCGCAAGATTAG-1	Fib
GATGATCCACTTACAG-1	Fib
TTTGCGCCATGCGCTG-1	CM
AAAGGGCAGAAATCTG-1	Myeloid
CCTCCCTAGTCGAAAT-1	Pericyte
AACGGGACAGAACTTC-1	Pericyte
GATTAGCCATCGGCCA-1	Endo
CTAACTTAGTAGTCGG-1	Pericyte
TGTTAGGGTTTCACCC-1	Pericyte
CTCTCGAGTAGACACG-1	Fib
AAACTGCGTGTTAGAA-1	Fib
TAGCATGAGTCGTATC-1	Myeloid
TTGCTTAAGATAGGTT-1	Endo
TTTGTGTCACACATTG-1	Endo
TCTCTGGGTGCATTGT-1	Endo
CTTGAAGTCTGAAAGA-1	Fib
GTTCAAGTCGGATGTT-1	Fib
GCTCGAGCACCACGAC-1	Endo
TCGATTTGTGTTAGAA-1	Myeloid
TTTGGTTTCTGCCGAG-1	Pericyte
TGCATGAAGTTTGGAA-1	Fib
CGCACAGTCAACACGT-1	Endo
GTGCCAGAGGGCATTG-1	Myeloid
TCGCAGGTCTCTTCTC-1	Fib
CTTGCTGTCTTAAGCG-1	Pericyte
TGCATTTTCCTTACGC-1	Endo
TTGACGACAGTTACAC-1	CM
CAACGGCTCGCAACTA-1	Fib
TGTTAGGGTAGAAGCC-1	Myeloid
TAAGCCACAGGTGTCC-1	Fib
GGCATTAGTTGCCTGG-1	Pericyte
GCGGAAACAGGATAGC-1	Myeloid
CGCGCAAAGTGAACCG-1	Fib
GTGCCAGTCAGAGTGG-1	Pericyte
CTGGGACTCGCCCTTA-1	Endo
CTGTTCGGTCTTAGCA-1	Fib
CTCTCGATCTGGGCGT-1	Endo
ATATTCCCACAACGGA-1	Endo
TCAAGCATCTGTAGAC-1	Endo
ACTACCCAGTTACCAC-1	Fib
AATGCCAGTGCCGGTT-1	Fib
CCGTGAGAGGACCGAT-1	Endo
CCGCATTCAAAGGCCA-1	Endo
ACATGGTCATTATGGC-1	Myeloid
CTCATGCAGGCAGTGT-1	Fib
CCACAGGAGAGCCACA-1	Endo
TACAGCAGTCTGGGAA-1	Fib
TAAACCGAGGGCTCTC-1	Fib
GGTGCTGAGGTCCTCG-1	CM
GTAATCGGTAACTGAA-1	Fib
GATGGCCCAACGACAG-1	Neuronal
TAACAGCTCACGTCAA-1	Myeloid
GCAACCGTCATCATGG-1	Fib
TTTACGTGTCCGTAGC-1	Myeloid
AGCCTTCCAAGCGACA-1	Endo
CATGCCTCAACAAACA-1	Endo
CTTGAAGAGGCGACTA-1	Myeloid
AAGGTTCGTATGTCCA-1	Myeloid
AGCCTGGCAGCCACGT-1	Fib
CGAGTTACACCAAGGA-1	Pericyte
CGTTCCAAGGCAGTAC-1	Endo
TTGCGAAAGGTACATA-1	Endo
GCGGAAAAGGGTGTTG-1	Fib
GTTCAAGCAAGCAATA-1	Myeloid
GGTGTCGGTAGCATGG-1	Pericyte
CACAACAAGATGTTCC-1	Endo
TTTGCGCCAGGCAAGT-1	Endo
TAATCGGTCATCGCAA-1	Endo
TTCGATTTCACACGTA-1	Myeloid
TCACAGAGTGAATGGC-1	Endo
CTCTCGACATGCGACC-1	Endo
CAAGAAATCCGCTCTA-1	Endo
TATCGAGAGAGTTTGA-1	Fib
ACCTGCTAGAAATTCG-1	Myeloid
GCCTAGGTCAGTGTAC-1	Fib
CATTCCGGTGTCCTTC-1	Fib
CAGCCTTCACTACACA-1	Fib
GTAGACTGTCATCGTA-1	Fib
GGTGTCGTCCATACCC-1	Endo
GGACACCGTGTGTGCC-1	Myeloid
TAAACCGCAACGTCGC-1	Pericyte
TCGCAGGGTTGAATAG-1	Pericyte
CACTAAGCAGGGAGTT-1	Pericyte
AACAGTCGTGATGCGA-1	Fib
GGCATTAAGATGGCAC-1	Myeloid
GTAGGAGGTTCAGAAA-1	Pericyte
GTGGCGTAGTCTCGAT-1	Endo
CCTTGCAAGTCAGGAC-1	Pericyte
GGTTGCGCACACACAT-1	Endo
ACAGAAATCCGTTAGA-1	Fib
ATTGTCTTCCCGGGTA-1	Fib
AGGACGAGTACGCAAG-1	Pericyte
CTGTTCGCAGGGTAAC-1	Fib
ATGTACGAGGTTGTTC-1	Fib
AACCTGAGTAGCAGCA-1	Fib
CAACCAATCAAACCAC-1	Endo
TAGGTCATCGCGATGC-1	Pericyte
CAAGAAACATTCACGA-1	Fib
TCCATCGCACGATATC-1	CM
AGTTTGGTCTCATCCG-1	Fib
AGGACGAGTTGGGAAC-1	Pericyte
GTGATCACAGCCGAAA-1	Endo
GAAGAGCGTTTAGACC-1	Myeloid
ATCCCTGTCTCTATCA-1	Pericyte
GATGATCCACAGTTAC-1	Pericyte
CTCTCGATCATCGCAA-1	Fib
GGAACCCAGTGTAATG-1	Myeloid
TTGTCTATCAATTGGC-1	Fib
ATGTACGGTCTTAGCA-1	Fib
CCCAGAGGTTTGATCG-1	Pericyte
GCATTGACATGTCCCT-1	CM
ACCAAACCAGTAAGCG-1	Myeloid
AAGGTTCTCTGGCGCA-1	Fib
AGTTACGCAACTACTG-1	Endo
GAGCGCTTCAGGAATA-1	Endo
GCACGCAAGTATGCTC-1	Pericyte
TGGTCAACAACACGGA-1	CM
CAACGTATCAAAGTAG-1	Myeloid
GCGATCGCATAGGCGA-1	Fib
CCGTGAGAGAGAAGCA-1	Fib
GATCATGCACAAACGG-1	Endo
ACTACCCAGGTACACG-1	Lymphoid
TTCTGTAAGTAACACA-1	Endo
TGATGCAGTAACATAG-1	Pericyte
ACCGCAGCAGTATCTG-1	Myeloid
TCAGTCCCACTGCTTC-1	Fib
TCAAGCATCGCGCCAA-1	Pericyte
TACTGCCAGGAAGACA-1	Endo
GGGCCATAGGGCTTCC-1	Fib
TCAAGCATCGCCGAAC-1	Pericyte
CTACAGACACAACGGA-1	Myeloid
TTGGTCCAGTGGGACT-1	Pericyte
ATTCGTTGTTACCACA-1	Fib
CGCTATCCATGCGACC-1	Fib
GTGTCAATCCAATAGC-1	Pericyte
CCCTAGTAGAGTAAGG-1	Fib
TGTACAGTCGACTGGC-1	CM
TTGCGGGCATATACGC-1	Pericyte
TGGAAGGCACTTACAG-1	Fib
AGCCTGGCACATTCTT-1	Myeloid
ATGGATCAGTCGAAAT-1	Endo
TTCAACTGTACTATGC-1	Endo
GGAATCTTCTGTGTCC-1	Endo
TAGGTCAGTTGGGAAC-1	Endo
TCAAGCAAGATCGATA-1	Endo
GGACACCCATGTGAGG-1	Endo
TTGCCCACAATGCATC-1	Myeloid
ATTTGTCGTTCTTTCA-1	Pericyte
TCTCTGGGTACGCCCA-1	Pericyte
ATTGTGGCACTCGGAC-1	CM
CAGTATGCACGATTAC-1	Endo
ACCCAAACATCTCACC-1	Myeloid
CCTAAAGAGTTCCCGG-1	Fib
TTACTCAGTTCAGAAA-1	Endo
TCTCAGCAGTACTCTG-1	Fib
GTTGGTAGTGGTAAGC-1	Pericyte
GCACCTTTCCGCTATC-1	Endo
CCTGGGAAGCCTTTGA-1	Endo
CGCAATACATTACTTC-1	Endo
TGTGACACAATACTGC-1	Myeloid
AGACAAAGTGAATGTA-1	Myeloid
AACTGTGCACTGCTCT-1	Fib
GTGTCCTCAAGCCCTG-1	Endo
TTTGAGGGTCATTGCA-1	Endo
TGTGGCGCATTGCGAT-1	Endo
TGCTCGTAGCTACGCC-1	Myeloid
GAGGATGGTTTGTACG-1	Pericyte
CATGTTTGTGTAGGAC-1	Fib
ATGGATCAGGCACCTC-1	Endo
ACTTTCAGTGCAAGCA-1	Endo
CTTGTCGAGGAGAACA-1	Fib
TATGTGGTCGATCGCG-1	Endo
CTCTACGGTTTGTAGC-1	CM
GTGACATCACAGCTTA-1	Myeloid
GAACCGCCATCCCTTG-1	Neuronal
TGGGTGCTCTACATCT-1	Pericyte
GATCATGCACGCGTTG-1	Endo
AAACTGCTCGATATGC-1	Myeloid
GGCGAAACACCGTTGG-1	Endo
CGCTAGGGTCAAATCC-1	Myeloid
CTCATGCCAACGTCGC-1	Endo
GTGTGATGTAGTAACA-1	Myeloid
GTTCAAGTCACATTCT-1	Fib
TGAGCCGGTACGAGAC-1	Fib
CTCATGCCAAATGTCC-1	Endo
CAATCCCTCAGCCGAC-1	CM
ACCGCAGCATTACCTT-1	Myeloid
CGATGATCATTATGGC-1	Myeloid
TCAAGACCAATCATCG-1	Myeloid
TCAGGTAAGAACAGGA-1	Fib
AGGCGAAAGAACCCGA-1	CM
CATAACGTCCTCCATG-1	Pericyte
TACCTCGCACCATTCC-1	CM
CGAGTTAAGCTGATTC-1	Endo
ACTATTCGTAAACGAT-1	CM
CAGCCTTCAGAGCCAA-1	Fib
GTGCTGGGTGCAGACA-1	CM
TTCAACTTCAGCCGAC-1	Pericyte
TAGGAGGTCTGTGTCC-1	Myeloid
ACTACGAAGGATGTCG-1	CM
ATATTCCGTATTCTTC-1	Pericyte
CGGACTGTCAGTGTGT-1	Fib
GCAGATTGTGTTAGAA-1	Pericyte
GGGTCTGTCTTTATCG-1	Pericyte
TTGACGACATCATCGA-1	CM
ACTAGGTAGGCATGCA-1	vSMCs
TGGACATTCGAGTTAC-1	Myeloid
TGATCAGGTTATAGAG-1	Endo
GTAGTACCACAGGAAC-1	CM
AGCCAGCCATTACACG-1	Myeloid
GTTGGTACAGTAACGG-1	CM
CAGGGCTCAATGGTCT-1	Fib
GCTGAGCCAACGAGGT-1	Endo
ACTCGGGAGACCCATT-1	Endo
GGGTCTGCAGCAGGTA-1	Endo
TGCTCACCACTCGGAC-1	CM
ACTAGGTCAATAGCGG-1	Neuronal
GACCCAGGTCCGGTAC-1	Neuronal
GGAGGATGTAGCAGGT-1	CM
GTCGTAATCTGCCGAG-1	CM
AGTCAACGTGTGCTTA-1	Fib
CACGTTCAGGCGTCCT-1	Endo
ATTGTCTCATTATGGC-1	Pericyte
TATGTTCAGGGCTCTC-1	Endo
TTCATCACATGTAGAA-1	Myeloid
CTAGCGGCAGGTAGCA-1	CM
TCAATTCGTTTGTACG-1	Pericyte
CTGAATGGTATATGGA-1	Myeloid
CCCTCTCAGAGCAGCT-1	Pericyte
CCTAAAGGTGTCTCGG-1	Myeloid
TTGTCTATCACAGGGA-1	Endo
TAAGCCATCTCTCAAT-1	Pericyte
GCAGCTGCATGTAGAA-1	CM
GATGATCCATTAACGC-1	Endo
AGCCCGAGTCTCTGGG-1	CM
TTCTGTAGTCAGTGTT-1	CM
TACGCAAGTCATAGAA-1	Fib
TGGACATGTTTAGACC-1	CM
GCAGATTTCGCACAAT-1	Endo
TCAATTCAGTTCTCCC-1	Pericyte
CTTGCTGCAACAACTC-1	Fib
ACATGCAGTATTCGCA-1	Myeloid
GGTACCGCACGTTGTA-1	Fib
TTGCGAACAGTAACTC-1	Myeloid
ATTCGTTCACGGCCAT-1	Pericyte
TAGCACACAATTCAGC-1	Pericyte
GCACGGTAGTGCTAGG-1	Pericyte
GATTGACGTGCGCATC-1	CM
TGGAAGGCATACTGCA-1	Pericyte
TTGGTCCCACTTGCGG-1	Pericyte
TTACTTGAGTTCGACT-1	Endo
TTGTTGTAGCTAGTTC-1	Fib
TAACAGCTCTGTAGAC-1	Endo
TGCCTCACACATGATC-1	Endo
ACAGCGCTCTTGTCGC-1	Myeloid
AGACAAAGTAACATAG-1	Pericyte
AACCTGACATGCCTTC-1	Fib
CTTGCTGGTAACTCCA-1	Endo
AATGGCTGTCTGATTG-1	Pericyte
AACAGTCTCGAGAAGC-1	Fib
GGTGTCGGTCAGTGTT-1	CM
CTCTCGACAAGAGATT-1	Endo
ACTGCGGTCACGATTG-1	Myeloid
AGCTGGCAGCTTCAAC-1	Endo
GAGCATTTCGGAAAGC-1	Endo
AACCAACGTAACCGAG-1	Endo
TGATCAGAGTTGCCGC-1	CM
GCCAGACCACTCGGAC-1	CM
TTCGCGTTCAAGGCCC-1	Endo
GTGTCAATCACACGTA-1	Endo
TTGCTTATCTCTATTG-1	Fib
CACATGATCCTCAAGA-1	Fib
GTGACATCACTGCTTC-1	Endo
GACTAGTGTACAAGCG-1	Fib
GTTGGTATCTTGTGCC-1	Pericyte
ACATGCAAGGATGTAT-1	Myeloid
GCCCAGATCTCTCAAT-1	Myeloid
GGTGTCGAGTTCGACT-1	Fib
AAGGTTCCAGGCATCC-1	Endo
GTGCTGGAGACCATAA-1	CM
TTCATTGGTCCATTGA-1	Lymphoid
AACCAACTCCAATCCC-1	Endo
CATGTTTAGTACAGAT-1	Endo
AACAGTCCACCTTGTC-1	CM
GAGATTCTCGCGTGAC-1	Endo
ACGGATTTCGAACCGC-1	Pericyte
GCCAGCAAGTAGAAGG-1	Pericyte
GAAGTGGTCTATACCT-1	Lymphoid
TAACGGTAGGGATCCA-1	Pericyte
TCCGACTTCCCGAAGC-1	Pericyte
CTGGGACCAGGCATCC-1	CM
AGGCGTCGTACGTAAA-1	Endo
GAGTGAGGTTGTCGGC-1	Pericyte
GAACGTTAGAGCTCCC-1	Myeloid
CTGGGACAGTCGGGAT-1	Endo
ACTACGAGTTAGGAAT-1	Fib
AAACTCGCAGAAGTGC-1	Endo
TACCTATCAGGTCTGC-1	Endo
ACAAACCCAAAGCTTC-1	Endo
GTCCATCGTCGATAGG-1	CM
TTAACGGCAACTGCGC-1	Pericyte
ATTGTCTAGGCGACTA-1	Fib
GTTACTTTCGCATACA-1	Lymphoid
GCCATAAAGGCCTCGT-1	Endo
CTGCGTTGTGTGTGCC-1	CM
CAGTGCGAGTCAGGAC-1	Fib
CCAGATAGTTAGTAGA-1	Pericyte
AGCCAGCCATCATGTG-1	Endo
AACAGTCGTCCCTTTG-1	Pericyte
ACAAGCTCAGTTAAAG-1	Endo
CCTAAAGGTTTCCTAT-1	CM
TGTTAGGTCACTCGGG-1	CM
TCACTCGGTAATGCAA-1	Pericyte
TTCTGTAGTAGACACG-1	CM
CTGCTCATCAGCACGC-1	Fib
CTGCTCATCAGGAATA-1	Endo
GCTGAGCCATGACTGT-1	CM
AAGATAGCACGCTGTG-1	Fib
TGGGTTAAGGTTGTTC-1	Pericyte
AACCGATCATTACTCT-1	Endo
CCTTGCACACAAACAA-1	Fib
GTGGCGTCAACACGGA-1	Pericyte
TTGTTGTGTCCGTAGC-1	Endo
GCCTAGGGTGCTGAAG-1	Endo
CTTCTAAGTTTCCACC-1	Myeloid
CTCAGAATCGGGCTCA-1	Pericyte
TGGGTTAGTGTCGGTC-1	CM
GCATTCCGTTTGTAGC-1	Fib
ATTACCTAGTGTGTAA-1	Fib
CCTTAATGTCGATAGG-1	CM
AGATTCGCATCACAGT-1	Endo
AACAGTCTCGAGAACG-1	Fib
ATGCATGCAGGTTATC-1	Fib
TAGCTTTTCAGTGTAC-1	Fib
ATCCAGACAGTAACGG-1	Endo
CTAGGGCTCTTCACTA-1	Endo
AAATGAGTCAGCCGAC-1	Myeloid
TGACTCCCACTCGGAC-1	Fib
ACTGCAACACCCTTTG-1	Fib
CCTTGGTGTTGCCTGG-1	Fib
TCCAGAAGTTTGGATC-1	Fib
CCTTGGTCACGCGATC-1	Fib
CGTTCCACAGGGCTTC-1	Pericyte
AACGAGGGTAGCGAGT-1	Fib
TGCTTCGGTGTCCAGC-1	CM
TTCGCGTCAAGCGAAC-1	Endo
TTGCAGACACCTCGTT-1	Fib
TGTGGCGAGAACGCCA-1	Fib
GAACCGCGTGAGTCGA-1	Pericyte
TATTGCTAGATTACGA-1	Pericyte
TCACCTGAGACTCGGA-1	Fib
GGCGAAAGTCTGAGCC-1	Endo
TAGCTTTAGACTTGAA-1	Myeloid
GCTCGAGAGCCATGGA-1	Endo
TGCTCGTCACAGTTCA-1	Endo
AACCGATAGTAGTCGG-1	Endo
CTCATGCGTAAACGGC-1	Pericyte
GAGGATGAGTATACCC-1	Pericyte
AGATAGAGTGTACGCC-1	Fib
CCCAGAGTCTATTGTC-1	Fib
TAGCCGGAGAGGAACA-1	Fib
GGCATTAGTGTGTGCC-1	Fib
CTGCGTTTCGGTCTCT-1	Fib
TTACCCGGTTCAGTAC-1	Myeloid
ACTGCAACAAGCGACA-1	Fib
AACTGTGGTGTAGGAC-1	CM
TAACGGTCAGAGATGC-1	Pericyte
TTACGGACACATTCTT-1	Myeloid
TCACCTGCATAGGCGA-1	Myeloid
CTGGCAGTCGCGATGC-1	Endo
GCAGCCAAGTTATGAG-1	Endo
CTGCTCACAACTACTG-1	Endo
CCTGGGAAGCGCGTTC-1	CM
GGCGTTGAGACGTCAG-1	Fib
CTAGGGCAGACACAAT-1	Myeloid
AGCGTGCTCATGTTCT-1	Endo
AAAGGGCCAAACCTAC-1	CM
AAATGCCGTAGACACG-1	Fib
TAGCATGAGCAGTAGC-1	Fib
CTGGGACAGCGTCTGC-1	Endo
TCACCTGAGTGCCCTG-1	Fib
GTGTCCTCACTGTAAC-1	Fib
CCCACATCAAACGTTC-1	Pericyte
ACTAACGTCATCGCCT-1	CM
AGGACGAGTGGATTTC-1	Pericyte
CAGCCTTCACAGTTAC-1	Pericyte
ATCCAGACATCCGTGG-1	Fib
GTGGATTGTGCAGACA-1	Myeloid
GTCACCTAGACCCTAT-1	Endo
TCCATCGGTTAAGGGC-1	Myeloid
GCTTGCTGTTGGCGAA-1	Lymphoid
CATTGGAAGGATTTGA-1	Endo
TTCGGTCTCAGCACTA-1	Endo
TAACGGTGTAGGTGAC-1	Endo
GATGATCCAAAGCTTC-1	Myeloid
GGTCATAAGACTAATG-1	Fib
AAGATAGCACTCCTCA-1	Endo
CAAGCTAGTGACGCAA-1	Endo
CTCATGCGTGCACTTA-1	CM
GCAGCTGCACTCGGAC-1	CM
CTTGCTGAGCACCATT-1	Endo
GCCCAGAGTAAGTCTC-1	Endo
ACTAGGTCATGCGACC-1	Fib
CCTGGGACAATGCACT-1	Pericyte
TTGCCCAGTACGCCCA-1	Pericyte
GCTGTTCGTACTAGAA-1	CM
TAGGTCAGTAGATGAT-1	Pericyte
CAAGAAATCCCTACGT-1	Fib
ACTATTCTCTGTAGAC-1	Endo
TTGTTGTAGGAGACTC-1	Myeloid
CCACGTTCACCTCGTT-1	Myeloid
GGAACTTCATAGCAGG-1	CM
CTCTACGGTCACTCTC-1	CM
GCATTCCCATGATTGC-1	Pericyte
TTTGTGTTCGCTTACC-1	Endo
TTGCTATGTAGGTCTT-1	Endo
CCCACATTCTCCAACC-1	Pericyte
CGGACCATCGATAGGG-1	Fib
TAACTTCAGGAAGAAC-1	Endo
ATGCATGTCACCCTTG-1	Myeloid
CTTGAAGCAAACCGAG-1	CM
CCGTAGGGTACGTAAA-1	Pericyte
GCTTTCGCATTCACGA-1	Fib
TAAGCCAGTGCTGTGC-1	Fib
ATCCTGCAGACTCGGA-1	Fib
CAGGATTAGTTGACAA-1	Fib
ATTGTCTCAACTACTG-1	Fib
CTAGGGCGTCTGAGCC-1	Lymphoid
TGCCTCAAGGAGACTC-1	Fib
AGATTCGGTCATAGCT-1	Endo
CTGGCAGCAGTCAGCC-1	Pericyte
GGATGAGGTGCAAGCA-1	Pericyte
CCCTAGTAGTGTCGCC-1	Myeloid
TGACAACGTCCTTCAC-1	Pericyte
ATTGTCTGTCAACAGG-1	Fib
ATCCCTGCAAACGACG-1	Endo
ACAAACCTCCTCCTGA-1	Fib
ACTACCCAGTAGTTCC-1	Pericyte
CGTTCCACAGCTGATT-1	Endo
GCCATAAAGCGTCAAG-1	Fib
TAGCCCTAGAACTCCT-1	Endo
CGATGATAGACACGGT-1	Lymphoid
GCTGCGATCTTCATAC-1	Endo
TGGCAATAGTCGGGAT-1	Fib
AACGAGGGTCGATAGG-1	CM
ACTATTCGTAACACTC-1	Myeloid
CGTGGCACAAACCCTA-1	CM
CTCAGAAGTGATGTGG-1	Endo
ACCTGCTCAAAGAGAG-1	Pericyte
TCACAAGAGTACCACT-1	CM
CAACCAAAGTTGCCGC-1	Pericyte
TGCATTTTCAGGAAGC-1	Pericyte
TACATGGGTTCCAGTA-1	Fib
TGGTCCTGTGGCATAG-1	CM
CCGTAGGTCCACGCTT-1	Fib
GTCTACCAGGGAGTTC-1	Endo
TCGAGCGGTTCTACGA-1	Fib
GCTCAGGGTGCTTGAT-1	Myeloid
TTAGGTGTCCACGCTT-1	Fib
TTCATCACACTCGGAC-1	Myeloid
AACTTGGCACGCGATC-1	Myeloid
GCGCATGTCTGCCGAG-1	Endo
GTGATCACACCCTTTG-1	Pericyte
GGTACCGCAGTAACTC-1	Fib
TCACCACCAAGGAGTC-1	CM
AGCCTGGAGCGTTGCC-1	Pericyte
GGCGTTGCAACAACTC-1	Endo
TTGCCCAGTGGCATAG-1	CM
GGAGAACCAAATTCCG-1	Endo
GACTAACTCCCAGTAA-1	Lymphoid
CTTTGCGAGAGGAAGT-1	Fib
TTCGGTCAGTATAGTG-1	Pericyte
CTGTATTGTACGCAAG-1	CM
GAGTGAGGTAGTGATA-1	Fib
GCACCTTCAATGCATC-1	Fib
CCTATTAGTCAGAAGC-1	Endo
CATAACGGTTACGGAG-1	Fib
GTCCATCAGACCTATC-1	Fib
CCATACCGTGGCATAG-1	CM
GGATGAGAGACGACTG-1	Endo
TATTGCTCACAATAAG-1	Pericyte
AGGACGAGTTACGGAG-1	CM
AAGGTTCTCTGTTGCC-1	Endo
ATTACTCAGATACCAA-1	Endo
CACATGACAATTGGCT-1	Endo
TTGAGTGCATGTATCG-1	Endo
AGATAGAAGACACTTC-1	vSMCs
GGCGAAATCTTCATAC-1	CM
TGTGTCCCAAGGAGGG-1	CM
TTTGGCCAGATCGCCC-1	Pericyte
GTGCACGGTTTAAGCC-1	vSMCs
TGCATGAGTGAGGTCA-1	CM
ACCTGCTAGCAGGAGG-1	CM
AGGCGAATCTTCGTTA-1	Endo
GTCACCTTCGAGGTAG-1	Endo
CTCAACCTCCTAGAGT-1	Lymphoid
CCTCCCTTCCGCCTAT-1	CM
GGGACCTGTCATTGGT-1	CM
GCGATCGCACTGGGCT-1	CM
ATGTCTTGTGCGTTTA-1	Endo
ATTACCTGTTGGGAAC-1	Myeloid
ACGTGGCCACGATATC-1	Endo
AGCCTCTAGAACGACC-1	Neuronal
TGTGGCGGTCAGTGTT-1	CM
CTCTAGCTCCTTCGAC-1	Myeloid
ATGGATCTCCCGATTC-1	Lymphoid
CACCACTGTTGCAGAG-1	CM
TGCATGACACGAACGA-1	Neuronal
ATTGTCTGTACGCAAG-1	Fib
AGCCTCTCATAGCCGC-1	Endo
CTCTCGAGTTGGACGA-1	Fib
AACTGTGGTATGTCCA-1	Fib
ACTGCAAGTCTGAGCC-1	Endo
AATGGCTCACTTATGG-1	Fib
GAACGTTCACTCAAGT-1	Neuronal
CCACAGGTCCGCTCTA-1	CM
TAGACTGAGCACACCC-1	Endo
GAGATTCCATGTAGAA-1	Endo
ACAGCGCTCCTATCAT-1	Fib
ATAGTCGAGTCCGATT-1	Myeloid
TCGGGACCACGGTGTC-1	CM
GATCATGGTGAGAGTC-1	Fib
TACCTCGCAACAAACA-1	CM
GTCACCTAGTACTCTG-1	CM
CAACGTAAGGTTGTGG-1	Fib
CGTACAACACCATTCC-1	CM
TGCTATTGTACGCCCA-1	CM
GGAATCTTCAGTACAC-1	Pericyte
AGTCCGGCAGGCAAGT-1	CM
GCGAGAATCATCGCCT-1	Fib
TTACTTGGTGGCATAG-1	Fib
CAGCCTTGTCCCGAGT-1	Pericyte
GAGCGCTTCTGTCGTC-1	Fib
AACTTGGGTAACGTAA-1	Endo
TGACTCCAGAAAGGGT-1	Fib
GCGTTGGTCTCTATCA-1	CM
ATGGATCGTCGAGAAC-1	CM
GCCTACTAGTGTCGCC-1	Fib
TAGCCGGCACTGAAGG-1	Fib
CTTCCAGTCGATGAAA-1	Fib
TTACGGACATTGTGAC-1	vSMCs
CTTGCCAAGTCACGCC-1	Myeloid
GGCATTAGTACGCAAG-1	Pericyte
TTCTGTATCACTAGCA-1	Lymphoid
CCAATGAGTGGCATAG-1	CM
CGATGATCAAACCTAC-1	Myeloid
GCCTAGGTCGGTCTCT-1	CM
CTCATGCGTTGGGAAC-1	CM
CCCTCTCGTCGAGGTA-1	Neuronal
TGTTAGGAGTCGAGCA-1	Myeloid
CATAACGAGTACTCTG-1	CM
AACCTTTGTACGCAAG-1	Fib
AATGGCTCAGCACATT-1	CM
GTGCTGGCACGACGAA-1	CM
CATTGGACATTGATGC-1	CM
GCCATAAAGGAGACTC-1	Fib
GCTCGAGCAGTTGGAG-1	CM
ATTTGTCGTTCCTGTC-1	CM
GCGAGAATCCGCTCTA-1	Pericyte
TTCGCGTGTTCCTGTC-1	Myeloid
TAACTTCGTTAGTAGA-1	Fib
CACGTTCAGGGTTCTT-1	CM
GGGACCTCAGATTGTC-1	CM
CGGACCATCGCCGAAC-1	Pericyte
GCCCGAAAGTCCCGCA-1	CM
ACAGAAATCATCGCCT-1	CM
AAAGGGCTCAGCACGC-1	CM
TACCTCGCAAACGACG-1	CM
AACGGGACATGCACTA-1	Fib
CGTACAAAGAGGTACC-1	Endo
ACCGCAGCATGCGACC-1	Pericyte
AACCTTTGTCAACAGG-1	Fib
CTGTATTGTCAACAGG-1	CM
TAGCATGCAATGCACT-1	Pericyte
GAACCTAGTTAACTCG-1	CM
GAGGTCCAGATCGCCC-1	Fib
TAGCCGGAGGTTTCTG-1	CM
CTAGCGGAGCTGCCAC-1	Myeloid
AGTCCGGCACTTATGG-1	CM
TGAGCCGCAAGGAGTC-1	CM
TATCTGTGTCAGACGA-1	Endo
TTACGGAAGGTAGGAA-1	Lymphoid
TACCTCGCATTAGCAC-1	CM
GCAAAGGGTTGGGAAC-1	Endo
ACATGGTCAAACCTAC-1	Myeloid
AGCGTGCTCTAAGGTC-1	Endo
CATTGGAAGCTTACCA-1	CM
GCACCTTTCACAAGCT-1	Endo
ACTAACGCAAGCACTT-1	Fib
GCTGTTCCAGCAGGTA-1	Myeloid
AGCTGGCCAAGACACG-1	CM
CCGTGAGTCTTCATAC-1	CM
GCATTCCGTCACTCTC-1	Fib
TTCGATTCAACGGACA-1	Fib
AATGCCAGTATTCTTC-1	Neuronal
GAAGAGCAGGCGACTA-1	CM
TTGTTGTGTACGCCCA-1	CM
GCCCGAACAGGTCCTG-1	CM
TTGCCCACACTGGGCT-1	Myeloid
CGCGCAATCTGTGTCC-1	Myeloid
