Barcode	cell_type
CCGTACTTCAGTCTTT-1	Endo
ATTCGTTAGGCGATTG-1	Endo
CATTCCGTCGTCGCAG-1	CM
TAAGCCATCTATTTCG-1	Fib
TTTGCGCTCATCATGG-1	CM
GATCGTAGTATTCGAC-1	CM
GCTTGCTAGTCGAAAT-1	Fib
CTTCCAGGTCCTCAGG-1	Fib
GATGGCCTCTGAAAGA-1	CM
GAGCGCTAGGTGAACC-1	CM
GTAGGAGGTAAACCCT-1	CM
TGGCGCACATTACTTC-1	CM
CCTCCCTGTATTCGAC-1	CM
GCCTAGGTCGCGTTCT-1	CM
GAACTTGGTGAAACAT-1	CM
TGGGTTATCAAATGGA-1	Pericyte
GGGTGTCAGAGAGGTA-1	Fib
CCTGCTACACGAACGA-1	CM
GCCTACTGTGCAACAG-1	CM
GGTACCGGTAGAGAGA-1	CM
GTTCAAGGTATGGATA-1	CM
GCTTTCGCAAGGCGTA-1	CM
TAGCATGAGGCTTAAA-1	CM
TAGCGGCGTAAACCCT-1	CM
TCAGGTAAGGCTTCGC-1	CM
TCGGGACTCTGTGTGA-1	CM
TCACAGAAGAACGACC-1	CM
AACGGGAAGAAGGGCG-1	CM
AGTCAACAGCGAATAT-1	CM
TCAGCTCCATGACTGT-1	Fib
GGGTCTGTCGCAACTA-1	CM
GTGATCATCGCTTACC-1	CM
AGGCGAAAGTGGACGT-1	CM
TGCTCGTGTGTTTCTT-1	Fib
GAACTTGCACTCGCAG-1	CM
GGAGGATCATAGCAGG-1	CM
ACAGCGCGTAGTAACA-1	CM
AACTGGTGTAACCGAG-1	CM
TAAGTGCGTAACGGCA-1	CM
TATGTTCTCTGTGTGA-1	Fib
AGCTGGCTCAGTCACA-1	Fib
ATTTGTCGTGATTCCA-1	CM
GCATTCCCATAGTCCA-1	CM
GTCGTAAAGTCGTGAG-1	CM
AAAGGATCAGATTTGC-1	CM
GTCACTCAGACACGGT-1	CM
TTAGCTTGTGGACGAT-1	CM
AACCTTTGTGCAACAG-1	CM
GTGTCCTCAGGATGTG-1	CM
TTTGTGTCATCGAGTT-1	CM
AACCAACTCGATGCAT-1	CM
ACAGGCCCATAGAATG-1	CM
ACAAGCTTCGCCGAAC-1	CM
AGCTATGCAATGATGA-1	CM
GCGCATGCAGGACTGA-1	CM
TCAGGGCGTTTGCCAA-1	CM
ATCCAGAAGGCCTAAG-1	Fib
GGTGAAGCAGTAAGCG-1	CM
TCAAAGCAGAGCAGCT-1	CM
GAGAACGGTACGCCCA-1	CM
GTGCCAGTCATGAACC-1	CM
GGCACGTGTGCGCTCA-1	CM
GGAGAACTCCTTGACC-1	CM
CACATGAGTGATGTGG-1	CM
GCGAGAAGTCCGTCGA-1	CM
TACGGATTCGCGTTCT-1	CM
AAATGAGGTACAAGCG-1	Endo
TTGCACCCACGCCGAT-1	Endo
TTCGTTACACAGGAAC-1	CM
GCGAGTCAGCTTTCCC-1	CM
ACAAGCTAGGTGAACC-1	Fib
GTAGACTAGTAACTCC-1	CM
AAAGATGTCACTAGGT-1	CM
CGGACCATCCAGGCCA-1	CM
ACTTTCATCCTGGGAC-1	CM
CTGGCAGCATTACTCT-1	Fib
TAGCGGCCATGTATCG-1	CM
GAACTTGCACACATGT-1	CM
AACAAAGGTAGCGTTT-1	Myeloid
CACAGATCAAGGTCGA-1	CM
TTTGAGGGTGAGTCGA-1	Fib
TGTACGAGTGAGTCGA-1	CM
TTTGGTTCAGATGGCA-1	Fib
TACCCTGAGGAGTCTG-1	CM
TCTCAGCCAATGGCAG-1	CM
TGTACGAAGGCGATTG-1	CM
GGGAACATCTCCTTAA-1	CM
GCAGATTCACTGTTAG-1	CM
ACAGACTGTTCCTATT-1	CM
ATGTCGAGTCCAGACC-1	CM
CCGTGAGCAAGGTTCT-1	CM
GCTGCGATCCCAGTAA-1	CM
CTGCTCATCACGTCAA-1	CM
TGAATCGAGAGACTCG-1	CM
CCTGGGAGTTTCTACT-1	CM
CTCACCATCACACGTA-1	CM
GTCACGGAGCCGCAAA-1	CM
GGTAGGATCACGTCAA-1	CM
TCGGGACTCAGAATGA-1	Fib
TGTAAGCTCCAAACCA-1	CM
GCTCAGGGTCCAACCG-1	CM
CCCGTTAAGATCGCCC-1	Fib
CTGCGTTTCGTTACAG-1	Fib
GAAGTGGGTTTGCCAA-1	CM
AGATAGACAGATACAA-1	CM
GAGAACGCATTGCGAT-1	CM
TCGCCTAAGCCATTCA-1	CM
TTTACGTAGTAGGTCG-1	CM
TCCATCGAGTCCGTGC-1	CM
TCAGCTCGTCTGGATT-1	CM
TATGTTCCATCACAAC-1	Fib
GAAGTGGAGAGAGGTA-1	Fib
GTCCATCAGGTTGTGG-1	CM
GAGGTCCAGTCTGCTA-1	CM
CCGCATTTCGTCCCAT-1	Fib
ATGCATGGTATGGGTG-1	Fib
GAGCGCTAGGTTCTCA-1	CM
AGCGTATCAAACTACC-1	CM
GAACGTTCAAGCGACA-1	CM
GAGTGAGCACAACGGA-1	CM
TCAGGTATCGCACCTT-1	Endo
ATGGATCGTAGCGGTA-1	CM
CATTCATCATTTCACT-1	CM
AATGTCGCACGATTAC-1	CM
GTTGGGCGTCTGATTG-1	CM
CTGGCAGAGGTAGGCT-1	CM
CACCTTGAGAGAGTTT-1	CM
CACCTTGAGGACCGAT-1	CM
AGGCGTCGTCACAGTT-1	CM
ACAGCGCAGGCAATTA-1	vSMCs
AGGACGAGTCACATTG-1	Fib
AGCGATTGTAAACGAT-1	CM
TCCATCGTCGGAAAGC-1	CM
TGTGGCGCAGATTAAG-1	Fib
TACTGCCCAAGGACCA-1	CM
ATGTCGATCACGATTG-1	CM
TGCCTGTAGCAGAGCT-1	CM
AGTCCGGGTTGAATAG-1	CM
AAACTCGTCTCCTTGG-1	CM
GAGCGCTGTCATCGTA-1	CM
GCTCCTATCGTTGTTT-1	CM
TCGCCTACAAAGGAAG-1	CM
AGTGCGCCACATTCTT-1	Fib
TGGTCAAGTTAGAGAT-1	Fib
TTGCAGAGTCTGTCCT-1	CM
AAGGTTCAGGGAAATG-1	CM
CCCTAACTCTATCTTG-1	Fib
ACTACGATCCCATAGA-1	CM
TGTGGCGCATCAGAAA-1	Fib
TTTGAGGCATAGTCCA-1	CM
ACCTGCTCAAGGCTTT-1	CM
CCAGATACAAAGCATA-1	Fib
GCAGATTGTGCATCAT-1	CM
CATTCATCAACTACTG-1	Fib
TAGGTCATCGCTCGGA-1	CM
GCCAGACAGCTAGTTC-1	Endo
CACAGATAGTGTTCCA-1	CM
CTTGCCAGTCGCTACG-1	Myeloid
TGCCTCAGTGCCAAGA-1	CM
CTTCCAGAGCAGGACT-1	Fib
TTACCCGAGCCTGTAT-1	Fib
TTACTCAAGAACTAAC-1	Fib
ACTGCAAGTAGCGGTA-1	Lymphoid
ATTACCTGTCTGTTGA-1	CM
GAAGAGCAGCCATCAT-1	CM
GTAGGAGGTTCCAGTA-1	CM
TTCATTGTCCATCGAA-1	CM
GATGGCCTCCCGATTC-1	Fib
GTCACCTCATGATCGT-1	Myeloid
AACGTACAGTCTAGAA-1	Fib
GTGACATTCCATGTTT-1	CM
GAGACTTGTTGAATAG-1	CM
CACATGACACGATATC-1	CM
AAGATAGAGCGTTGCC-1	Fib
GCATTGACACGGTTAT-1	Myeloid
AACCGATAGGGAGATA-1	Fib
CGCGCAAGTGGTTCTA-1	CM
CCCTAACAGTGCCCTG-1	Fib
GCTCCTACAACGAGGT-1	Fib
CACCTGTAGATCGATA-1	Fib
ATGGATCGTTCTGAGT-1	CM
GCGATCGGTTCCTATT-1	CM
GCCCAGACAATCATCG-1	CM
GTGGATTTCGGTTCCT-1	Fib
TTACCCGGTCTGTGTA-1	CM
GTCACGGTCATTCTTG-1	CM
CAGGATTCAACTCAAC-1	CM
TCGTTCGTCCATATCT-1	Fib
AACTTGGGTTCTACGA-1	CM
TTGAGCATCAAGGCCC-1	CM
ATCCCTGAGGTTACAA-1	Fib
ACAATCGAGAGGCCTA-1	CM
TAACTTCAGCTAACAA-1	CM
AGCTGTATCCACGCTT-1	CM
GTGCCAGAGATAGGTT-1	Fib
TACGGATAGTTGAATG-1	CM
GCAAAGGAGTACAGTA-1	CM
CTAACTTCACGTTACA-1	CM
CCCAGAGCAGTATCTG-1	CM
AGGACGATCGTCCCAT-1	CM
CAAGAAAAGATTACGA-1	CM
TAGTCCCAGCGCACAA-1	Fib
AAGGAGCAGCGCACAA-1	Fib
TAGCCGGTCCGCGATG-1	CM
GGCGTTGAGACCATAA-1	CM
GTTATTCGTCAGGTGA-1	Fib
ACTACCCAGGTCTTTG-1	CM
GACCGACAGCCATTCA-1	CM
AGCCGCAGTATGTTCG-1	Fib
AAACTCGAGTCCTTCC-1	Fib
AGCCTTCTCTTCTCTC-1	CM
TACATTCCATTAAGGA-1	CM
TAATCGGGTCATAAGA-1	CM
CATGCCTAGACGCCCT-1	Endo
ACAGAAAAGTCAGGAC-1	Fib
GAAGTCTTCGTCTTAT-1	CM
GCGGAAACAAAGCTTC-1	CM
AGCCCGACAGTAGGCA-1	Fib
AGTCAACGTGACCAGA-1	CM
ATTCGTTAGGTACACG-1	Fib
GATGATCAGGCCAGTA-1	CM
CGAGTTATCCTAAGTG-1	CM
GCGATTATCTCTGCGT-1	CM
GCCATAAGTGCACTTA-1	CM
CTGTATTTCGAGGTCC-1	Endo
TCGTTCGGTTATCGAC-1	CM
CACGTTCTCCAGTTAG-1	Fib
TGGCGCAGTATCCCTC-1	Fib
AATGCCACACTGATTG-1	CM
TTTGAGGAGGGAAATG-1	CM
AATGGAACAGGGTACA-1	CM
GTTGGGCTCCCTAAAG-1	CM
TAGCGGCCAAGGAAGA-1	CM
CCCTGATGTCAAGACG-1	CM
TCTCTGGAGAGTTTGA-1	CM
TCACAGATCTACATCT-1	CM
TTGCACCGTGCAAAGC-1	Fib
ATTGTGGCACCCTTTG-1	Fib
GTGTCAAAGGCTTAAA-1	CM
TTGAGTGAGTAGTTCC-1	CM
GCGTAGCCAGACTAAA-1	CM
AACATCGTCTACCCGT-1	CM
TGGCCTTGTGTCTCGG-1	Myeloid
TTCGATTCAACTGCGC-1	Fib
TTAACGGTCGCAAACT-1	CM
CACTAAGCATTTCACT-1	CM
GCATTGATCATGAACC-1	Endo
CCCTAACCAGGTAGGT-1	CM
AAATGCCCATCGGCCA-1	CM
GCTTAAGAGTGCTAGG-1	CM
GCAGATTTCAGCCGGT-1	Fib
AGCCCGAAGTTGGAAT-1	Fib
TTCTAACCAATAGCGG-1	Fib
TGGTCCTTCTTACCTA-1	CM
AGCTGGCCAATCCATG-1	Fib
CTCAGAAAGTAATCAG-1	Fib
TAGCTTTAGAGTTTGA-1	CM
TGCTCACTCGGAAAGC-1	Fib
TTGGTCCCAAGCGAAC-1	Endo
ACAAGCTGTGTCCCAG-1	Fib
GCTGTTCAGAGAGTTT-1	CM
ACTGCGGTCAGGTCTA-1	Fib
AGGACGATCCAATAGC-1	CM
CCACGTTAGGAGTCTG-1	CM
CCGTGAGCAGATTTGC-1	Fib
ATTGTCTCATACAACC-1	CM
GCTGTTCAGGATGCCA-1	CM
CTAGGATCACCACAGC-1	Myeloid
TTTGCGCCACCACGAC-1	Fib
ATTACTCTCGACTTAG-1	Fib
TCGCAGGAGACCCTAT-1	CM
AGCCTGGAGTAGACCG-1	Fib
AGTGTACTCGGACGAA-1	Fib
GGTGTCGCACTCGGAC-1	CM
TTTGGTTAGAAATTCG-1	Fib
TTGTTCATCCATGACA-1	Myeloid
ACAGAAAGTGCATTCA-1	CM
TTACGGAAGGCTAAAT-1	CM
TTTGGCCCACCTGGTG-1	Fib
TTACCGCTCCGGACTG-1	CM
TACAGCACACGGCCAT-1	CM
GAGCATTGTGTGCTTA-1	CM
ACCATCCTCCTATCCG-1	CM
AGTTTGGGTATCTCAG-1	CM
GGTCATATCCCTACCA-1	Fib
CATTGGACAAGGGAGG-1	Myeloid
CAAAGCTGTTCTACGA-1	Fib
ACCGAATAGGATTGCG-1	Fib
AAAGGGCGTTGCCTGG-1	CM
TGACAACCAATGACTC-1	CM
CCTGCTAGTACCTATG-1	Fib
TAATCGGCAGCGCGTT-1	vSMCs
TAGCCGGAGTCCCGCA-1	Endo
CTGTTCGAGTACAGAT-1	Fib
CTGGGACGTCAGGCTC-1	CM
TCAGTCCGTACGCAAG-1	CM
TGAGTCAGTCTGGGCT-1	CM
CTGTTCGTCGCCACTT-1	CM
GTGCACGTCATCGCTC-1	CM
GTTGGGCGTCTCTGGG-1	CM
TCGGGACAGTTAGCGG-1	CM
TGGAAGGTCCAGGCCA-1	CM
ACCATCCAGAGAGGTA-1	Myeloid
CATGTTTAGGCGTCCT-1	Fib
GCGGTGTGTGTCGTGC-1	CM
GCTTTCGGTAAGTCTC-1	CM
GGTGAAGGTATCTAGC-1	CM
AAGGAGCGTAACGGTG-1	Myeloid
GAATCTGCAGCTATAC-1	Myeloid
GTGGCGTAGTCATACC-1	CM
CACTAAGAGGTTCGAG-1	Fib
CACCACTTCTCATATC-1	CM
TACGCCTCAATTGCCA-1	CM
CACAACATCTTTATCG-1	CM
GCGCATGAGACACAAT-1	CM
TGCTCACCATCCTCGT-1	CM
TTTGGCCCAATGTGCT-1	CM
ACTAGGTGTTGGGAAC-1	Fib
ACAGGCCAGTCAGGAC-1	Fib
TTGTTCATCCCAGCAG-1	Endo
ACGGATTCAGTTACAC-1	CM
TGCTCGTAGTGCTCGC-1	CM
TAGCCGGTCGAGGCTC-1	CM
CTCACCACACCTGGTG-1	CM
CAACCAATCCCACTTG-1	Fib
TTAGGTGGTTATGCAC-1	Fib
TGGTCAACAAAGGCCA-1	Fib
CTCATGCAGAAGCCGT-1	CM
TTGGTCCCAGAATGCG-1	Myeloid
ACCGCAGTCAGGATCT-1	Fib
TTGCTTAAGCTGAAAT-1	Fib
GCAGCCAGTAAGCCTT-1	Fib
CTCTCGACAACCTCTC-1	CM
GACCTTCTCGGGAAAC-1	Fib
TTTACGTCATACAACC-1	CM
AAATGAGTCTGATCCC-1	Fib
CTAACTTCACCGTCTT-1	Fib
GACTAACCACGATATC-1	CM
CCTTGCACACTCCACT-1	Fib
CCCTGATAGAGTCCGA-1	CM
TCCATCGTCCCGTATC-1	Fib
GCGGTGTTCTTCTCTC-1	CM
TCTAGTTTCTGCGTCT-1	Fib
CTAGGATTCTTAATCC-1	Myeloid
AGCCGCAGTCACTCTC-1	Fib
TGGTCCTCAGCGTCGT-1	CM
TCGCCTAGTCTGGATT-1	CM
GTGATCAGTATGTCCA-1	Fib
TCACAGACAAGCCAGA-1	CM
GCCAGCAAGCCTTTGA-1	CM
GCCTACTCAGATGGCA-1	Fib
GCTTAAGAGTACCCAT-1	CM
TTACTCATCAAACCAC-1	Fib
CAACCAATCCTGTAGA-1	CM
CTTCTAAAGAAAGCAG-1	Fib
ACAATCGCACCCTTTG-1	Fib
GTGATCATCTCGACCT-1	Fib
TTGCACCAGTTACCAC-1	CM
GAAAGTATCAAACCAC-1	CM
TAACGGTAGGAGTAGA-1	vSMCs
GGAGTAGAGGACTAGC-1	Neuronal
GTACTTTCATAGGCGA-1	Fib
CCTGGGAAGACAACGC-1	CM
GAAAGTATCTATCTAC-1	Fib
AGTGCGCTCGACGGAA-1	Fib
TAACGGTGTATGGATA-1	Fib
CCGTACTTCCTAAAGC-1	CM
AATGGCTAGTGTCGGA-1	Fib
CTGTATTGTCATAAGA-1	Fib
TTTGCGCGTACGCAAG-1	Fib
GTTATGGGTTCTGAGT-1	CM
CACTGAAGTTGTGAGG-1	CM
TAGCTTTCAGTAAGCG-1	Fib
TAATTCCGTTATAGAG-1	Neuronal
CAACCAATCCCAGCAG-1	CM
CCCAGAGAGGGCATTG-1	Fib
GCGCATGCAGGTCTGC-1	CM
GATCATGTCCGGCTGA-1	Myeloid
TAGGTCAGTCAGTGCC-1	Fib
TACGCCTGTAACACTC-1	Fib
GTGGCGTTCCTGTGGG-1	Fib
GTGGCGTCACCTATTT-1	CM
GGTTGCGTCAATTCCT-1	CM
TTAACGGGTATGAAGT-1	CM
AGCCTGGGTGCTTTGA-1	Endo
CTTTGCGAGAGGTACC-1	CM
TACGGATAGCCGCAAA-1	Fib
AGCCGCAGTTTCGACA-1	Fib
GGTGTCGAGTCGTACT-1	Fib
ATGTCTTCATGTGAGG-1	Fib
GAGGCTCGTAGACACG-1	Fib
CCCTGATCATTTAGGC-1	CM
AATGGCTAGGATTGCG-1	Fib
GTCACTCTCCAAGAGG-1	Fib
CACTAAGTCAGGCCGT-1	CM
GTTATGGAGAGGTCCA-1	CM
TTTGAGGTCGCAGATT-1	Lymphoid
TGTTAGGGTACGCCCA-1	Fib
CCTCCCTGTTCAGTAC-1	vSMCs
CCCTGATGTCTGAGCC-1	CM
GAAGAGCTCCTAGAGT-1	Endo
AAGGAGCTCTGGACAT-1	Pericyte
TGCCTGTGTCAATACC-1	Fib
CTACAGATCACCCTTG-1	Fib
CACTGAATCGCCTTAC-1	CM
TTGTCTAGTATACGCT-1	CM
ACCTGCTTCCACTAGA-1	Fib
TCACAGATCGTAGCGC-1	Myeloid
TGGCAATTCATTCTTG-1	Fib
GCGTTGGCAATTCTCT-1	CM
GGGAACAGTGTGTGCC-1	CM
ATTACCTGTCTGGTTA-1	Fib
AGCCGCAAGCGTCAAG-1	Fib
TAGACTGCAAAGGTCG-1	Neuronal
TTGCTTACAAGAGCGT-1	Fib
GAAGAGCGTAAGTCTC-1	CM
GAACGTTTCCCAGTAA-1	CM
GCGGTGTTCGCGATGC-1	Fib
AGCTGGCTCTCTATCA-1	Fib
CACTGAATCATGTTCT-1	Fib
TAGCCCTGTCTAACCA-1	Fib
ACTACGATCACTCCCA-1	CM
TACGGATGTGCTTCCT-1	CM
TATCGAGGTCTCTGCT-1	Fib
TGATGCATCGCTCTAC-1	Fib
CGCGCAACATTATGGC-1	Fib
GCTTAAGCAGGTGTCC-1	CM
GGGCCATTCGGTCAGC-1	Fib
GCCCGAAAGCTATCCA-1	CM
GCGATTACATACAACC-1	CM
ACCGCAGGTGTACGCC-1	CM
GGAGTAGCACGCTAAT-1	Endo
AGCCTGGCATGTGGGA-1	CM
CCTTGCATCGCCTTAC-1	Myeloid
CAAGCTATCCACTAGA-1	CM
GCAGCTGTCAAACCCA-1	Pericyte
TAGGTCATCAAGAGGC-1	Fib
GCAGCTGTCAAGAGGC-1	CM
GTGCACGGTTGGCTAT-1	Fib
ACAAGCTGTATGAAGT-1	Fib
CTGTTCGTCTGACTTT-1	Fib
TCACAAGCAGGACCTC-1	Fib
GCAGCCACATCATGTG-1	CM
TAACGGTGTCTGGTCG-1	Fib
TCTCTGGGTTTCTTAC-1	CM
TTGTTGTGTAACTCCA-1	CM
ATGTCTTTCAGGATCT-1	CM
ACTGCAATCGCCGAAC-1	Fib
TTCTAACAGGGAAATG-1	CM
TGTGACAGTATTCGAC-1	Endo
AACGGGAAGTGTGTAA-1	CM
TCGGGACTCGGGAATG-1	CM
CGCTGGAAGAACTCCT-1	Endo
CACCTGTGTCCGAGCT-1	Endo
CCCTAGTGTTGGCTTA-1	Fib
AAAGATGTCTATAGGC-1	Fib
AAGATAGGTACATGGG-1	Fib
GTCTACCAGAAGACTT-1	Fib
CACTAAGCACTGTCAA-1	CM
GGAACCCGTTCTGAGT-1	CM
CGCAGGTTCGGTGATT-1	Fib
TTAGCGAGTAAACCCT-1	Fib
AGCGTGCGTCATCAAC-1	CM
CGTGGCACAGTCAGCC-1	Fib
GCCTACTAGTGTCGCC-1	CM
GTTCAAGCACATGATC-1	CM
GCATTCCGTCTCGGGT-1	Fib
TGTACGAGTACGACCC-1	Fib
CTTGCTGAGGGAGTTC-1	CM
AACAGTCTCACTCCCA-1	CM
TTCGGTCCAGTCCTGG-1	Pericyte
TGTGACATCGCGTGAC-1	CM
CCTTAATAGACCTATC-1	CM
TTTGAGGCACAGATGG-1	Fib
CCCAGAGTCTCTGTTA-1	Fib
GCCCGAATCGCCCTTA-1	Fib
CTGTATTAGGTAAGCC-1	CM
AGCCGCAAGAGCTCCC-1	Fib
GGATAGGTCGCCGAAC-1	Fib
CTTGCCAAGTAGTGTA-1	CM
CTGCGTTGTGGACGAT-1	Endo
AATGCCACAGTTGCAT-1	CM
CCACAGGGTCTGAGCC-1	CM
GCTCCTACAAGTTGCT-1	Myeloid
CCTTGCACATAGAATG-1	Fib
AAACTGCAGGGTTCCC-1	Endo
TACAGCAGTGATGCGA-1	CM
TAGGTGTTCACTACCC-1	Myeloid
TCACTCGCAACGGGTA-1	Endo
AGTCCGGTCAGCCGGT-1	Fib
TTAGCGACATCGGCCA-1	Fib
ACTCGGGGTCTAAAGA-1	Endo
GCGATTAGTTCTTTGT-1	Fib
TAACTTCGTTCTACGA-1	Fib
GTCCATCCACTCCCAT-1	Fib
TTTGTGTCACTTGCGG-1	Fib
AGTGCCGTCGTGAACT-1	vSMCs
GACCGACTCGATGAAA-1	CM
GCATGATGTACGTAGG-1	CM
GTGCTGGTCGTTACAG-1	Fib
GATCGTAAGTATGCTC-1	CM
AGTGTACTCCGGCTGA-1	Pericyte
TGTACAGTCCTATCAT-1	Fib
CCCACATGTAGGTGAC-1	Fib
AAAGGGCTCCACGCTT-1	Myeloid
ACGTGGCGTGTGTGCC-1	Endo
GCGCATGAGTTCGCGC-1	Fib
AGCTGGCGTAACATAG-1	CM
CGATGATGTCTCTGGG-1	CM
CAAGCTAGTAACCATC-1	Fib
TTGGTCCGTACTTGAC-1	Fib
GTGGATTTCGGGAATG-1	CM
TGGTCCTCAACGTCCG-1	CM
GATCGTACAAATTCCG-1	Fib
TGAGTCAAGACAGTGC-1	CM
AACTGGTGTGAATGTA-1	Fib
ACTACCCTCGAAGCCC-1	Pericyte
TTCAACTGTCGATAGG-1	Lymphoid
TTCGGTCGTCCGTCGA-1	Pericyte
CTCCCAAAGAACGACC-1	Myeloid
AGCGATTTCGCATACA-1	Endo
GCGATTATCAAGGCAG-1	Fib
AACGTACTCTGGGCGT-1	Myeloid
CATTCATAGTGAGTGC-1	Myeloid
AACCGATCATCCATAG-1	Fib
TCGTTCGCATCGAGTT-1	Pericyte
GTCCATCGTAGACACG-1	vSMCs
TCAGTTTAGACAACGC-1	vSMCs
GATGATCGTTGCTTGA-1	Fib
CTACAGATCCGCCTAT-1	Endo
TTCGGTCAGGTCTTTG-1	CM
CCAATGAGTTTGCATG-1	Fib
TACCTCGCATCTCTCG-1	Fib
CATTGGAAGATCGAGC-1	Myeloid
ATCCAGAAGTCTCGAT-1	Fib
GTTACTTCACGCTCAG-1	CM
TTGCTTAAGTTGAATG-1	Fib
CAAGGCCTCACGTCAA-1	Myeloid
ACAAACCTCCGTGCGA-1	Fib
GCGATCGTCGCTCTAC-1	CM
TGTGACAAGCAGGAGG-1	Fib
TAATTCCCAAGGATGC-1	CM
AATGTCGTCTCTATCA-1	Fib
CACAACACAGACCTGC-1	CM
ATGTCTTTCTGTGTCC-1	Endo
TCAGTCCGTAGCTGTT-1	Pericyte
GGTGAAGAGTACTCTG-1	Myeloid
TGCTATTGTATGTTCG-1	Fib
GAAACAAGTGTGCTTA-1	CM
CGCACAGCAAGGACCA-1	Endo
CAACGGCTCTTCCAGC-1	Myeloid
CGATGATGTTACGAAA-1	Fib
ACCGAATTCCAACCTC-1	Fib
GAAACAACAGTATCTG-1	Myeloid
GGTGCTGCAAATGCTC-1	Fib
GCTGTTCCAGAAGTGC-1	vSMCs
ACTGCAAAGAGGCCTA-1	CM
GGTGTCGTCTCAGATG-1	Pericyte
AAGGTTCTCCATGACA-1	CM
GTTGGGCAGGAGTCTG-1	Fib
ACAATCGGTATCCCTC-1	Myeloid
GGCATTAAGTTCTCCC-1	Pericyte
CAACGTAAGAGAGTTT-1	Fib
CACCTTGCATTGTTCT-1	Endo
TGTGTCCGTTTGACCA-1	Fib
TTGCAGAGTAACATAG-1	CM
GTGTGATGTAAAGGCC-1	CM
TTGCTATAGCCATTCA-1	Endo
GAAGAGCGTCCGGTAC-1	CM
GTGTCAACACGCGTTG-1	Endo
ACTAACGTCGGTCCGA-1	Myeloid
CTGGCAGCATGGCCTG-1	Lymphoid
CTAGGGCCAGGGCTTC-1	Lymphoid
TAGCTTTAGGATTTGA-1	Fib
CTCTCAGAGTCAACTC-1	Endo
CTCTCAGAGGTACATA-1	Pericyte
CCAGATAAGTATGCTC-1	Fib
TAGCCGGAGCGGACTA-1	Myeloid
TACCCTGGTTACCACA-1	Endo
CAGTGTAGTTCCAGTA-1	Fib
TGTACAGTCTATCTAC-1	Endo
CACGTTCTCGTTGTTT-1	Fib
CAGCCTTCATGATCGT-1	Myeloid
CACCACTAGATTACGA-1	Fib
ACAATCGTCTAGCTGA-1	Myeloid
TCTCTGGGTTTGTACG-1	Myeloid
AAGATAGAGGTGATGC-1	Myeloid
TGAGTCAAGAAGCCGT-1	Myeloid
CGCTATCTCAGCCGGT-1	Endo
ACAGACTTCCCAGCGA-1	Fib
CAGCCTTGTGGCCTTG-1	Myeloid
GCTCACTGTGCACCCA-1	Endo
TGCACCTGTCCGGTAC-1	Endo
ATCGAGTTCGTCCCTA-1	Neuronal
ATGTCTTCAAATTGAG-1	Pericyte
GCGATTAAGGGCTTCC-1	Myeloid
CAACCAATCTGGTACA-1	Pericyte
GAACTTGAGCGCCTAC-1	Endo
TGTGTCCAGTACAGAT-1	Myeloid
AACTTGGTCTATTTCG-1	CM
GTTACGAGTCTGCGCA-1	Myeloid
TACTGCCAGACTAATG-1	Endo
GCCTACTAGATAGGTT-1	Myeloid
ACATGGTGTAGAAAGG-1	Endo
ACCCAAACAGTGGTCC-1	Endo
GATTGACTCGTTGTTT-1	CM
GTTGGTAGTGTGTGTT-1	Pericyte
TACTAGGTCGCACCGA-1	CM
GAAATGAAGCCTCGCA-1	Lymphoid
CTGGCAGCAAGCCCTG-1	Myeloid
ATTGTGGAGACACAAT-1	Endo
TTGTTCACAAAGGCCA-1	Myeloid
TCAGTTTTCAATGCAC-1	Neuronal
GAACTTGAGTTGCGCC-1	vSMCs
TACAGCAAGTCAACTC-1	Fib
GCGCATGGTCTGTTGA-1	Myeloid
ACTAGGTGTATCTGCA-1	vSMCs
GAGACTTCATCTCACC-1	Endo
TCAGTTTTCGCTATAG-1	Fib
GGTTGCGGTAACGGTG-1	Endo
CACGTTCGTGCAAAGC-1	Myeloid
AGCTGATAGAAGACTT-1	Myeloid
TAATTCCCAGCAACCC-1	Myeloid
GAGCGCTGTAGTAACA-1	Myeloid
GATCATGGTTGTGAGG-1	Myeloid
CTAGCGGAGTGGTGTG-1	CM
AGCCTGGAGGCTTTAC-1	Fib
AAAGGATAGCCTTTGA-1	vSMCs
ACATGGTTCGTCTTAT-1	CM
AACCTGAAGTAGTCGG-1	Endo
GGGCCATCATTACTCT-1	Pericyte
TTTGTGTTCTCGGCGA-1	CM
GACCGACCATAGACGG-1	Endo
AACGTACAGGGTTCTT-1	Fib
ACTGCAACACTTTGGA-1	CM
GCAAAGGAGGTGATGC-1	Endo
ATGTACGGTATGAAGT-1	Endo
TCCGACTTCTCCCTTT-1	Myeloid
AAAGGATGTTACGAAA-1	CM
GTGTCCTTCCGGAAAG-1	Myeloid
TACATTCCAGGTCTGC-1	Myeloid
TCCCACATCACGATTG-1	Myeloid
TCAAGGTGTGTGAGGT-1	Myeloid
CAGCTAATCAGTGTAC-1	Myeloid
GATCATGGTGATAGAT-1	Endo
CGCTGGAGTAGTAACA-1	Myeloid
TGACAACAGCGGACTA-1	Pericyte
TTCAACTTCGTGGTAT-1	Myeloid
CGTTCCACACGCTGTG-1	Pericyte
AGCCTCTAGATGGGAA-1	Fib
TATGTGGAGCGATACG-1	Pericyte
AACATCGGTAGCAGCA-1	Myeloid
GTTACTTCAGGTAACG-1	Myeloid
CTCACCAAGTATGCTC-1	Myeloid
TCGATTTAGACAGTGC-1	Fib
TGCACCTCAAGACTAA-1	Fib
TTGAGCATCCAGCACG-1	Pericyte
CGGTGCAAGGTTGTGG-1	Fib
TAGACTGAGCGCAATG-1	Myeloid
CAAAGCTAGAGAAGCA-1	Myeloid
GCAGCCAAGAGAATTC-1	Myeloid
TCTCTGGAGTCGTGAG-1	Myeloid
CAGTATGAGCGTCTGC-1	Myeloid
TGGCCTTCAATCACTG-1	Myeloid
AACGAGGGTGCATCAT-1	Myeloid
GCTCAGGTCACGGGTC-1	CM
CGCGCAACAAACCTAC-1	Fib
AGCGATTGTAATGTGA-1	CM
CGATGATTCTGAGTCA-1	Myeloid
CTCACCAGTCACATTG-1	Myeloid
TGTAAGCCAAGGCGTA-1	CM
TTTACGTTCACGGGTC-1	CM
CGCTATCCACGCGATC-1	Pericyte
TTCTGTACATCCGTGG-1	CM
TCACCACCAGATTAAG-1	Myeloid
CTCTCGACAGTCCTGG-1	Myeloid
GTAGGAGTCTCATCCG-1	Lymphoid
CTGCGTTGTGGACTGA-1	Myeloid
AGTTTGGTCATGAACC-1	Myeloid
TGCCTGTGTCGAGGAT-1	Myeloid
GGAGGATTCCGTTAGA-1	Fib
AGGCCTGGTCAATCCA-1	Myeloid
CTTTGCGTCAAGAGGC-1	Myeloid
CACAGATCACATAAAG-1	Fib
ACTCGGGAGCTGATTC-1	Myeloid
CGGACTGCACCTGTGG-1	Pericyte
ACTATTCGTACATGGG-1	Pericyte
ACTAGGTGTATCACAC-1	Lymphoid
AAGGAGCAGAAATTCG-1	Fib
TTATGTCGTGATAACA-1	Myeloid
CGAGTTATCGCATAAC-1	Myeloid
GAGCGCTTCTCTTCTC-1	Myeloid
GGCACGTCAACTCAAC-1	Myeloid
TTTGGCCGTGCTAGTT-1	Myeloid
AGTGCCGGTCAAACAA-1	Myeloid
GCGCCAACATGTAGAA-1	CM
AAAGGGCGTCAACAGG-1	CM
TAGGAGGAGTTGAATG-1	Endo
TCAAAGCCAACGCAAG-1	Myeloid
TAAACCGCAATTGCCA-1	CM
GCGCATGGTCAAATCC-1	Myeloid
TTGTTGTGTAACCATC-1	Myeloid
ACTAACGCATAGTCCA-1	CM
CCCTGATGTGCATTCA-1	Myeloid
TGTAGCAGTATTCTTC-1	CM
TTCGATTCATGTCCCT-1	Fib
TCTATTGTCACAACAC-1	Myeloid
TACTCGCCAACTCCCT-1	Fib
ATCCCTGTCGACTCGG-1	Fib
GTTATGGGTTTAAGCC-1	Myeloid
CCAGATACATTGTGAC-1	Myeloid
AGCCAGCGTGTCGGTC-1	Fib
GTCACAAAGTTCTCCC-1	Fib
GCGAGTCGTATGGTTC-1	Lymphoid
TGATGCAGTGAGAGTC-1	CM
ACTAGGTTCCAGTACA-1	Pericyte
GCAGATTCAATGGCTT-1	CM
GAGATTCTCTATTGTC-1	CM
ACTGCGGCACTGTTAG-1	Pericyte
ACAAAGACATCGCTAA-1	Myeloid
AAATGAGGTCCTCAGG-1	Lymphoid
GGAGGATAGATCTCAC-1	Myeloid
TAACGGTGTCACAGGA-1	Myeloid
GCGAGAATCTCCACTG-1	Myeloid
TTAGCGACATGTGGGA-1	Pericyte
TACAGCAAGGTCACTT-1	Fib
GTGCTGGCACTACACA-1	CM
ATTCGTTAGTAGTTCC-1	Lymphoid
AAACTGCCAGTTAAAG-1	Myeloid
TATCTGTTCCTAAAGC-1	Myeloid
TAAACCGTCCATCGAA-1	CM
CTCAGAAGTGGTACTT-1	Myeloid
TAGCACAAGCCTGGTC-1	CM
CTCAGAAAGATTACGA-1	Myeloid
AGTGCGCTCACATTCT-1	Myeloid
CGCTATCAGTGTCACT-1	Myeloid
TCTCTGGGTCCGAGCT-1	Lymphoid
TCGATTTAGGAGGCGA-1	Endo
AGCCGCATCTATTGTC-1	Endo
TTTGAGGGTCTCGGGT-1	Myeloid
CGCGCAATCTTACCTA-1	CM
CCAGATACAATGCCAT-1	CM
ATGCATGCAAGGGAGG-1	Endo
TATTGCTCATGATTGC-1	Endo
AGCCTCTAGAGAGTTT-1	Fib
TCGCCTAGTGAATGGC-1	Myeloid
AGCCGCACACAGGAAC-1	Endo
GAGGCTCGTCAGTGTT-1	Fib
GCGCCAACACTCGGAC-1	CM
AGCCCGAGTCCGTAGC-1	CM
TCGCAGGAGAGGTGGG-1	CM
GGACACCTCTGACATG-1	Myeloid
AGTTTGGTCGCTATAG-1	Fib
TGAGCCGAGCGAGAAA-1	Fib
GCATTCCGTAACATAG-1	Myeloid
CCAATGATCGATGCAT-1	Myeloid
GAGAACGGTGTCTCGG-1	CM
CACATGACAAGGCTTT-1	CM
TACCTCGTCCTCCTGA-1	Endo
TAGCCCTTCTTACTCA-1	Myeloid
CAAGAAATCATCATGG-1	Lymphoid
GATCATGAGAGGCGGA-1	Endo
TGGAAGGTCGGGAATG-1	Endo
CCACGTTTCCTCCATG-1	Endo
CGTACAATCCCATAGA-1	CM
CAGCTGGGTAAACCCT-1	CM
GAGACTTAGAAGACTT-1	Fib
AGTGCCGAGCGAGCTA-1	Pericyte
AAAGGGCGTACGCAAG-1	CM
AGTTTGGTCAATGCAC-1	Neuronal
GTGCTGGGTATGGGTG-1	Fib
TGCACCTCAACTCAAC-1	Myeloid
GAGGTCCTCACCACAA-1	Myeloid
TTACCCGGTCGAGGAT-1	Fib
TAGCACATCCGCTATC-1	Myeloid
TCGCCTAAGTTCCCGG-1	Endo
GTCCATCTCAGGCCGT-1	CM
GATTGACAGTCAGGAC-1	Endo
GCTGCGACAGATTAAG-1	vSMCs
CATAACGAGCCTTTGA-1	Pericyte
GCAGCTGTCGGAAAGC-1	CM
CGCGCAACAACTTGGT-1	Fib
GTTCAAGGTCCGTAGC-1	CM
TGATCAGTCCCATAGA-1	CM
GTCTACCGTAAACGTA-1	Pericyte
TCGCAGGAGGGCTTCC-1	CM
GAGTGAGCATACCCGG-1	CM
TGTACGAGTCGATAGG-1	Fib
AAAGGATAGTATGCTC-1	Endo
GCAGCTGTCCCGTATC-1	Fib
ATTACTCAGAACGACC-1	CM
CGCTATCCAATTGCCA-1	CM
GTCACCTAGCCTTTGA-1	Pericyte
GCCCGAACATGATCGT-1	Myeloid
CCGAAGCCAGCGTCGT-1	Pericyte
CCCTAACTCACACGTA-1	CM
GTGGATTTCCGGCTGA-1	Myeloid
GCGGAAACATTTCTTG-1	Pericyte
TGATCAGTCACTCCCA-1	CM
GACCGACTCACGGGTC-1	CM
TAACGGTTCAGGCCGT-1	CM
AACCTGAAGAAGACTT-1	Fib
TACCTCGTCACTCCCA-1	CM
TCCAGAAAGAGAGTTT-1	Fib
GGCATTAGTGTGCGTC-1	CM
GAAACAATCAGCCGAC-1	Endo
CGTACAATCTTTCGAT-1	Pericyte
AGCTGGCCAACTCCCT-1	Pericyte
GCTCCTATCGCGTTCT-1	CM
ACCGCAGTCACCCTTG-1	Pericyte
CCCAGAGGTGCATCAT-1	Pericyte
GTCCATCGTCAGTGTT-1	Pericyte
ACTCGGGTCGCGTGAC-1	CM
GAGACTTTCTGTCGTC-1	Myeloid
TACCTCGTCGCCACTT-1	CM
CTCACCATCGCGTTCT-1	CM
CAACCAATCAGGCCGT-1	CM
CGCGCAACACTCCTCA-1	Fib
TAGGTCAAGAGAGTTT-1	Pericyte
GTTATGGGTAGTCCAT-1	CM
CCTTGGTAGATATGAC-1	Pericyte
CACAACACACTCGGAC-1	CM
ACCTGCTAGAGAATTC-1	Myeloid
CCCTAACTCTATCTAC-1	Fib
GAACTTGCATACCCGG-1	CM
CAGCCTTGTCGCTAGC-1	Myeloid
CTCACCATCCTGGAAT-1	Endo
