Barcode	cell_type
GCATTCCTCCTTGACC-1	CM
ACTCGGGGTACGGAGT-1	CM
ATTGTCTTCGTGGTAT-1	CM
TTATGTCTCTCTTAAC-1	CM
TACCTATAGGCCTCTG-1	CM
AGCCTGGGTCACAGGA-1	CM
AATGTCGAGCTCCGGT-1	CM
TGAATCGCAGTCAGCC-1	CM
GTGCCAGGTAGTACAA-1	CM
ACCGAATTCGATAGCT-1	CM
AACGGGAGTCAATACC-1	CM
TGCTCGTAGACACGGT-1	CM
GGTGTCGTCCCAGCAG-1	CM
TTTGTGTGTATGTTCG-1	CM
GGATGAGTCACATTCT-1	CM
TGCATGATCGTGCTGG-1	CM
GTTACGATCGGAAAGC-1	CM
CTACAGAAGCTAGCAG-1	CM
TACGCCTCAATTCGTG-1	CM
ATTCGTTAGCTACGTT-1	CM
GGAATCTAGCGTCAAG-1	CM
AGCTGATTCCTGAAAC-1	CM
TGGAAGGGTAGCGAGT-1	CM
CCGTACTGTCCGCTTT-1	CM
AAGATAGCATCCCGGA-1	CM
TAATTCCTCGGCATAT-1	CM
ATCCTCGCATGCGTTA-1	CM
ACCGGGTGTGATTCCA-1	CM
TATGTGGCATTAAGGA-1	CM
ACTATTCAGATCCGAG-1	CM
CTTGCCATCCATGTTT-1	CM
CGCTAGGAGTTCGTTG-1	CM
TTCTGTATCTTGCGCT-1	CM
GCATTCCAGACGACTG-1	CM
CAACGGCGTACTTCGA-1	CM
AATGGCTAGTGGACGT-1	CM
AGTTACGGTATGTCCA-1	CM
CGGTGCATCTGACTTT-1	CM
CTCGCTAAGATCTCAC-1	CM
AACATCGAGTTCCCGG-1	CM
GTCTACCAGTCCAGAG-1	CM
CTGCGTTGTGGACGAT-1	CM
ACTGCAAGTGCTTGAT-1	CM
TAAGCCACACTGGGCT-1	CM
CTGCTCACATCCGTGG-1	CM
AGGCGAATCCGAATTG-1	CM
GAGGATGGTTTGATCG-1	CM
GAACCGCGTATCAGCT-1	CM
TACCTCGAGCTTTCCC-1	CM
CTCTAGCAGCAGGACT-1	CM
TTACTTGAGTCGACCC-1	CM
CATTCATCAAAGGTCG-1	CM
GTGGCGTTCGCGCTGA-1	CM
GTTATTCCAACTCGTA-1	CM
TCAAAGCTCCGGAAAG-1	Endo
TAAGTGCTCGGTACTA-1	CM
GCGAGTCGTCACCCGA-1	CM
AATGGCTAGTGAGCTG-1	CM
ACCCAAACATGATCGT-1	CM
GCACGCAAGCTAACAA-1	CM
TATCTGTTCTCGCGTT-1	CM
CTCCCAAAGGGTCCCT-1	CM
TGCTTCGCAACGAGGT-1	CM
CCTTAATGTATGAAGT-1	CM
GTAGACTCAAGCAATA-1	CM
GATCATGTCTGGCCAG-1	CM
CAACGTATCCGCGATG-1	CM
AATGGAACACACATGT-1	CM
AGACAAAAGAACTAAC-1	CM
TAGCTTTCAGCACATT-1	CM
CCCTAGTCAGCACATT-1	CM
GTGCACGGTCCACCAG-1	CM
TTGCCCAAGACCATAA-1	CM
GTCACCTCATGGTATC-1	CM
GAAATGAAGGATTGCG-1	CM
CCTTGCATCGTAGCGC-1	CM
AGGCGAAGTCACAGTT-1	CM
AGCCCGATCCACGCTT-1	CM
CAATCCCTCGTATAGC-1	CM
TACGGATTCTGTAGAC-1	CM
GAGAACGCATACTGCA-1	CM
TGGGTGCCATCCCGGA-1	CM
AACAGTCGTGATAAGT-1	CM
GCTCAGGCATCCGTGG-1	CM
CTCAACCCACTCGGAC-1	CM
CAGTGTATCCGAATTG-1	CM
TTCGTTATCTGGCACG-1	CM
GGTGAAGGTGCAACAG-1	CM
AACTGGTTCCTATCCG-1	Fib
CCGTAGGCATGGCCTG-1	CM
TAGCGGCCAGGTAGGT-1	CM
AGTCCGGCACTGTTAG-1	CM
GGGAACACAAAGGTCG-1	CM
CTTGCTGCATGCGTTA-1	CM
AAGATAGAGTATAGTG-1	CM
GGTTGCGGTATTCTGG-1	CM
TTATGTCCAAGGGAGG-1	CM
TTCTAACTCGTGCTGG-1	CM
CAACGGCCACGGCCAT-1	CM
ACCCAAATCGTCTAGA-1	CM
TTTGTGTCAATTGGCT-1	CM
CCCAGAGTCGTCCCAT-1	CM
GGAACCCAGGTTCTCA-1	CM
TTGTCTAAGTGAAACT-1	CM
CTCATGCTCCGTTAGA-1	CM
GTTGGGCCAAAGCATA-1	CM
CAGTGTAAGCTGAGGT-1	CM
AAGATAGTCTGGGCGT-1	CM
TTTGGTTAGAGACTCG-1	CM
AACCAACAGCAGGACT-1	CM
AACGGGAGTTTAGGAA-1	CM
AATGTCGAGACGCCAA-1	CM
CTCGCTAAGAAAGCAG-1	CM
TCGGGACTCAGAACGG-1	CM
GACCAATGTTTAGGAA-1	CM
TTACCCGCAATGTAAG-1	CM
TGTACAGTCTTAATCC-1	CM
GTAATCGAGGCGTAGT-1	CM
GGAGGATTCCCTATTA-1	CM
TTTGGTTTCGTATAGC-1	CM
TGCTATTGTTTAAGGA-1	CM
AACTTGGGTTTAAGGA-1	CM
CCTAAAGAGCTCGGCT-1	CM
TAGGTCATCAGTCAAC-1	CM
CTACTTATCACCCGGA-1	CM
CAGTGTAGTCAGAGTG-1	CM
TAGCGGCCAGCTTACA-1	CM
CCGAAGCTCTTCCAGC-1	CM
AAACTGCCAGGTAGGT-1	CM
TCACAAGTCTTACCTA-1	CM
ACTACCCCACTAAACC-1	CM
TTGAGCAGTGCTGTCG-1	CM
CCGTACTCAAGGTCGA-1	Pericyte
ATTACCTCATCCTCGT-1	CM
GTTACGACAACTCCCT-1	CM
TAAGCCATCATACTTC-1	CM
GAAGTCTTCCGGAAAG-1	CM
TTTGTGTGTCACAGGA-1	CM
AGCTGTACACTTACAG-1	CM
CAAGCTACAAGTGGCA-1	CM
CGGACTGAGCAGAGCT-1	CM
TCTAGTTAGCGTTAGG-1	CM
GAACGTTTCGCCTTAC-1	CM
TTCGGTCGTCCGTGCA-1	CM
TACGCCTCAACTCAAC-1	CM
GCCCGAAAGTCTGGGA-1	CM
GAGGTCCCAAGTCTGT-1	CM
TTAGCGAGTTTGAAGA-1	CM
GTAGGAGAGCTTCAAC-1	CM
CTCAGCTAGTCTGTGT-1	CM
CACAACATCTCTCAAT-1	Fib
CTCACCAAGCATGATA-1	CM
GAAGTGGAGAACGTTA-1	vSMCs
TCGGGACAGCCTCGCA-1	CM
CACAGATTCCTCATTA-1	CM
GGAGTAGAGCAACTGG-1	CM
AGCGTATTCATGTTCT-1	CM
TTGCTTACACATTCTT-1	CM
TTTGTGTAGTGGGACT-1	CM
TAGGTGTAGCTAGCAG-1	CM
AGTTTGGAGACACTTC-1	CM
CTTGAAGTCCTCCTGA-1	CM
TTTGCGCGTCTCTGGG-1	CM
CTAGGATCAAGTCCTA-1	Fib
CCGCATTAGACACTTC-1	CM
ACTACGATCCATAGGT-1	CM
CCTATTACAATGGTAA-1	CM
ACCGGGTGTCACAGGA-1	CM
AATGGAACAAACAGTA-1	CM
ATAGTCGTCCACTAGA-1	CM
AACAAAGGTACTTGAC-1	CM
CCTGGGATCTGGCTAA-1	CM
AGCTATGAGTGTCGGA-1	Fib
AGCCTCTTCATGAACC-1	Fib
CTTGCCACAGCAGGTA-1	CM
TCAAGGTTCCAGGTCG-1	CM
CTAGGGCCATATACGC-1	CM
TAGCCGGAGGCCTCTG-1	CM
GCGGAAATCTGTGTGA-1	CM
ACATGCAGTAGACGCA-1	Endo
CTTAATCTCCGTTTCG-1	CM
TTACCCGAGTTGGAAT-1	CM
GGCGTTGGTTCCCGGA-1	CM
GTGCACGGTAGTGATA-1	CM
AGCGATTTCGCAAACT-1	CM
TACGCAAAGTAGTTCC-1	CM
ATCGAGTTCTCTTCCT-1	CM
AACAGTCCAATGATGA-1	CM
AGCTGGCCATTAGCCA-1	CM
GCCCGAAGTCCCGTGA-1	CM
GCGATTAGTCTGTCCT-1	CM
TTGAGCATCCGTACGG-1	CM
CGGTGCACATAGACGG-1	CM
GCGGTGTTCGACCCGA-1	CM
TTTGCGCAGTTACACC-1	CM
GAGACTTAGAATCAGT-1	CM
TGTACAGAGTACAGTA-1	CM
GAATCTGTCAAGGCCC-1	CM
AATACGCGTCAAACAA-1	CM
ACAATCGCATGGGACA-1	CM
GAGCATTTCGGATAGG-1	CM
GGGTGTCTCACTAGCA-1	CM
CCTCCCTAGAGCTGTG-1	CM
GTCACTCCAACTCGTA-1	CM
CCACGTTCAACTAGAA-1	CM
AGCCTGGTCTGGTACA-1	CM
CTCATGCGTGTTGTTG-1	CM
TGCTCGTAGGCGTAGT-1	CM
ACGTTAGAGGTGTTGG-1	CM
CAGCCTTCAAGCAATA-1	CM
GGGTTATCATTGTTCT-1	CM
GAGCATTCAGATGGCA-1	CM
AGGCCCATCACAAGCT-1	CM
CTCACCAGTACAAATG-1	CM
GCCAGCAGTGACAAGC-1	CM
TCGCCTAAGCGCATTT-1	CM
AGCTGTAAGACTCTTG-1	CM
TTATGTCTCTCCAACC-1	CM
TAACTTCGTCACATTG-1	CM
AGCTATGGTACGGAGT-1	CM
GCTTTCGTCCGGAAAG-1	CM
AGATAGATCCTGGAAT-1	CM
CCGTAGGGTTGGCGAA-1	CM
TTGACGAAGTTACACC-1	CM
GGAACCCCAGGTAGCA-1	CM
CAGCTGGCATGGAGGT-1	CM
GCTTGCTAGTGAACCG-1	CM
GATTGACCATGTGAGG-1	CM
TGCTCGTAGGACTAGC-1	CM
TTGCCCATCAAGGCAG-1	CM
CGCAGGTGTCGCTACG-1	CM
TGATGCATCGTTCTAT-1	CM
AGCCCGAGTAACGGAC-1	CM
GATCGTACAGCGTGAA-1	CM
AAGGAGCTCCAGGGAA-1	CM
TAGACTGTCGTGAGTT-1	CM
TACGCAAAGATCGATA-1	CM
TAAACCGTCCCTACCA-1	CM
ACCCAAAGTAGAACGC-1	CM
TGAATCGAGAGCGAAA-1	CM
ATTACCTAGCGATACG-1	CM
TACGGATGTCCAAGAG-1	CM
TAGACTGGTGATGCGA-1	CM
CGCTATCGTCTGCGCA-1	CM
CACGTTCGTCAACAGG-1	CM
GATTGACGTCACAGGA-1	CM
CTAGGATCATAGCCAT-1	CM
TTGTTGTGTATACGCT-1	CM
GTTACGACATTCTTTG-1	CM
AGCGTATCAGTGCTCG-1	CM
TTACCCGCAGGGTAAC-1	CM
CTCCCAACACGCGACT-1	CM
AGATAGAAGCTAACAA-1	CM
CCCTAACGTCCGTCGA-1	CM
GTCTACCGTGAGTCGA-1	CM
GCTGAGCGTACGGTTT-1	CM
CATTCATCATCCTCGT-1	CM
AGCCTTCAGTCCGGAA-1	CM
CATAACGTCTGGTACA-1	CM
CATGCCTTCCGTGCAG-1	CM
GTCACCTTCCCGAAGC-1	CM
TTGGTCCAGATACCAA-1	CM
GAAAGTAGTACGTAAA-1	CM
AACAGTCGTTCCTATT-1	CM
CGCTAGGAGTGAAACT-1	CM
TGATTTCGTTCTACCC-1	Endo
GTGTCAATCAGGTCTA-1	CM
CGCGCAACACTAAACC-1	CM
ACATGCAGTCCTTCAC-1	CM
GAGGTCCTCTCCACTG-1	CM
TCTCTGGCAGCGTCGT-1	CM
AACGTACCACTTATGG-1	CM
GATCATGGTAGCATGG-1	CM
CGTGGCACACAACGGA-1	CM
GTGCCAGAGGGACGTT-1	CM
TAAGCCATCTGAGTAC-1	CM
ATGTCTTTCAGAATGA-1	CM
ATTGTGGTCGCTAGTA-1	Myeloid
CTACAGAGTGGTCGAA-1	CM
ATCCCTGGTTTGATCG-1	CM
TGATCAGAGTTATGAG-1	CM
CCAATGATCGAAGCCC-1	CM
GCTCCTACATTTGTTC-1	CM
TGCTCACAGGCAGTAC-1	CM
GGCACGTAGTGAAACT-1	CM
GCCCGAAGTCAGGTGA-1	CM
GGATAGGGTTCCCAAA-1	Fib
ATGTCGAGTCACCCGA-1	CM
AATGGAACACCGAATT-1	CM
CTTGAAGAGAACGACC-1	CM
AATGTCGCAACTAGAA-1	CM
CTCAGAAAGAGGTGGG-1	CM
TACCTATCAACGCAAG-1	CM
GTTGGTACAGGGTAAC-1	CM
CCGTAGGCAATAGCGG-1	CM
GCAACCGAGGGTGTTG-1	CM
ACGTGGCGTGAGGGTT-1	CM
AGTCCGGGTCCTATTT-1	CM
AGACAAACAGCTGATT-1	Fib
GCAGATTAGACAGCTG-1	CM
GGACACCCAAATGTCC-1	CM
AACTTGGCAATTAGGA-1	CM
ACTTCCGAGAACCCGA-1	CM
GATCGTAGTTAGGCTT-1	CM
TGATCAGTCGGGAATG-1	CM
GTCTACCTCACTCGGG-1	CM
GACTAACAGTTCGCGC-1	Endo
GTTATGGCAATGCACT-1	CM
ACTATTCTCCGTGCAG-1	CM
AGCTGTACACGCTAAT-1	CM
TTACGGACATCGAGTT-1	CM
AGTGCGCAGCATTGGG-1	Endo
GGAGGATCAGCTTACA-1	CM
ATTGTGGTCTGTGTCC-1	Fib
GGTCATAAGTCGATAA-1	CM
TTGAGCATCTTGTCGC-1	CM
TTCATCAGTCCTTCAC-1	Pericyte
ACAGGCCCATTGTTCT-1	CM
GAGATTCCAGTATACC-1	CM
AGGCCCACAATGGCTT-1	CM
GCGATTACATTACTCT-1	CM
GTGATCAAGTAGACCG-1	Fib
CAAAGCTAGTGTCCCG-1	CM
GAATCTGGTAACTCCA-1	CM
AGCGTGCAGTAGGAAG-1	CM
TAACAGCTCGGCTATA-1	CM
ACTATTCTCATCGCAA-1	CM
CAGTGTATCCATGTTT-1	CM
ACTGCAAGTACGAGAC-1	CM
TGTTAGGCACTGTAAC-1	CM
TACATGGCAGTAACGG-1	CM
TAGGTCAGTCTGGTTA-1	CM
CTGTTCGGTTGCCTGG-1	CM
AGACAAACAATTCTCT-1	CM
ACTGCGGGTTACCCAA-1	CM
TGCATTTGTGAGTAAT-1	CM
GTGGATTGTTATCGAC-1	CM
AGCCGCAAGAGGCCTA-1	CM
ACGGATTAGGGAGTTC-1	CM
GAACTTGCAGTCAGAG-1	CM
ACCATCCGTTCTGAGT-1	CM
CCCACATCAAAGGCCA-1	Endo
AAAGATGGTCGAGGAT-1	CM
GGACACCTCAGGGTTT-1	CM
CCTAAAGTCTTAAGCG-1	CM
TATCGAGAGGATTGAT-1	Fib
GAGGATGAGATCTAAG-1	CM
TGCTCACAGCAGTAGC-1	CM
CGCACAGTCGATGTGT-1	CM
GCCTAGGGTACAACGG-1	CM
GCAGATTTCTTATCAC-1	CM
TACCTCGCATTGCGAT-1	CM
GGACACCTCGGGTCCA-1	CM
TCGCCTACACGTTACA-1	CM
CGGACCATCCAAGAGG-1	CM
CAGGGCTCAAAGGTCG-1	CM
GGTGAAGTCAGGTTTG-1	CM
TCAGTCCAGAGCCTGA-1	CM
CTGGGACAGACTAGCG-1	CM
AACTTGGGTGAATGTA-1	CM
AACGGGAGTCACAGGA-1	CM
GTACTTTTCAGGAATA-1	CM
GCCTACTCATCATAGC-1	Endo
CTGTATTAGAGAACCC-1	CM
GCAAAGGAGTCAACTC-1	CM
CGGTGCATCGAGGCTC-1	CM
TGGACATTCCCTAAAG-1	CM
TGGTCCTCAACGGACA-1	Myeloid
TTGAGCATCGGTTAGT-1	CM
TAGCGGCGTTCATTTC-1	CM
TGTACAGGTCTAAAGA-1	Endo
GCTTGCTTCCATAACG-1	CM
GATGATCGTGGTTCTA-1	CM
GTGCCAGCACTGTCAA-1	CM
GTGGCGTGTAACGTAA-1	CM
CCGCATTCAGGCACAA-1	CM
AAGGTTCTCCTTTGAT-1	CM
AGACAAAGTATCTCAG-1	CM
CCACAGGCATCGAGTT-1	CM
TTACGTTAGAAAGCAG-1	CM
TAATCGGGTGCCAAGA-1	CM
TCGTTCGTCGCCACTT-1	CM
GAGTGAGTCTTCTTCC-1	CM
TGCATGACATAGATAG-1	CM
AAACGAACAGTTGGAG-1	Fib
GCGGTGTTCTTGTCGC-1	CM
AGTTACGGTCTCAAAC-1	CM
AGCGTGCCAGCAACAG-1	CM
ACAAACCGTAAGCCGA-1	CM
AACTGTGAGGCGCTTC-1	CM
GTCTACCGTTTCGACA-1	CM
AGCCAGCAGAAGCCGT-1	CM
GGGTGTCTCGTGCTGG-1	CM
TTTGTGTTCGCTAGTA-1	CM
ACTAACGCAGGTTATC-1	CM
CAAGCTAAGGACTAGC-1	CM
CCATACCAGTTACCAC-1	CM
GCTCACTTCACTAGCA-1	CM
GACTAGTGTTTCACCC-1	CM
CCTTGCAAGATATGTG-1	CM
AGGCGTCGTCTTAGCA-1	CM
CAACGGCCAGGTCTGC-1	CM
TGACTCCTCCCACGGA-1	CM
GAAACAACAAGCCAGA-1	CM
TGTTAGGAGGATGTCG-1	CM
AACGGGACAAGGGAGG-1	CM
TCAGCTCAGTACAACA-1	CM
TGCTTCGGTAGCAGGT-1	CM
TGATCAGAGTCAACTC-1	CM
ATTGTCTTCTATAGGC-1	CM
TGCACCTCACAGGAAC-1	CM
CCCTGATCAGTTAAAG-1	CM
GTGCTGGCAAGCAGGT-1	CM
TTTGGCCTCTGGAAGG-1	CM
TTGTTCATCGGGAATG-1	CM
ATATTCCAGCGTGTTT-1	CM
TGCATGAGTGATAGAT-1	CM
CCCTGATTCACAACAC-1	CM
TTGTTCAGTGTAGGAC-1	CM
GTTACGAGTGATGTGG-1	CM
AGCTGATAGATGAGGA-1	CM
TCCATCGAGGTTAGTA-1	CM
GCAAAGGAGTGATCTC-1	CM
ATCGAGTAGCTGGAGT-1	CM
TCACCACGTCACCCGA-1	CM
CATTGGAGTCATAAGA-1	CM
CACAACACAGAAGTGC-1	Fib
AACATCGTCTTGGCCT-1	CM
AGGCGTCTCGGTCAGC-1	CM
GCTCACTAGCATGTGG-1	CM
TGTGTCCTCAGAATGA-1	CM
TTGTTCAAGGAAGAAC-1	CM
ACTGCAATCCTCATTA-1	CM
GAATCTGTCTTACGGA-1	CM
CTCAGCTGTATTCACG-1	CM
TCAAGACCAATCCATG-1	CM
TTATGTCAGTTATGAG-1	CM
TGTAGCATCTGGCACG-1	vSMCs
AACCGATAGTGCACAG-1	CM
GGTGAAGAGAGGAAGT-1	CM
AAACTCGGTTCCGCGA-1	CM
ATAGGCTAGAGTTCGG-1	CM
GACCCAGCAGGTAGGT-1	CM
TTACCCGTCTGTAGAC-1	CM
CTACAGACACAATAAG-1	CM
ATTCGTTGTATCCTTT-1	Fib
CGCACAGTCCAGTTAG-1	CM
GAAAGTATCGGGCTCA-1	CM
GACCCAGAGACTAGCG-1	CM
ACAGGCCCATCACAGT-1	CM
TAGCGGCCACAAACGG-1	CM
GAGCATTAGGCTGGAT-1	CM
AATGTCGGTCTGGGAA-1	CM
ACTAGGTTCATTCTCA-1	CM
CTTGAAGCAAGACTTC-1	Fib
AGTGCGCGTCTGTGTA-1	CM
GTGGCGTCAGCGTGAA-1	CM
ATAGGCTTCAGGAAGC-1	CM
GCTTTCGGTTCTGAGT-1	CM
TCAGGGCTCACTCGGG-1	CM
GAAGTCTAGTGGTGTG-1	CM
TTTGCGCCACAAGTGG-1	CM
TCAAGCAAGGGCGAAG-1	CM
GCGGAAACACGTACAT-1	CM
GCCCGAACACTCAGCG-1	CM
GAACCTATCGCATACA-1	CM
CTACAGAGTGCAAAGC-1	CM
GCCTAGGAGAGTTTGA-1	CM
CAATCCCCAAAGCTGG-1	Fib
TCAAGGTGTACATGGG-1	Fib
GATGGCCAGCCTTTGA-1	CM
GAGGCTCGTGCAACAG-1	CM
GCACGGTAGAGAGGTA-1	CM
AACAGTCGTAAAGCTA-1	CM
TTCGATTCACAAGGGT-1	CM
GTGCACGAGGGTATCG-1	CM
TTACGGAGTTGGTAAA-1	CM
GTGGATTCAAGCGTCC-1	CM
ACTTCCGAGTCTTAGC-1	CM
AGTCAACGTCTAACCA-1	CM
TCAGTCCTCTCTGACC-1	CM
ATGTCGAAGTACCCAT-1	CM
GACCTTCAGGTAGGCT-1	CM
CTTGTCGAGCTAGCAG-1	Fib
TACAGCAAGCGCATTT-1	CM
TAACGGTAGTGTAATG-1	CM
CAAGGCCGTGCAACAG-1	CM
CGTGGCATCCCTATTA-1	CM
ATCGAGTAGACCGCAA-1	CM
CAGGGCTAGGCCTCGT-1	CM
AACCAACGTTTCAGCA-1	CM
GAAATGATCTGAAAGA-1	CM
CCTCCCTAGTCGTACT-1	CM
GATCATGAGCCTATAC-1	CM
TTAGGTGGTGAATCGG-1	CM
TAGACTGAGAAATGGG-1	CM
GGGACCTGTCCACCAG-1	CM
TTCGGTCTCACATTCT-1	CM
CCACGTTAGATATGAC-1	CM
GTGCCAGTCCTCTCTT-1	CM
GCAAAGGCAATGGCAG-1	CM
CTGTATTCAAGATGCG-1	CM
ACTATTCAGAACCATA-1	CM
AGTCAACAGACTAGCG-1	CM
ATAGGCTAGTCGGGAT-1	CM
ACTACGATCGTGGCGT-1	CM
TTGCGAACACACACAT-1	Endo
ATTTGTCGTAGCGAGT-1	Fib
AGGCCTGGTTCCCGGA-1	CM
TTGACGAAGCTCGTTA-1	CM
CACCTGTTCCAACCTC-1	Endo
CGGACTGCAAGCCCTG-1	CM
CAACGTAGTGAGCTAG-1	CM
AGCCTCTTCATACTTC-1	CM
ATGTCTTAGGTCACTT-1	CM
TACTGCCTCTGTGTCC-1	CM
AGCTATGAGAACGACC-1	CM
TATCTGTCAAAGGAAG-1	CM
GCGCCAAGTTACGAAA-1	CM
TTCGTTAAGGATTGCG-1	CM
GTGGCGTGTGACGCAA-1	CM
GCTCAGGCACAATAAG-1	Neuronal
CAGTGCGCAGACCTGC-1	CM
TACATGGGTATCCCTC-1	CM
TCAAGCACATCATGTG-1	CM
CCCTAACCATTACACG-1	CM
GTGCTGGTCCTGAAAC-1	Fib
TTGTTCAGTACAAATG-1	CM
GCGCCAAAGACACAAT-1	CM
GATGGCCCAATGGTAA-1	CM
TTGCACCAGGCCAGTA-1	CM
TTACTTGTCCAGGTCG-1	CM
GTCGTAAGTACGCAAG-1	CM
AGTCCGGAGCATGTGG-1	CM
TCACAAGGTTTCTACT-1	CM
AACTTGGTCTGAGTAC-1	Fib
TACGCAACAACTGCGC-1	CM
GCCCGAAGTCGAGGAT-1	CM
TGGGTGCAGAGAGTAG-1	CM
GGAACCCCATAGCCGC-1	CM
AGGACGAGTTTGTCTT-1	CM
CAGGATTCAACTCAAC-1	CM
TGACAACGTGCATCAT-1	CM
AGATAGATCTCATATC-1	CM
GACCCAGCAACAACTC-1	CM
ATCCCTGGTGCGTTTA-1	CM
TAACTTCGTCGCTACG-1	CM
GGAACTTGTAGCGAGT-1	CM
GTCCATCAGTCGTACT-1	CM
CGTGGCATCAGTGGTT-1	CM
ACAAAGACAATTCTCT-1	CM
ATCCTGCCACGCGACT-1	CM
TAGCCCTAGAGAGTTT-1	CM
GAAAGTAAGGCTTCGC-1	CM
ACAGCGCTCTTAACGG-1	CM
GCATTGAAGTTATGAG-1	CM
TTAGGTGGTGCTTCCT-1	Fib
ATGTCGAAGATGCGCA-1	CM
ACCGCAGAGCATGATA-1	CM
ACTAACGCAGTTGCAT-1	CM
TTGAGCAAGTGAAACT-1	CM
GTGATCATCGGTCGAC-1	CM
ACGTGGCCAGAACAGC-1	CM
CGCAATACAGTAACGG-1	CM
ATTCGTTAGTGAGCAC-1	CM
GAAGTGGGTTTCTTAC-1	CM
GCGTAGCCATCCTGGG-1	CM
TGCATGACAATGAAAC-1	CM
TGATTTCTCGAGAAGC-1	Lymphoid
CTTTGCGAGTGGGACT-1	CM
TGCACCTCAAGTTCGT-1	CM
ACCAAACTCCTCAAGA-1	CM
CCAGATATCGGGACAA-1	CM
TCAGTTTAGAGTGGAA-1	CM
CCGTACTAGGGCTCTC-1	CM
GTTACTTAGCTTCAAC-1	CM
ATAGGCTGTAGTTTGC-1	CM
GTTACTTTCGTCGCAG-1	Pericyte
ATAGGCTGTCCGTCGA-1	CM
GTTGGTAGTAACAATG-1	CM
CGTGGCATCATCGCCT-1	CM
GAGACTTCATTTGGTG-1	CM
ATTGTGGAGAGAACCC-1	CM
TTACCCGGTCGAGAAC-1	Endo
GCGATTATCATCGCCT-1	CM
GCAGATTAGCTTACCA-1	CM
GGGACCTAGTGAAGGA-1	CM
CGTTCCACAGAGTCGA-1	CM
TAGCCCTAGTCTCTAG-1	Endo
CAGCTAAGTTGTGAGG-1	CM
TTGCACCTCAGTTGAC-1	CM
GAGGCTCCACTGATAC-1	CM
TTTACGTTCCCGTATC-1	CM
GTTCAAGGTGTGAGGT-1	CM
GCATTCCCAATTGTGC-1	CM
TACCTCGAGGTACTCT-1	CM
TTGCGGGCAGTAAGCG-1	CM
TGGGTGCTCAGGGTTT-1	CM
GCTCCTACAGCGTGAA-1	CM
TGAGCCGGTTCACGTA-1	CM
CACTAAGCAAGTCTGT-1	CM
GGCGTTGCATCCGTAA-1	CM
GTCACTCTCTGTGTCC-1	CM
GAGTGAGAGAGCACTG-1	CM
GATGATCTCTTCTTCC-1	CM
ACAGACTAGGCTCAGA-1	CM
TAGCACAGTGCGCATC-1	CM
TGTACAGTCGATATGC-1	CM
GCGAGAAGTGAATGGC-1	CM
CCAATGATCGTGCTTC-1	CM
CTCTACGCAGGTCCTG-1	CM
TTCGGTCAGACCCTAT-1	CM
ATAGTCGCATACCCGG-1	CM
ACTCGGGAGAAGCCTG-1	CM
AACTTGGCAAGTCCTA-1	CM
GTCTACCCACCCATCT-1	CM
AGCCCGAGTGGTAAGC-1	CM
TGTACAGCAGTGGTCC-1	CM
GGACACCTCAAGGCCC-1	CM
GAGAACGTCACACGTA-1	CM
TATCGAGTCCTTCGAC-1	CM
CACATGATCGTGGTAT-1	CM
GGTGTCGCAAGGAAGA-1	Endo
TGTGTCCAGGCGTCCT-1	CM
TAGCCGGTCAAGGCAG-1	CM
AGTGCGCTCGTGATAC-1	CM
CACTAAGGTCCCTTTG-1	CM
CAGCTGGCAAGCGAAC-1	CM
GTCTACCGTAGCGAGT-1	CM
AGGCGTCGTTTGAAGA-1	CM
GCGATTAGTCTGTGTA-1	CM
ACAATCGTCATCATGG-1	CM
CTCAGCTCACTAGCCG-1	CM
TTAGCGAAGTAGGAAG-1	Endo
GCGTTGGCAAGGGAGG-1	CM
GCTCACTTCTCTCAAT-1	CM
ACTTCCGTCTCCTTAA-1	CM
CTTGAAGAGAATATCG-1	CM
GAAACAACAAGTTCGT-1	CM
GATTAGCAGGGTTCCC-1	CM
CAGCTAAAGAAGGGCG-1	CM
ACTACCCGTGTAGGAC-1	CM
GTGTCAACACTCGCAG-1	CM
AGCCTTCGTAGACACG-1	CM
CCTGGGATCGATAGCT-1	CM
AGGCGAATCCGTTTCG-1	CM
GCTGAGCTCGGTTAGT-1	Fib
CCGTACTGTGGTAGAC-1	CM
CACCTGTAGTACCACT-1	CM
GTTACTTTCAAGGCAG-1	CM
CCCTCTCGTAGCCATT-1	CM
CTCTCGACAGCGTGAA-1	CM
ACTTCCGCAGCGTCGT-1	CM
TTCTAACGTAACCGAG-1	CM
CTCACCAGTGCACATT-1	CM
TCTAGTTAGCCATTCA-1	CM
CCACAGGTCAAGGCAG-1	Fib
AACATCGCAATAGTGA-1	CM
GGCACGTAGGAGGCGA-1	Endo
GGCACGTTCTTGTCGC-1	CM
TAGCTTTTCTGATCTT-1	CM
AGTCAACAGTCAGCCC-1	CM
ATCCAGAGTTTGTGAC-1	CM
GGATAGGGTTAAGGGC-1	CM
CCGAAGCAGAAGACTT-1	CM
AAACTCGAGACTAGCG-1	Endo
AACTTGGTCGACTATG-1	CM
AACAGTCAGGTCGGTA-1	Fib
CCGTAGGTCGACTCGG-1	CM
CTTCTAATCCTCCATG-1	CM
TATCGAGTCGAGGCTC-1	CM
TCAGTCCGTAAGCCGA-1	CM
GAACTTGGTTGCCTGG-1	CM
TACGCCTGTTTCCACC-1	CM
GATTGACGTATCATGC-1	CM
AGGACGAAGGTCTTGT-1	CM
AGTTTGGTCAGTACAC-1	CM
TGCTCACCAGATTTGC-1	CM
ACAGCGCAGTACAGAT-1	Fib
GAGACTTTCGCCCTTA-1	CM
GCATTGAGTATTCTTC-1	Endo
TGTACAGGTACTTCAG-1	Endo
CCGTAGGTCCTTCGAC-1	CM
TCAGGGCGTAGTCTGT-1	CM
ACTATTCGTTCGGGAA-1	CM
GTAGTACGTCAGGCTC-1	Fib
GATTAGCCAACGAGGT-1	CM
ACTGCGGTCATTCTCA-1	CM
AGTTTGGTCCTGAAAC-1	Fib
CTAACTTCAAGCGTCC-1	CM
TTGCGAAAGTTACCAC-1	CM
ATTGTGGAGGTGATGC-1	CM
CGAGTTAGTATTCTTC-1	CM
TGTGTCCTCGCTACCT-1	CM
GCTTAAGTCGGAAAGC-1	CM
TAGGTCACATGGATGG-1	CM
CTTGAAGGTTGCCTGG-1	CM
GCCTAGGTCGCAAGCC-1	CM
TATTGCTTCGCTACCT-1	CM
TTCGTTAGTATTGTCG-1	CM
TAGCCCTAGATTCCGT-1	CM
TGACAACCACAGCCAC-1	CM
TTTGAGGGTGAATCAA-1	CM
TACATGGTCGCTATTT-1	Fib
TATCGAGCATTCACGA-1	CM
TACAGCAGTCCTTCAC-1	CM
GATTAGCAGGAGAACA-1	CM
GGATGAGCATGCCTTC-1	CM
CAGTATGCAAGGTCGA-1	CM
TCAAGACAGGCGATTG-1	CM
CTCCCAAGTCATCAAC-1	CM
TGCTCACCAACAACTC-1	CM
GGCATTAAGTTCGACT-1	CM
ACAATCGTCCTAAGTG-1	CM
AGCCTGGAGATCGCCC-1	CM
GCACCTTTCAACACGT-1	CM
TCTCAGCGTCCGCTTT-1	Endo
GATGGCCCACCAAGGA-1	CM
TGGTCCTTCTCTGACC-1	CM
GAGCATTTCACTGATG-1	CM
ACAAACCGTTGGGAAC-1	CM
CCCTAACCAAGGTCGA-1	CM
GGCGTTGTCGGGAAAC-1	CM
GGCGTTGAGTATGGGC-1	Neuronal
CACGTTCTCCTCAAGA-1	CM
CACATGAAGTTCCAGT-1	CM
TGTGTCCCAGCAATGG-1	CM
TAACGGTTCTCGACCT-1	CM
TCGCCTACATAGAATG-1	CM
AGCTGTATCGGTTGTA-1	Endo
GCGCATGGTTTAAGGA-1	CM
CTCAACCGTAGGTAAT-1	Endo
TGGACATCACAGTTCA-1	CM
CTTCTAAGTTAGGAGC-1	Fib
GAAGTGGAGGTAGGAA-1	CM
TCACAGAAGCAGGACT-1	Endo
CCCTAGTCAAGACTAA-1	Endo
GGAGTAGTCAAACCAC-1	CM
CTGCTCATCGGCAATT-1	CM
CTCACCAAGCGTATCT-1	Endo
CAGTGCGCAAACTACC-1	CM
TGGTCAATCTGGGCGT-1	Endo
TCACTCGTCCCGTATC-1	CM
TAGTCCCCACTCCTCA-1	CM
ACTTTCAAGTGGACGT-1	CM
GGTGCTGCACAGGAAC-1	Endo
TCAAAGCGTAGACACG-1	CM
AATGTCGCATCAACTG-1	CM
TAGTCCCTCTTCTCTC-1	CM
TTACGTTGTAGAACGC-1	CM
ATTGTGGTCGAACACT-1	Lymphoid
GTAGGAGAGATCACCT-1	Myeloid
TCACCACAGGATGTAT-1	CM
ACGTTAGTCCTTTGCG-1	CM
CCGTACTGTAGTTTGC-1	CM
TTCATTGCACAGATGG-1	CM
GTTGGTACATTGCCTC-1	CM
ACTTTCAGTAACCGAG-1	CM
GAACCTAAGGGTGTTG-1	CM
CAGTGCGGTGCGCTCA-1	Endo
TTGACGAGTGCGCATC-1	CM
TGTACGAGTATTCGCA-1	CM
GCGCATGTCATACTTC-1	CM
CGCAATATCCACGAGC-1	CM
TGGGTGCTCAGGAATA-1	Fib
GGTCATACACTGCTCT-1	CM
GAGTGAGGTGATAACA-1	Fib
TAGTCCCCATATTGGC-1	CM
GGTCATACAAGGGAGG-1	CM
TTACCCGCACTGATAC-1	CM
TCAAGCACAGTGCGAA-1	Endo
TAGCCCTCACACACAT-1	CM
GAGTGAGTCTTGTCAT-1	Fib
CGGTGCACACCGTTGG-1	CM
CACCTGTTCTCAGATG-1	CM
GGAACTTAGTGATATG-1	CM
AGTTACGAGTGCCCTG-1	CM
GAACCGCTCATCATGG-1	CM
TCAAAGCTCGTAGCGC-1	CM
CGCTATCAGAAGACTT-1	Fib
GTAGTACCATCCGTGG-1	CM
GCATGATTCCGAGGAA-1	Fib
TACGGATCACTGGGCT-1	Endo
ACGTGGCTCCATCTAT-1	Fib
CTACTTACACAACGGA-1	CM
AATGGAAAGTCTCTAG-1	CM
TAGCCGGGTTGGCTAT-1	CM
TCACTCGCAAGTCTGT-1	CM
TAGCACACAACCTCTC-1	CM
GGAGTAGTCTCTTAAC-1	CM
CGGACTGTCGTTCTAT-1	CM
TTCGATTTCGCACCTT-1	CM
TGGGTGCAGTGCAACG-1	CM
ATCGAGTGTGCGTTTA-1	Fib
ACTTTCACACTCGCAG-1	CM
CACAACAAGAATGCTA-1	CM
CAGTGCGTCGGACGAA-1	CM
CTACTTAGTTGCAGAG-1	CM
GGAGAACTCGCGTTCT-1	CM
TCAGGGCTCAGAACGG-1	CM
CTTGCCAAGTGAACCG-1	CM
CTGTATTCAATCACTG-1	CM
GCCAGACAGGGAAATG-1	CM
CCTTAATAGCCAGAAC-1	Fib
TGCATGAAGAACCATA-1	Fib
AGTTACGCAGAAGTGC-1	CM
AAAGATGGTATTCGAC-1	CM
TGCCTCATCATCATGG-1	CM
GCTTAAGCACAAACAA-1	Endo
GCGAGTCGTATGGGTG-1	CM
ATAGTCGAGAAGAGTG-1	Pericyte
AACCTTTTCTGAACGT-1	Fib
CAGGATTAGATGCGAC-1	CM
GCAGCTGTCGTGCTGG-1	CM
TACTAGGTCTATCTCA-1	CM
CTAGGATTCTTCAGAG-1	CM
AGGCCTGTCACTGGTA-1	CM
GATTAGCGTTACCCAA-1	Endo
GTTCAAGTCTCTGAGA-1	CM
CCAATGATCTGCCGAG-1	CM
GAGATTCGTCCTCAGG-1	CM
AGGCCCATCTTACCTA-1	CM
TTGCTTACATCAGCTA-1	CM
CCGTACTAGAGAAGCA-1	CM
ATGGATCGTCTCTGCT-1	CM
TGCATGAAGGCGACTA-1	CM
CACGTTCTCGGCTATA-1	Endo
AGTCCGGTCTGAGTAC-1	Fib
GTTACGAAGTGAGCAC-1	Fib
GCATGATCAATGTGCT-1	CM
GAGGCTCGTGCTTACA-1	Endo
GTTGGGCAGTGAGCAC-1	CM
GAGCATTGTTTGTCTT-1	Fib
TAGCATGCATCGCCTT-1	CM
CTAACTTAGCACACCC-1	Fib
GTGTGATGTACAAGCG-1	CM
AGCTGATCAAGACTTC-1	Endo
GTTATGGCACAGAAGC-1	CM
CAGCTAAGTGCATTGT-1	CM
AAGGTTCGTTTGCGAT-1	CM
CCACAGGCAATGACTC-1	CM
GCCAGCAGTTGGCGAA-1	CM
CATTCATTCTCCAACC-1	CM
TTCATTGTCATTCGGA-1	Myeloid
AATGGAAAGGTTAACA-1	Endo
GCGATCGGTTCTACCC-1	CM
TTATGTCTCCAGTACA-1	Fib
TTAGCTTCACTAGCCG-1	Fib
GAACGTTTCGATAGGG-1	Pericyte
AGGCCTGGTACTAGAA-1	Endo
AACCTTTTCTCGTAGA-1	CM
GGGCCATCATGGTATC-1	CM
TCGGGACCATTACTTC-1	CM
TTGCCCACAACCTCCT-1	Myeloid
TCAGGGCCAGGCAAGT-1	CM
GCTCAGGGTTACTTTC-1	CM
ACAAAGATCCGAGGAA-1	Fib
AGCCTCTGTAGTCCAT-1	CM
GTGCCAGGTTACACTG-1	CM
TCCGACTCAAAGCATA-1	CM
ATTACCTCAGTAAGCG-1	Endo
GGCATTATCTTCACTA-1	CM
TTACTTGCACGCGTTG-1	CM
GGAATCTGTCATTGCA-1	CM
AACCTGAAGTCTAGAA-1	CM
TACGCCTTCTCGGCGA-1	CM
TGAGCCGTCCCGGGTA-1	CM
TCCCACATCCATACCC-1	CM
AGCTGTACAGCAACGA-1	CM
AAACTCGGTAGCAGGT-1	CM
AGCCTGGCACACATTG-1	Fib
TAACAGCGTTTCCACC-1	Endo
GTCACGGCATTACTTC-1	CM
GTTACGACAGTAGTTC-1	CM
GCGAGAAAGTCAACTC-1	CM
GCCAGCAAGGTACATA-1	Endo
GGAACTTCAATTAGGA-1	CM
TAATTCCCACCACAGC-1	CM
CCCTAGTAGAAGAGTG-1	CM
GACTAACCACCAAGGA-1	CM
AGCCTTCGTTAAGTCC-1	CM
CAGCTGGGTCATCGTA-1	CM
TTGTTGTAGGTCCTCG-1	Fib
AACGAGGCAAGTAACA-1	CM
AACAGTCTCAGCACGC-1	CM
GCAGATTTCCCTACCA-1	Endo
TAGGTGTTCAATTGGC-1	CM
TGGGTTATCCAGTACA-1	CM
TTTGGTTCATGTATCG-1	CM
TCGGGACTCAGTGTGT-1	Fib
GAGACTTCATGCGACC-1	CM
GAACTTGTCCGCTATC-1	CM
CTCATGCCACCTCGTT-1	CM
GAAGTCTAGGATTTGA-1	CM
CCTTGCACATGTCCCT-1	Endo
TTTGGCCAGATAGGTT-1	Fib
TAGCCCTAGGGCTCTC-1	CM
ATGTCGATCGGCAATT-1	CM
ATCCAGAAGTGCTCGC-1	CM
CCTCCCTCAAGGGAGG-1	CM
ACGTGGCCATCAGCTA-1	CM
AGCCCGAGTGGATTTC-1	CM
CCAGAATCAGCCGAAA-1	CM
CGTTCCAAGTACCTCA-1	CM
ATCCTCGCAATGCATC-1	CM
CATAACGTCTTGTGCC-1	CM
AACAAAGCATCGGCCA-1	Fib
GTCTACCAGCGTTAGG-1	CM
ACTAACGCAATGCCAT-1	Fib
GGGCCATAGTATACGA-1	CM
TTACGGACATGCCCTT-1	CM
AGTGCCGAGCATGATA-1	CM
GAGCGCTAGTGCACAG-1	Fib
AAACGAACATTACTTC-1	CM
ATGTCTTGTAATGCAA-1	CM
AGCTATGCAAGACTAA-1	Fib
CATGTTTAGAGTTCGG-1	CM
ATTTGTCCAAGGAAGA-1	CM
GCGAGAATCAGCACTA-1	CM
CGTGGCACATGCGTTA-1	Fib
TTCAACTCAAGCAACG-1	Fib
GTCCATCGTAGATGAT-1	Myeloid
GTAATCGGTCTTAGCA-1	Endo
CTGTTCGGTACGTAAA-1	CM
CCGTACTGTGAGGTCA-1	CM
CCCTCTCCAGAAGTGC-1	Endo
ACTGCGGTCATCGCTC-1	CM
TTACTCATCCGAATTG-1	Lymphoid
GCTTTCGAGGTAAGCC-1	CM
AGCCTTCGTGCTGTCG-1	Myeloid
GAACTTGCACTCCACT-1	CM
ATGGATCCAGTTCGGC-1	CM
GTTATGGAGACAACGC-1	CM
GATGATCCATTTGGTG-1	Endo
AGTGCCGAGCTAACAA-1	CM
GGATGAGGTCCAGACC-1	CM
GAAGAGCGTAAACCCT-1	Fib
TCACCACAGGGATCCA-1	CM
ACTGCAAAGTTAGCAA-1	CM
GGCATTATCGCCCTTA-1	CM
AAATGCCGTTCCAGTA-1	vSMCs
GTGGCGTCATGGCCTG-1	Endo
GAGTGAGTCGCATAAC-1	CM
ATAGGCTGTCTTAGCA-1	CM
AAAGATGGTGGAAGCT-1	Fib
GCAGCTGCATTGATGC-1	CM
AGTCAACAGCTCCATA-1	Fib
TTGAGTGAGTCTGCTA-1	Fib
CGCAATAAGCTAGCAG-1	CM
CTTGCCAGTAACCCAT-1	Endo
GACTAACCATGTAGAA-1	Fib
TACTGCCTCCATACGA-1	CM
TACATTCTCTAGCTGA-1	CM
AGATAGAAGAGGCGGA-1	Endo
TCGCAGGGTCATAGAA-1	Fib
TACGCCTGTCCTTCAC-1	Fib
TGTACGACATCCTCGT-1	CM
CCCTAACGTAGCGAGT-1	Myeloid
CTGTATTAGTGCTCGC-1	CM
GAGGATGGTTAAGGGC-1	CM
CTTAATCCAACGGGTA-1	CM
GCAGCCATCGCTCGGA-1	CM
ACTCGGGCAGGGTACA-1	Endo
AGCCTGGAGTTTACGC-1	CM
TTGCAGACATTCGTCC-1	Endo
GATCGTATCGGTCGAC-1	Fib
TTCATTGCAAGGCGTA-1	CM
AATACGCAGCTAACAA-1	Fib
AAATGAGTCCTTACGC-1	CM
GCTGTTCGTAACGGTG-1	Fib
TGGCGCAAGAGAGTAG-1	CM
TGGGTGCCATGGATGG-1	Endo
CTGCTCACACAATAAG-1	CM
TGCTATTGTAGGGTTG-1	Myeloid
AGCGTATCAATTGTGC-1	CM
GGAACCCAGGCTCCTG-1	CM
GTGGCGTGTGCAAGCA-1	CM
TTACTCAGTAGGGTCA-1	Fib
AATGCCAAGCAGTAGC-1	CM
CTCGCTACATGTCCCT-1	Myeloid
TAAACCGAGAACCCGA-1	Myeloid
TACTCGCTCCGTTTCG-1	CM
CCTGCTAAGTGAGCAC-1	CM
CAACGGCTCTTAGTGG-1	Pericyte
GCTGAGCCACGCGATC-1	CM
CACCACTTCCTGAAAC-1	Fib
TCTAGTTGTATGGGTG-1	CM
GGTACCGCAGGGTAAC-1	CM
GCAACCGTCTTTCGAT-1	Fib
ACAAGCTAGAGGCCTA-1	Endo
GACCTTCAGATACCAA-1	Fib
TTTGAGGAGTGAAGGA-1	Fib
GTGGCGTCAACTCCCT-1	CM
CCGAAGCTCCCGGGTA-1	Fib
GTAATCGCATGGCCTG-1	Fib
ACTATTCGTCGAGGTA-1	CM
GCCAGACTCTTCCAGC-1	CM
CGCACAGTCCTGTAGA-1	CM
CATTGGATCTCCCTTT-1	Fib
TTCGATTCAGACCTGC-1	CM
TAACTTCAGTAGCAAT-1	Fib
GGGAACAAGGTCGTTT-1	Pericyte
CTTCTAACACAAGGGT-1	Endo
TGCTTTAAGGCTTCGC-1	Endo
ACCGCAGGTATCCCTC-1	CM
AACATCGGTCAATCCA-1	Myeloid
CTGGCAGTCTTTGCAT-1	Endo
CTCATGCCATATTGGC-1	Myeloid
AGCCGCATCCAAACCA-1	Pericyte
ATTTGTCGTGAAACAT-1	CM
GAGGTCCGTATGCTAC-1	CM
CTGGGACAGTCAGGAC-1	CM
CTGAATGAGTAATCAG-1	CM
ACCGCAGGTATGTTCG-1	CM
CCACAGGAGCATGATA-1	Pericyte
TGACTCCTCGCTTCAC-1	CM
GGGAACAAGCTGATTC-1	CM
GCAAAGGTCACTTACT-1	CM
TACTCGCCATGGATGG-1	Fib
AGTCAACTCGCAAGCC-1	CM
GAACGTTGTGTCTACA-1	Myeloid
ACAGACTTCGATGTAC-1	Fib
AGCCTCTGTTTGCCCT-1	CM
CCTTGCAGTCAACTGT-1	CM
AGTGCCGGTGTCCCAG-1	Endo
TCGATTTGTTTGTGAC-1	CM
AGCTATGCAATGAAAC-1	Endo
GGGCCATTCTGCTACC-1	CM
ACTTTCAAGAGCTCCC-1	CM
CGAGTTAGTTCCTATT-1	Fib
AAATGAGAGTACCCAT-1	CM
CCTTGCAAGCAACGGT-1	CM
GCTCAGGTCCAGAATC-1	Myeloid
TTCATCACATGTGGGA-1	Fib
GTTCAAGAGTAACTCC-1	Fib
CAGCTGGAGATATGAC-1	CM
GTTATTCAGTCCGTGC-1	CM
TTGTTCAAGGGTAATT-1	CM
ACTTCCGAGAACGTCG-1	CM
GAACCGCAGAGAACCC-1	CM
AGGCCCAAGACAGTGC-1	CM
TTCATCATCAGCACGC-1	CM
CTTGAAGAGAAGCCTG-1	CM
TACATTCAGATGGGAA-1	CM
TGGACATAGTAGTTCC-1	vSMCs
CATTCATGTGATTCCA-1	Endo
CGTAAACAGTCTGCTA-1	CM
TATTGCTGTGCCCAGT-1	Fib
AGCGTGCTCCCTACGT-1	CM
GCCCGAAAGGGTAATT-1	CM
CAGTGTAAGAGGAACA-1	CM
CCATACCCATAGAATG-1	Myeloid
TTCGATTCACCTATTT-1	CM
AAAGATGAGTTACCAC-1	CM
TGATGCAGTACGGATG-1	Fib
TCAAGGTAGTAGTGTA-1	Fib
TTGTTCAGTGGCCTTG-1	CM
CGTGGCAAGTGATCTC-1	CM
CAGCTAATCTCTGACC-1	CM
AAATGAGAGTAACATG-1	Myeloid
AGCCGCACAAGGACCA-1	Fib
GCATGATGTGTCGTGC-1	CM
TTAACGGGTTCTTTCA-1	CM
ACGTGGCTCGCGATGC-1	Endo
AGGACGACACAAACGG-1	CM
AAAGGATAGGCTTCGC-1	CM
TCCAGAATCTACCCGT-1	CM
TTGTTCAGTATCCCTC-1	CM
GAAATGAGTAGGGTCA-1	Myeloid
TTCTGTATCAGGAATA-1	Fib
CTGGGACAGTTCCAGT-1	Myeloid
CCTTGCAGTTGGCTAT-1	CM
TGAATCGAGTCCTTCC-1	Fib
TAGCATGAGTGATTAG-1	Endo
CTCCCAAAGGTGTTGG-1	CM
TCTATTGGTATCGCGC-1	CM
CAGCTAAAGGATGCCA-1	Fib
ACCTGCTTCCAACAAC-1	CM
CTTAATCTCGCTTACC-1	Fib
TGCACCTAGAGTTTGA-1	Pericyte
GAGGCTCGTATTGTCG-1	Myeloid
CCTTAATGTATCGCGC-1	CM
GTCACGGTCTACTGCC-1	CM
AACCTTTGTGAATACA-1	Fib
GCGCATGTCTGGACAT-1	Fib
TAACTTCCATATTGGC-1	Endo
TGCACCTCATTACACG-1	Fib
AGCCCGATCCCGATTC-1	CM
TAATCGGTCGCAAGCC-1	CM
CTACTTATCGCTGATA-1	Fib
ACTATTCGTTGGACGA-1	CM
TTACGTTAGTTGGAAT-1	Endo
ACAAGCTTCGACTTAG-1	Fib
TTATGTCGTTGGCTAT-1	CM
TAACTTCTCATTCATC-1	CM
AGGCCTGTCGCACCGA-1	Myeloid
GTAGGAGAGCCTCGCA-1	Fib
GCCCGAAAGTGTCGCC-1	CM
ATTACCTTCGTGAGTT-1	Fib
TTGTCTATCCAATCCC-1	Fib
GATTGACCAAGTGGCA-1	CM
GGAGGATGTGCACCCA-1	Fib
TGCTCACGTCCTCAGG-1	CM
CGCTAGGGTACCCACG-1	Fib
AGCCTGGGTAAAGCTA-1	CM
GCGGGTTCACATCATG-1	Fib
GTTATGGCAACGTAGG-1	CM
GCGAGAATCCAGGTCG-1	Endo
TGTGGCGCAGTATCTG-1	Fib
TAACGGTCATTACCTT-1	Fib
GTGTCCTGTGGAGTGT-1	Endo
TCGCAGGTCGTTCCGT-1	CM
CTCTAGCTCCTATCAT-1	CM
TTGCTTAGTACAACGG-1	CM
CAAAGCTTCTCCAACC-1	Fib
GTTATTCGTTCAGAAA-1	Fib
GGGTCTGTCTCTCAAT-1	CM
GCCAGACCAATCCATG-1	CM
TGTACAGCATTCGTCC-1	CM
CTCGCTATCCGATGCG-1	Fib
CCACGTTAGCATACCT-1	Fib
TCGCCTATCGGTCTAA-1	Fib
CTCGCTAAGATCCGAG-1	Fib
GGGTTATTCGATCGCG-1	CM
TGTGGCGCACATCATG-1	CM
TGCTCACAGGGCTTCC-1	CM
GGAGAACGTTACTACG-1	Endo
GTAGTACCAGCTATAC-1	CM
CCTAAAGAGCAGAATT-1	CM
TTCGCGTTCTTGTCAT-1	CM
GCAGATTCAGGCAGAT-1	CM
GGGACCTGTGTTTCTT-1	CM
CCTGGGACAATTGCCA-1	Endo
GAACCTAAGAAATGGG-1	Fib
GGAGAACCACCTATTT-1	Pericyte
CTTGAAGAGTTCGTTG-1	CM
TCAATTCTCCATACGA-1	CM
ACTGCAACAATAGCGG-1	Fib
AAAGGGCTCTCGCGTT-1	Fib
ACTGCAACATTTCACT-1	CM
CCGAAGCGTAAACCCT-1	Endo
ATAGGCTCAGTTCGGC-1	Pericyte
GTGTCAATCGAACCGC-1	CM
CCAATGACACCGTTGG-1	Endo
CGGTGCACACAGGAAC-1	Pericyte
TACATTCAGGAGTAGA-1	CM
ACTTTCAGTACGACCC-1	CM
GCTGAGCAGGCGTCCT-1	Endo
CAGTATGTCCCAGCGA-1	Myeloid
TGCCTCAGTCACATTG-1	Endo
CGAGTTATCGTCTTAT-1	Myeloid
TGTGTCCAGGAAGAAC-1	Endo
GAGAACGGTTGCCGCA-1	CM
CAGCTAAGTAGAATAC-1	CM
ACATGCAAGCTGATTC-1	Fib
GAAGTCTAGGCAGTGT-1	Endo
GCGAGTCCAGAACAGC-1	Fib
CAGGGCTGTTGGCGAA-1	CM
TAAACCGTCCAATCCC-1	Fib
ACAGGCCAGTGTCACT-1	CM
TGCCTCAAGGCAAGCT-1	CM
TCAGCTCGTCCGTGCA-1	Endo
TACATGGTCCGATGCG-1	Fib
GGTACCGGTTGGCGAA-1	Endo
GAGTGAGCACTCCTCA-1	Pericyte
AATGGAACATGTAGAA-1	CM
TACAGCAGTTTAAGGA-1	Fib
TACATTCAGACTCTTG-1	Neuronal
TACGCAAGTCATAGAA-1	CM
GGATGAGTCAAACCAC-1	Fib
TTCTAACGTACATGGG-1	Endo
CGCTAGGGTTGAAGCG-1	Fib
GCAGATTCATCGGCTG-1	Fib
TTGCTTATCTCGTGAA-1	CM
CGTTCCAAGGATTGCG-1	Fib
GATTAGCCACAGTTCA-1	Fib
AGCGATTAGTAGAAGG-1	Fib
TTGACGACAATTAGGA-1	CM
GTTACGACACATTCTT-1	CM
TTGCACCAGCTTACCA-1	Fib
TCAGTCCTCCCACTAC-1	Endo
GTAATCGTCCCTAAAG-1	Fib
GTCACGGGTTGGAGGT-1	Pericyte
CTGGCAGTCATCATGG-1	Endo
CCTGCTAGTTGGCTAT-1	Fib
CGCACAGAGGGTATCG-1	Fib
TGACTCCCATAGCCGC-1	CM
GCACCTTCAAGGAGGG-1	CM
CGAGTTACACAGTTCA-1	Endo
TTGCTATTCGCTTGAA-1	CM
GCAGCCAGTTTGTAGC-1	CM
CGTTCCACAATGCACT-1	Fib
CTACAGATCACTCCCA-1	Fib
GGCATTACAAGCGTCC-1	CM
TAGCTTTTCCGAGGAA-1	Endo
ACCCAAAAGTGATCTC-1	Fib
ACTACGACATGGCCGT-1	CM
GAACCGCAGGGAGTTC-1	Fib
CAGTATGTCGTCTAGA-1	CM
CTCTACGTCTTTATCG-1	Fib
ACATGGTAGCTAGTTC-1	CM
ATCCAGAAGCAATAAC-1	Fib
GCGCATGTCGATAGCT-1	Fib
CCGTGAGGTGATAAGT-1	Fib
TTAGGTGTCTTATCAC-1	Endo
GACCGACGTTTGTGAC-1	CM
GGGTGTCTCGAGAACG-1	Myeloid
TTTGCGCAGCTGAGGT-1	Fib
TACCTCGTCGCGTGAC-1	Myeloid
GGAACTTCAGTAGTTC-1	Fib
GTTACTTCAAAGAAGG-1	Fib
TCAGGGCTCCAGTTAG-1	Fib
TGCTCACGTGGTAGAC-1	CM
TGTACAGAGTAACACA-1	Fib
TATTGCTGTGAATCGG-1	Fib
TGAATCGTCTGCCGAG-1	CM
TGATCAGAGAGATTAC-1	Fib
GCGAGAAGTCAATACC-1	Myeloid
CTAGGATTCATCGCCT-1	Fib
ATCCTCGTCATTCTTG-1	Fib
ACAATCGTCAATTGGC-1	CM
TCTATTGTCCGTACGG-1	CM
CAGCTGGAGTGAATAC-1	Fib
CCAATGAGTCCAAGAG-1	Fib
TGCATGATCTCTTAAC-1	Fib
GTGGCGTTCAGATACC-1	Fib
TAGCACAGTTGGAGGT-1	Endo
ATGCATGGTATCATGC-1	Pericyte
GCTCAGGAGTCGAAAT-1	Endo
CGCTATCGTCAGGTGA-1	Pericyte
TGTACGAGTCTAAGAA-1	Fib
CCCGTTAAGGTACACG-1	Fib
CACAGATTCCAATAGC-1	Myeloid
ATTGTCTTCCGTACGG-1	CM
TTACCCGCATTTCTTG-1	Fib
GCTGTTCAGAGTAAGG-1	Fib
GTCGTAAAGTAATCAG-1	Fib
TTGCTTAAGGTTGTTC-1	CM
GATTGACCAACTCGAT-1	CM
TGGTCCTGTAGCATGG-1	Fib
GACTAACAGAAATCTG-1	CM
TGATTTCAGGGACGTT-1	Endo
GCAGCCAGTCACTCTC-1	CM
CGCTAGGAGAAATTCG-1	Fib
CTCTCAGCACAAACGG-1	Fib
CCAATGAGTCAACTAC-1	CM
ATGCATGTCGGGCTCA-1	CM
ATTACCTCACGAACGA-1	CM
ACAAACCCATTAGCCA-1	Pericyte
CATAACGCACTTATGG-1	Pericyte
AGTCCGGTCTGACATG-1	Endo
GAGCATTCACTGATTG-1	Endo
AATACGCAGCCCATGC-1	Fib
ACTGCAAAGGCAGTAC-1	Myeloid
CCACAGGGTCTGGTCG-1	Fib
AGCCCGATCTAGCAAC-1	Endo
GCGTAGCAGTCCCTCT-1	Fib
GAAACAAGTGATCAGG-1	Endo
GCTCACTAGTCCTTCC-1	CM
GCCATAATCGACGGAA-1	Fib
TACTGCCTCGGATCGC-1	Fib
GTGGATTTCCTGTAGA-1	Myeloid
GCTGAGCAGGGTGTTG-1	CM
ACAGACTAGTGATAAC-1	Fib
CTACAGAAGTTTGGAA-1	Fib
GCCTACTAGGATTGCG-1	Fib
GAAATGAGTACGGTTT-1	Endo
ACGTTAGTCGGTTAGT-1	CM
GTTATTCTCAAGGCAG-1	Pericyte
AAGGTTCGTGGCGCTT-1	Myeloid
GATCGTATCACTTACT-1	Endo
GCTGTTCGTACGGATG-1	CM
CTCACCAAGAGGAAGT-1	Myeloid
ACGTGGCAGTAGTGTA-1	CM
CTTCCAGTCCTCATTA-1	Endo
GCGGGTTGTTTCCTAT-1	Myeloid
CACTAAGAGTACCACT-1	Endo
GGAACTTAGCCCATGC-1	Fib
TCAGGTATCCTCCCAA-1	CM
TCTCTGGTCAGGCCGT-1	Myeloid
AAAGGGCGTGTCCAGC-1	Fib
GAGCGCTAGAACGCCA-1	Endo
TGTGTCCCAACGAGGT-1	Pericyte
AGTGCCGTCGTTCCGT-1	Lymphoid
GCAGATTCAAACTACC-1	Fib
TCAGTCCGTAGCGTTT-1	Endo
TCAGTTTCAAAGGTCG-1	Myeloid
AATGGAACACTCGGAC-1	CM
TAGCTTTGTACGTAAA-1	Fib
ACCATCCAGTACAGAT-1	Fib
TGTGTCCTCGATATGC-1	Neuronal
TTCGGTCGTGAGTCGA-1	Endo
AGGACGAAGTCAGCCC-1	Fib
ACAGACTGTCAGCTTA-1	Myeloid
CGTTCCAAGTTGTCCA-1	Fib
AGCTGATCAGGGTAAC-1	Endo
GGAGGATAGTACGACG-1	CM
CTTTGCGTCTACATCT-1	Fib
TCAAGCACAAAGCATA-1	Fib
TGAATCGTCCAGGCCA-1	Fib
GATTAGCGTAAGCCGA-1	CM
CTTCTAAAGCATTGGG-1	CM
TCACTCGTCGCTATAG-1	CM
TAAGTGCGTCTGGGAA-1	Endo
ACAAGCTGTACGTAGG-1	Fib
AATGTCGTCGCTTCAC-1	Fib
GCCCAGAAGCCATCAT-1	Endo
CCGTAGGTCCGGGCAT-1	Myeloid
ACTTTCAAGACAACGC-1	Endo
TCAAGCACACGGTTAT-1	Endo
TACGCAATCTCTTCCT-1	Endo
CTGAATGCAAGTCTGT-1	CM
ACCGGGTAGCGTAGCA-1	Endo
GCTCGAGTCCAGGGAA-1	Myeloid
CTAACTTTCTCGCGGA-1	Fib
TAAACCGAGTTAGCAA-1	Endo
CATTCATGTTCCTATT-1	Neuronal
TTGCTATTCAGGAATA-1	Endo
GTGCCAGCATGCCTTC-1	Endo
AGCGTATCACCCTTTG-1	Fib
CGTACAAGTCAGCAAG-1	Endo
AAGATAGAGTAGGAAG-1	CM
ACAGCGCCAGATGGCA-1	Endo
GTAGACTCAGGCAAGT-1	Endo
TCAAGGTGTTCTGAAC-1	CM
GCTTTCGTCCATAACG-1	Fib
CAGGGCTCATATACGC-1	CM
CTGCTCAGTGAGTCGA-1	Fib
GCTTAAGGTTCCAATG-1	Fib
TTGTTCACAGCGTACC-1	Endo
CCGTAGGTCGGATGTT-1	Endo
ATGTCTTCATCCCTTG-1	Fib
CTTGCTGGTTGAATAG-1	CM
CGCGCAAAGCAGGACT-1	Fib
AGGCGTCAGATTGACA-1	CM
GAGTGAGGTTCTCGAA-1	Fib
CTTAATCTCTTCTTCC-1	Fib
ACCGAATTCCAGTACA-1	Fib
AACAAAGCAAGCACTT-1	Fib
TTACCCGTCATTGCCC-1	Endo
CACTAAGAGAGACTCG-1	Fib
AGCGTGCGTGGAAAGA-1	Endo
TGTACGAAGGGTAATT-1	Endo
AAAGATGAGAAGGGCG-1	Endo
ACAATCGTCGAGCGCT-1	CM
TATGTGGTCAGGGTTT-1	Fib
GGAACTTAGAGAAGCA-1	CM
GATCATGTCTGGAAGG-1	Fib
GCGGAAATCTAGCAGT-1	Endo
GCTGTTCTCACTCCCA-1	Endo
TTCAACTCAGCTTACA-1	Endo
CCTATTATCTGACATG-1	Endo
TAAACCGCAATTCGTG-1	CM
AACATCGTCGGTCAGC-1	CM
TCCAGAATCTTTGCAT-1	Myeloid
GAAGAGCGTCATCGTA-1	Fib
CGCGCAAGTCTGGTCG-1	Neuronal
CCCGTTACAGCGTACC-1	Fib
GTTATTCGTTTCGATG-1	CM
CGCTGGAAGAAAGGGT-1	Fib
GGCACGTGTGATAGAT-1	CM
AAAGGGCCATTACCTT-1	Endo
ACCGAATCACCAAGGA-1	Neuronal
CCTTGGTCATAGCAGG-1	Myeloid
CACCTGTCATGGGAAC-1	Endo
GGATAGGTCTCTGACC-1	Fib
GCGATCGGTAGGGTCA-1	Fib
GGACACCGTTACACTG-1	Fib
ATGTTTCAGTTCTCCC-1	Endo
GTACTTTAGAGACTCG-1	Endo
TTAGCTTGTCTGATTG-1	Fib
TGCTATTGTGGTGGTA-1	Myeloid
GAGATTCAGCGCCTAC-1	CM
AGCCGCAAGCATTCCA-1	Fib
CTCAGCTTCTGTGTGA-1	Neuronal
CACTGAAGTATCAGCT-1	Fib
TTGTCTATCTCTTAAC-1	Fib
TAAGTGCGTGTGACCC-1	Pericyte
GAGCATTGTGACGCAA-1	Pericyte
CTTGCTGAGGTAAGCC-1	CM
AGTGCCGTCCTCTCTT-1	Endo
TCACCTGAGGTTAACA-1	Pericyte
CTTGTCGAGAGTCCGA-1	CM
GCGCATGTCTTCTTCC-1	Pericyte
GAAATGATCGATAGGG-1	vSMCs
GTTGGTAAGGCAAGGG-1	Fib
GGTGTCGCAGTAACCT-1	Fib
CAAGGCCTCGGATCGC-1	Fib
ATATTCCTCAGGCCGT-1	Endo
GTAGGAGTCTACTGCC-1	Fib
TGAGTCACATGCGTTA-1	Fib
AGCTATGAGAACCCGA-1	Endo
TTACTTGCACTGATAC-1	Fib
GAAGAGCGTGCGACCT-1	Endo
CTCATGCGTACGAGAC-1	CM
TGAGTCAAGGTAGGCT-1	Fib
GCATGATGTATCTAGC-1	Myeloid
ATTCGTTTCAGGCGCT-1	Fib
CAAAGCTAGGCAGATC-1	CM
CCCTCTCGTCACAGTT-1	Fib
TCACTCGAGCCTGTAT-1	Fib
ACTACCCCATTGAACC-1	Fib
ACTTCCGAGAACGTTA-1	Endo
ACTATTCTCGAGGCTC-1	CM
GTGATCAGTACGTAAA-1	Pericyte
GTCACCTCAATTGCCA-1	Myeloid
AGTCAACGTCAAGACG-1	Fib
TAAGCCATCCCAGCGA-1	Pericyte
TGGGTGCTCCGTGCGA-1	CM
CCCAGAGCAATTGGCT-1	vSMCs
GTGCTGGCAGAGTCGA-1	Fib
GTCACGGTCCACGCTT-1	Fib
CTCTAGCGTCAGTGCC-1	CM
TTAGGTGAGTTGGAAT-1	Fib
GCGATCGTCTCCTTGG-1	Fib
CATGTTTAGCTTACCA-1	CM
GCTGAGCTCCCTAAAG-1	Fib
TTGAGTGGTGATGCGA-1	Myeloid
CATGTTTGTTAGAGAT-1	Endo
CCGAAGCAGTCCCGCA-1	Myeloid
TAATTCCCAGAATGCG-1	Fib
ATCCAGAAGTCGAAAT-1	Fib
TACGCCTTCCAGGCCA-1	Endo
TTGTTGTAGCTACGCC-1	Fib
TGGCGCACATGGGAAC-1	Fib
AACGGGAGTCCAAGAG-1	Endo
GATGGCCTCCTTTGCG-1	Pericyte
GGTAGGATCTCATATC-1	Fib
GCCAGCAGTTTGCCAA-1	CM
CTTGAAGAGCATGATA-1	Neuronal
ACTCGGGTCGACTATG-1	Endo
ATGTTTCCAACTCGAT-1	Myeloid
TTTGAGGAGTAACACA-1	Myeloid
CTAGGATAGTCTCCAA-1	Endo
GACCAATGTGAGTTGG-1	CM
TAAACCGCAACTCAAC-1	CM
TCGCCTACAGGGTACA-1	Fib
GAGGCTCCACGATATC-1	Fib
GCTCAGGTCGTGGCGT-1	Fib
TTCTAACTCCGAGAGA-1	Fib
ACTACGAGTAGGTGAC-1	Fib
GAGGATGCAATGTAAG-1	Fib
TGCTCGTTCCAACGCG-1	Fib
ACAGACTTCGAGAAGC-1	CM
CTAGCGGTCTCGCGTT-1	Fib
CATGTTTAGATATGAC-1	Fib
CTCGCTATCTGGAAGG-1	Pericyte
TAAACCGCATCTCTCG-1	Fib
GGAGAACGTTGAAGCG-1	Fib
GCATTCCTCAGGGTTT-1	Fib
CCAGAATCAAATTGAG-1	CM
AGGCCTGGTGCGTAGA-1	Fib
GCGATCGCATAGCAGG-1	CM
TGTAAGCGTACGGAGT-1	Pericyte
GGTACCGGTATGGTTC-1	Myeloid
CCGAAGCAGAATACTG-1	Fib
TCTAGTTAGCACACCC-1	Fib
AAGGAGCAGGCTGGAT-1	Fib
AACTTGGCAATGCATC-1	CM
TCAAGGTTCCCGCAAG-1	Myeloid
AAACGAACAAGAGATT-1	Myeloid
AGCTGGCTCTTGGCCT-1	CM
TGTTAGGAGCTGAAAT-1	Fib
AAAGGGCGTGGCATAG-1	Fib
CTCACCACATCGGCCA-1	CM
AACTTGGAGATTCCGT-1	Fib
GCAGCTGTCGCCTTAC-1	CM
AGTCCGGAGTTCCCGG-1	Pericyte
GCCATAACATTTGTTC-1	Endo
GTGCACGCATTCACCC-1	Fib
TAATTCCCATGTCCCT-1	Pericyte
GCAGATTCACAGATGG-1	Fib
AGGACGAGTGACGCAA-1	Fib
GAGACTTAGTACCACT-1	Endo
TGGCCTTGTACCCACG-1	Fib
CAGGATTGTAACGGAC-1	Myeloid
GGATAGGCAAAGCTGG-1	Pericyte
ACTACCCAGCGAATAT-1	Fib
TGGGTGCCAGTAAGCG-1	Myeloid
ACTATTCAGATGGGAA-1	Fib
ACCGGGTGTAAGCCTT-1	Endo
TGACTCCGTTGCAGCC-1	CM
GGCGTTGTCGTCGCAG-1	Endo
ACAAGCTGTTACTTTC-1	Fib
GACCGACAGACTTGAA-1	Fib
ATTGTGGTCCGGCGAT-1	Endo
GAAGTGGCATCATAGC-1	CM
GTAATCGAGAGAACCC-1	Fib
GCACGGTGTTACCCAA-1	Myeloid
TCAAGGTAGAGATTAC-1	Fib
TAGCGGCTCTGGTACA-1	Pericyte
GACCCAGGTGCGTCCA-1	Fib
TGTACAGGTGGCATAG-1	Endo
GCTCACTGTAGATTAG-1	Endo
GTTCAAGAGAAATACC-1	Endo
TTGACGAGTCTGGGCT-1	Pericyte
CAGGGCTGTTTAAGCC-1	Myeloid
ACCGCAGAGCAGGAGG-1	Endo
TTGACGATCCAAGAGG-1	Pericyte
AGTCAACCAAAGGAAG-1	Endo
ATATTCCGTGAATCAA-1	Fib
GGTGCTGCATGCGTTA-1	Fib
TAGGTCATCGTTGTAG-1	Fib
ACCGGGTAGTCCTTCC-1	vSMCs
CTGTATTGTTCTGATG-1	Endo
TTTACGTTCTATTTCG-1	Pericyte
TACGGATCATCCCGGA-1	Myeloid
AGCCTGGTCGGTTAGT-1	Endo
GCTTTCGGTCCTTATT-1	Fib
TCGAGCGGTTTAAGGA-1	Fib
GCATTCCGTACAAATG-1	Fib
GTTGGGCTCGCTACCT-1	Pericyte
ACAAGCTGTGTCTCGG-1	CM
ACCTGCTCAAATGTCC-1	Endo
CAACGGCGTAACTGAA-1	Fib
TCTCAGCAGTAGGTCG-1	Fib
TAGCGGCGTAGTATCC-1	Endo
AACGAGGCATCCATAG-1	Fib
CACTGAATCCCGAAGC-1	Myeloid
GTCACCTCAGACCTGC-1	CM
CCAGATAAGTTGCGCC-1	CM
GAAATGAAGGCTCCTG-1	Pericyte
ACAGAAAGTCAACAGG-1	Myeloid
AACGGGAAGTGTCGCC-1	CM
CCAATGATCTATCCTA-1	Endo
TCGGGACTCGTCTTAT-1	Fib
GCTCGAGGTTTGACCA-1	Pericyte
ATTCGTTTCCAGGGAA-1	Endo
TAGGTCAAGCTGCTCG-1	Fib
TCACCTGTCTCAGATG-1	Pericyte
ACTAACGTCCTATCCG-1	Endo
ACTAGGTAGGGTCTGA-1	CM
GTGTGATTCCCACTTG-1	CM
AAGGAGCCATCGTACA-1	Endo
CAAAGCTAGTAGTTCC-1	Endo
TTATGTCCACATTCTT-1	Endo
GAGCATTCAAGGAGGG-1	Pericyte
CTTAATCTCGCCTTAC-1	Endo
AACGAGGTCTATCTTG-1	Pericyte
GAAACAACAATCATCG-1	Pericyte
TATTGCTCAAGATGCG-1	Fib
CCCTAGTCACAGCCAC-1	Pericyte
CCTTAATGTAAGTCTC-1	Fib
CAAGCTACACAGGAAC-1	Fib
AATGTCGAGTTGAATG-1	Neuronal
CGCTATCAGGCTCCTG-1	Endo
GCATTCCGTGCATTCA-1	Pericyte
TCACCTGCATCCCTTG-1	Fib
GCAACCGCACCTATTT-1	Myeloid
TCCAGAAAGGTAAGTT-1	Endo
TGGCGCACAGGGTACA-1	Endo
CAACGGCCATAGCCAT-1	Fib
CGTGGCAAGACTAGCG-1	Pericyte
CAGCTAAGTTCCCGGA-1	Fib
GACCCAGTCGCGCCAA-1	Myeloid
GCGTAGCGTTAAGTCC-1	CM
ACGGATTAGTTGCCGC-1	CM
TAACAGCGTCTAAAGA-1	Endo
CGGACTGGTGCATTCA-1	Fib
TTGCGAACATCTCTCG-1	Fib
GATGGCCAGCAACTGG-1	Fib
TCAGTCCGTAACCCAT-1	Endo
AGATTCGCATTGAACC-1	Fib
TCAGTTTCATCCCAAA-1	CM
GCAGATTGTTATCGAC-1	Fib
TGTGACAAGCCTGTAT-1	CM
TTAGGTGGTCCGTCGA-1	Endo
CTGCTCAAGAAACGCC-1	Myeloid
CCTTAATAGATTAGAC-1	Fib
AGCGTGCTCCAAGAGG-1	Endo
CTAGGATAGAGCGAAA-1	Endo
CCGTAGGAGAGCCTGA-1	Lymphoid
TACCCTGCAATTGGCT-1	Fib
CCGAAGCTCCAATCCC-1	vSMCs
GTCACCTGTACCCACG-1	Pericyte
GTGTCAAAGGCTTAAA-1	Pericyte
TGTGTCCTCCATAACG-1	Fib
TAGGTCATCATCGCCT-1	CM
GTCGTAATCCCGTAGG-1	Fib
CCTCCCTGTTTCCGGG-1	Endo
CGCTGGAGTGGCATAG-1	Myeloid
CTTGCCACAGAGAGAA-1	Fib
CCCAGAGTCGCACCGA-1	Fib
TGTACGAGTAGCGAGT-1	Fib
GAAAGTAGTAGCGGTA-1	Pericyte
CAGCCTTAGTCTCGAT-1	Endo
ACCGGGTTCCATCTAT-1	Endo
TACCTATAGAACTAAC-1	Fib
GTGATCAAGCAGGAGG-1	Fib
TACTAGGCAAACAGTA-1	Endo
CCTGCTAAGCTTTCCC-1	Fib
GCGGTGTCAGTAGTCT-1	Fib
ATATTCCAGCTACGTT-1	Pericyte
AGCTGTATCAATCGTG-1	Fib
CACCTGTGTAAGCCGA-1	Endo
TAAGCCACAAAGGAAG-1	CM
AGTGCGCCAAGTCCTA-1	CM
ACCTGCTGTATTCGCA-1	Endo
GCAACCGGTGTCGTGC-1	Endo
ACTTTCAGTTTCTTAC-1	Fib
AACTTGGGTTTGCCCT-1	Endo
ACCCAAACATTCACCC-1	Fib
TACCTCGTCGCTTCAC-1	Pericyte
TTGCCCAAGGTGTTGG-1	Fib
TAGCCCTTCGCCCTTA-1	Endo
TGGAAGGTCTTCCAGC-1	Endo
ATTCGTTAGGAGAACA-1	Fib
AAATGAGAGAGGAATG-1	Endo
CTTCCAGGTACGTAAA-1	vSMCs
TGTGACACATCGGCCA-1	Fib
TGCTTTAAGATCGATA-1	Fib
ACTGCGGTCTCAGATG-1	Endo
GAATCTGAGACAACGC-1	Fib
GGAACCCCAAGGCTTT-1	Neuronal
CAGCTGGCAAACAGTA-1	Endo
ACGTTAGCATCGTACA-1	Fib
CAATCCCCACAAGGGT-1	CM
GAACTTGGTCAACAGG-1	CM
GTAGACTGTCTGGTCG-1	Myeloid
GGTGAAGTCGATAGGG-1	Myeloid
GCGCCAACATGTGAGG-1	Fib
TGTACGAGTTAAGTCC-1	Fib
ACGTTAGAGATCTCAC-1	Endo
TAACGGTAGTTGTCCA-1	Pericyte
TGATGCAAGCTGCCAC-1	Fib
CCTTGCACAGTCCTGG-1	Fib
GAGACTTTCAGTGTGT-1	Endo
TATCTGTAGTACCCAT-1	Endo
GAGTGAGTCGTGAGTT-1	Pericyte
CTCGCTATCATTCGGA-1	Endo
ACCGCAGTCAGTGGTT-1	Fib
GCTCAGGCAGGTGGTA-1	Pericyte
GAGCATTAGGAGTCTG-1	Fib
CTTGAAGGTCAACAGG-1	CM
ATTTGTCGTCATTGCA-1	Fib
CAACCAACAACAAACA-1	Pericyte
GCCAGACAGATGGGAA-1	vSMCs
CTGGGACAGCGTCAAG-1	Pericyte
TCCGACTCATACAACC-1	Endo
CTGGGACGTCTGCGCA-1	Fib
AAATGAGAGTTGACAA-1	Fib
TCCATCGCATTGCACA-1	CM
GGGTCTGTCACAACAC-1	Endo
CGTGGCACACACGGTC-1	CM
CACATGACACCGATCG-1	Myeloid
ACGTGGCGTACGTAGG-1	Endo
TGGACATTCCGGGCAT-1	Fib
AATGTCGCACTGGGCT-1	Fib
TGGAAGGGTTGGTAAA-1	CM
TGGCAATTCAATGCAC-1	CM
AGTGTACTCGAGGTCC-1	Endo
GGTAGGACATCCATAG-1	Endo
CCAGAATTCCTAAGTG-1	Pericyte
ATATTCCGTAAGTGCG-1	Myeloid
GGGTTATAGAACGTCG-1	vSMCs
GTTATTCAGTGCCCTG-1	Endo
ACAGAAAAGGGTCCCT-1	Fib
GTCACAAGTGACGCAA-1	Fib
GTGGATTGTGAGTTGG-1	Fib
CGCACAGCACGTACAT-1	CM
GCGCATGAGTATAGTG-1	Pericyte
GACCCAGGTGTCCCAG-1	Fib
CTCCCAAGTGTCGTCG-1	Endo
GCTTGCTAGTTCGTTG-1	Endo
CCATACCTCCATGTTT-1	Pericyte
CCGTAGGAGGGTGTTG-1	Endo
GTGCACGAGGATATCA-1	Fib
ACCGAATTCAGCACGC-1	Myeloid
TTTACGTAGCGCGTTC-1	Fib
GTGGATTGTATGGGTG-1	vSMCs
AACAGTCTCTCCACTG-1	Fib
AGCTATGGTTAGCTCA-1	Endo
TCAAAGCGTGCTGAAG-1	Fib
ACCGGGTAGCTCGGCT-1	Neuronal
TTTGAGGGTTCACGTA-1	Endo
TGGACATGTTCAGAAA-1	Endo
TCGCCTATCCACGCTT-1	Fib
GGAGGATGTAACATAG-1	Endo
TTTGAGGGTGATCAGG-1	Fib
ATTTGTCTCTCTTCTC-1	Endo
TAGTCCCAGTGATAAC-1	Endo
GCCAGACGTAAACGAT-1	Fib
GGATAGGCAACGTCGC-1	Endo
GCGATCGAGTTTGGAA-1	Pericyte
GTCACTCTCCTGTAGA-1	Fib
TGAATCGCATCGACGC-1	Endo
AATACGCAGGTTCGTT-1	Fib
GAGGCTCTCACTACCC-1	Fib
TGGCGCACATCCCTTG-1	Fib
AGCTGTACAAGCCTTA-1	vSMCs
TAGCGGCAGTGTTCCA-1	Pericyte
AGCCTTCCAGCGTAGA-1	Myeloid
TCACAGACACCATTCC-1	Fib
TGACAACTCGCAAGCC-1	Myeloid
CGTTCCAAGTGAGCTG-1	Endo
GAAATGAGTACTTGAC-1	Myeloid
TAGCGGCTCACTCGTC-1	CM
GAACGTTAGTGATTAG-1	Endo
GCGATTACAAATTGAG-1	Endo
GGCGAAATCGGTAGGA-1	Fib
TGTGTCCAGAGTCCGA-1	Endo
CAATCCCCAACGTCGC-1	Endo
CGCTGGATCGTTCAGA-1	Fib
CACCTTGTCTCGTAGA-1	Myeloid
CGTGGCAGTTGGGAAC-1	Myeloid
TACGGATAGACCATAA-1	Fib
TAGACTGTCGATGTGT-1	CM
TCAGTCCTCGTGCTTC-1	Fib
GCGATCGAGGGCGAAG-1	Fib
CAGTGCGCACAGGAAC-1	Endo
GAGGATGGTGATAACA-1	Pericyte
CTAACTTCAAAGGTCG-1	Endo
TAAGTGCAGGTCCTCG-1	Fib
CCTATTACAATAGTGA-1	Endo
CTTCCAGGTACCCATA-1	Myeloid
CCTGGGATCGGTCGAC-1	Endo
GCATGATAGTTGAATG-1	Pericyte
GAGCATTGTGCTGAAG-1	Endo
ACATGCACATTGTTCT-1	Endo
CTCTCAGCACTGATTG-1	Fib
AGCTGGCGTCCTTATT-1	Fib
TGTAGCAAGACTCGGA-1	Fib
AACTGGTCAAGTCCTA-1	Fib
GTACTTTAGAACGACC-1	Pericyte
GTCACTCAGTAACTCC-1	Fib
TGATGCACACTGATTG-1	Endo
GCTCGAGGTGAGCTAG-1	Endo
GCCTAGGCACTAGGAG-1	CM
ATAGTCGGTAGCAGGT-1	Pericyte
TACGCAAGTCTGCACG-1	Endo
GTGACATCATCCCAAA-1	CM
TGCACCTGTACGCAAG-1	Endo
AGCCAGCAGCGCACAA-1	Fib
GTGATCAGTCCATTGA-1	CM
TCAATTCCATTTAGGC-1	CM
CCACAGGGTGAGGTCA-1	Endo
CTTTGCGTCGGTTGTA-1	Endo
TGTAGCATCCGTTTCG-1	Myeloid
ATCGAGTCATAGCAGG-1	Pericyte
CTAGGATTCTTCACTA-1	Fib
TAAACCGTCTGAACGT-1	Endo
AACCGATGTCCCTAAA-1	Endo
CTAGGGCAGTCGCCTG-1	Pericyte
ATAGGCTGTTTCAGCA-1	Fib
TAAGTGCTCAAGGCAG-1	Endo
TTTGCGCAGAACTAAC-1	CM
TGGGTGCTCCTTACGC-1	Fib
TTAGCGACATACCCGG-1	Neuronal
GATGATCTCAGCGGTC-1	CM
TGTTAGGTCAGTGTAC-1	CM
AGTTACGTCGACTGGC-1	CM
CCGTACTAGTTACACC-1	Endo
GCTCGAGTCGTTTGAG-1	Lymphoid
TCCCACAAGGCCTCTG-1	Pericyte
GGATAGGAGTACCACT-1	vSMCs
AGTGCCGTCCCAGCGA-1	Endo
CCGTACTTCACTTACT-1	Fib
TGGCAATAGAAAGGGT-1	Neuronal
AACAGTCTCACTAGCA-1	Fib
ACATGGTGTCTCTGCT-1	Pericyte
AACCTGACAAACCCTA-1	Endo
CACCTTGGTGACGCAA-1	Myeloid
CTCCCAACATCCCAAA-1	vSMCs
ACAAGCTTCCGTCAAA-1	Endo
ATAGTCGAGTTCGTTG-1	Endo
CTGTTCGGTCAACAGG-1	CM
TTCAACTGTAGACGCA-1	Endo
GGATAGGGTCAGAAAT-1	Fib
TACCTCGTCGTGATAC-1	Fib
TAACAGCTCCATAGGT-1	Pericyte
TCGAGCGGTCCGTCGA-1	Pericyte
GTTCAAGCAAATGTCC-1	Myeloid
CCCACATCATATAGAG-1	Endo
GAGGCTCAGGTTAGTA-1	Fib
GTCACGGGTGGATTTC-1	Endo
ACCGGGTCAAACCCTA-1	Endo
TTACTTGAGAGGTACC-1	Pericyte
TTGACGACATCCCGGA-1	Pericyte
TCTAGTTCAATGGTAA-1	Pericyte
CGCACAGGTTTCGATG-1	Pericyte
TACTGCCCACTCCACT-1	Endo
GGAACCCAGCGTTAGG-1	Pericyte
TACATGGGTCTCTGCT-1	CM
CATAACGTCAGTGTAC-1	Endo
GCACGCAGTAACGGTG-1	Pericyte
TTCGTTACATGGGTGA-1	Myeloid
AGTTTGGGTAGCGAGT-1	Endo
TGACAACAGCCATCAT-1	Fib
AGCGATTGTCTGGGCT-1	Fib
ATGTCTTGTGCATTCA-1	Neuronal
TGCTCGTCAGGTAACG-1	Endo
CTGTTCGAGGTACTCT-1	Pericyte
CTACTTACAAGGAGGG-1	Endo
GCTCCTACAGGGTAAC-1	CM
GAGACTTAGTCCAGAG-1	CM
CGGACCACAACCTCCT-1	Pericyte
TCACCTGTCTGTTGCC-1	CM
GCTTAAGGTTAACCGT-1	Endo
GTCACGGAGAGCGGTT-1	Pericyte
ATCCTCGCACAAACGG-1	Myeloid
GGTTGCGCAGGTAACG-1	Endo
GGAGAACAGTCTTAGC-1	Fib
GGTGCTGAGTGATATG-1	Fib
GCGGAAACAGGTTATC-1	Fib
AGCGATTTCTGACATG-1	Pericyte
GGATAGGAGCTGCCAC-1	CM
AGCCTGGGTCTGATTG-1	Fib
TGATGCAAGGCTCCTG-1	Myeloid
TGCCTGTGTGTCCAGC-1	Fib
TTGTTCACATCGTACA-1	vSMCs
AATGCCACAACTTGGT-1	Pericyte
CCTGGGATCCACCTAC-1	Fib
GTAGACTTCGGTCGAC-1	Fib
TTTGAGGCAAGGTCGA-1	Fib
GGCATTAAGGCGCTTC-1	Fib
CCCAGAGCAATGACTC-1	Pericyte
ACCGCAGAGTGATAAC-1	Endo
TTCGATTGTGAGGGTT-1	Pericyte
GCAGCCACACGTTACA-1	Fib
AGTGCGCGTCCACCAG-1	Myeloid
ACCCAAAGTTGTGACT-1	Endo
TATCGAGGTAAACGAT-1	Pericyte
TAGGTGTAGTGATTAG-1	Endo
ACAGCGCCAGGTCCTG-1	Endo
AAACTGCGTATTGTCG-1	Endo
GTTATGGGTTGAAGCG-1	Lymphoid
CTTGAAGTCGGATAAA-1	Endo
TCAAGCATCCCGAAGC-1	Pericyte
TTGTTGTCATTCCCGT-1	Fib
CTGTTCGTCTTCCAGC-1	Endo
TGTACGAGTTACACTG-1	Endo
TTTGGCCTCGCATACA-1	Endo
CCTTGCACACAACGGA-1	Fib
CTGGGACAGGTAGGCT-1	Endo
GTGACATAGGCAGTGT-1	Endo
TCACCTGGTATCCCTC-1	Endo
CCAATGAGTTCCTATT-1	Fib
AGTCAACTCCGTTTCG-1	Fib
TCGTTCGAGAGGCCTA-1	Pericyte
CCCTGATGTTTAGGAA-1	Endo
ATCCTCGTCAAGGCAG-1	Endo
TTCTGTACATGGTAAA-1	Fib
AACAAAGGTCATGAGG-1	Endo
CCAATGACAGCGTAGA-1	Fib
TTACGGATCTGTTTAC-1	Fib
GCTCACTGTCTGGTCG-1	Endo
AAACTCGAGAAACGCC-1	Fib
AGTCAACAGTACCTCA-1	Pericyte
ATCCCTGAGACCATAA-1	Fib
CAAGGCCCATCCTGGG-1	Endo
AATACGCCACAGCTTA-1	Fib
TTATGTCCAAAGGAAG-1	Endo
CCCTGATCAAGCGTCC-1	Fib
TGTGACAAGATCGCCC-1	Pericyte
ATTTGTCTCTGGGCGT-1	Endo
CTCGCTAGTGGCGCTT-1	Pericyte
CCAGATACAACTAGAA-1	Endo
CTGGCAGGTAATGTAG-1	Fib
GCAGCTGTCGTTGTAG-1	Fib
CCACAGGAGTCATACC-1	Pericyte
CTGCGTTAGCTGAAAT-1	Pericyte
CACAGATTCCATATCT-1	Fib
GACCGACTCTTGCGCT-1	Endo
TGGTCCTCAAACGTTC-1	CM
CCTGGGAAGAACTCCT-1	Pericyte
AGCCTCTGTTTGAAGA-1	Endo
GCTCGAGCACGTTGTA-1	Fib
GTAATCGCAGGTTATC-1	Fib
CTCTCGATCTGTTTAC-1	Fib
GTTACTTAGATGTTGA-1	Fib
AACCGATCAAATTGAG-1	CM
ATATTCCTCTGTTGCC-1	Myeloid
TTCTAACTCGAGGTAG-1	Endo
AGCTGTAGTGTCGTGC-1	Fib
GCAGCTGGTTATCGAC-1	Pericyte
AGATTCGGTGGACCAA-1	Pericyte
AATACGCGTAGAAGCC-1	Fib
AGTTACGGTCACTCTC-1	Endo
CAGCTAATCTTACCTA-1	Pericyte
CAGTGCGAGTAATCAG-1	Endo
GCGTAGCGTGACGCAA-1	Fib
CACTAAGGTATCCCTC-1	Pericyte
GCGCCAAGTAGTACAA-1	vSMCs
CGTGGCAGTGCGCATC-1	Fib
ACCGCAGGTTTGTCTT-1	Pericyte
GTCACCTTCAACGTGT-1	Endo
GAACGTTTCTCATCCG-1	Fib
TCTATTGTCCCAGTAA-1	Fib
GCCCGAATCCCGATTC-1	CM
CTGGGACTCCCAGCAG-1	Endo
TTAGGTGCACGATATC-1	Fib
CCAGAATAGATTGACA-1	Pericyte
GCCCAGAGTGCCCGAT-1	Fib
CAAAGCTGTAGAGAGA-1	Pericyte
GGGTCTGAGCGAATAT-1	Myeloid
CCATACCTCTCGTGAA-1	Pericyte
CAGGATTTCTTCATAC-1	Pericyte
TTACGTTTCCTCAAGA-1	CM
ATCCTCGTCAGAACGG-1	Pericyte
GCCATAAAGCAATAAC-1	Endo
ATGTCTTTCGTGGGTC-1	CM
GTTACTTTCTCTGCAC-1	Endo
TTCGATTGTGATGCTT-1	Fib
CGTTCCAAGGTAGGCT-1	Myeloid
TTACGGAAGTACAGTA-1	Endo
CACTAAGAGTTCAGGG-1	Pericyte
CTTTGCGCAGGCACAA-1	Pericyte
TATGTTCAGGAACCGT-1	Endo
AGTCCGGGTGTGACCC-1	vSMCs
GCCAGACTCGTTGTTT-1	Endo
TGATTTCTCGGGATCC-1	vSMCs
GCTCACTGTGCCAAGA-1	Neuronal
AGGCGAATCCTGTAGA-1	Pericyte
TAAACCGAGTTCGCGC-1	Endo
GTAATCGAGGCTTTAC-1	Fib
GCATTCCAGGTCACTT-1	Fib
TTAGCGAAGCCATCAT-1	Pericyte
AACTGTGTCGATGTAC-1	Endo
GGCGTTGAGTACCCAT-1	Endo
ACAATCGAGCCTATAC-1	Endo
GGGTTATCAAGATGCG-1	Endo
GAAGTGGTCTATGAGC-1	Fib
GGGCCATGTATGGATA-1	Myeloid
GGGCCATAGTGCCCTG-1	Endo
TGCTTCGTCCTCCATG-1	Pericyte
TTCATTGTCCATTGTT-1	Fib
ACATGGTGTGAATGTA-1	Endo
CCCAGAGGTTAGAGAT-1	Endo
CTCACCATCGGTCTCT-1	Endo
ACCCAAATCCCGTAGG-1	CM
GAGAACGGTAGCGTTT-1	Pericyte
CGCTATCAGTTGCTTG-1	Endo
CATTCATAGTGGTGTG-1	Fib
CTCCCAAGTGGAGTGT-1	Pericyte
CGAGTTAAGGAAGAAC-1	Endo
GTGCACGGTTTCCACC-1	Endo
TGGCCTTTCACGTCAA-1	CM
AACCTGAAGTCCAGAG-1	CM
CCCAGAGGTCTGCGCA-1	Endo
ACTCGGGTCTATCTCA-1	Endo
TTGAGTGTCAGCCGGT-1	CM
CACTGAAGTTCCAGTA-1	Myeloid
CTAGCGGCACAGGAAC-1	Pericyte
GTTATGGGTGCTAGTT-1	Endo
GAAAGTAAGCAATGTA-1	Fib
TGGCAATGTTAGAGAT-1	CM
AACAGTCTCTCTATCA-1	Endo
AAACTGCCATGGCCTG-1	Endo
TGTAAGCTCGGGAAAC-1	Endo
AGCTGGCTCAATCGTG-1	Pericyte
TCCGACTAGCGTGTTT-1	Pericyte
CCAATGACAGATTAAG-1	vSMCs
GGGTTATCATTTCACT-1	Endo
ACTACGAGTTAGGAGC-1	CM
AACTTGGCAACGCAAG-1	Myeloid
TGTTAGGTCCCGATTC-1	Fib
TAAGCCACATTCACGA-1	Endo
TTACTTGGTGCATTGT-1	Fib
CCGTGAGCACTGTTAG-1	Endo
GAGTGAGTCAAGGCCC-1	Pericyte
TGCTCACGTGCGCATC-1	vSMCs
AATGGAATCACATTCT-1	Neuronal
ACAAACCCACAACGGA-1	Myeloid
TGATCAGCAGATGGCA-1	Endo
GTCCATCTCCGTTTCG-1	CM
ACATGCATCGTAGCGC-1	Fib
CGAGTTATCGGATAAA-1	Endo
GTGACATAGATGGCAC-1	Endo
TGGCAATCACATATCG-1	Endo
GCGAGAAGTCCGAGCT-1	Endo
TCGCCTAGTCCGTCGA-1	Endo
AGGCCTGCATCCCAAA-1	CM
TGCATTTCAGGATAGC-1	Endo
ATGCATGCACCTACCT-1	Endo
GTTCAAGTCTTGTGCC-1	CM
AACCTGACACTAAACC-1	Pericyte
ATCCTCGAGGCACCTC-1	Endo
TAGCTTTAGTATACCC-1	Fib
GCGTTGGAGCAACTGG-1	Pericyte
AGCGATTAGGGAAATG-1	Pericyte
TCAGGGCTCACTCCCA-1	Pericyte
GCTGAGCAGAACTAAC-1	Lymphoid
GACCCAGTCTGCTACC-1	Endo
GAACTTGAGGCGATTG-1	Fib
TGGTCCTAGGGAGTTC-1	CM
TGCCTCAAGTCAGCCC-1	Fib
GCGGGTTAGACCTATC-1	Fib
CTCTAGCAGGTCGGTA-1	Endo
CAGCCTTAGATACCAA-1	Pericyte
GGAACCCCACGCTGTG-1	Myeloid
ACTATTCCAATCATCG-1	Endo
AAACGAAGTAGAGAGA-1	Fib
ACATGGTTCACCACAA-1	Pericyte
CAAGCTAAGCGTTAGG-1	Endo
GGCATTACACTGTTAG-1	Pericyte
GCCTACTTCTCGCGGA-1	Pericyte
GATGGCCAGTGGACGT-1	Fib
CTTAATCAGGTGTCGA-1	Myeloid
GTCACAAGTTCAGAAA-1	Endo
ATCCCTGAGACGCCCT-1	Fib
TATTGCTCAGGGTACA-1	Lymphoid
CGGTGCATCGACTATG-1	Pericyte
TAACAGCGTGTCGGTC-1	CM
ACATGGTTCGCACCGA-1	Endo
CTTGTCGGTAAGTCTC-1	Fib
TGGACATGTGATAACA-1	Endo
TCACAAGAGGTCTTGT-1	Pericyte
GTCACCTCACCCATCT-1	Endo
TATGTGGGTCGAGGAT-1	Endo
GCAGATTGTCATAAGA-1	Endo
CTCTACGCAACTGCGC-1	Myeloid
CCGTAGGCATCCCAAA-1	CM
CCTATTATCCAGGGAA-1	Fib
TGAGTCAAGCAAGGTC-1	CM
GGAACCCTCATGTTCT-1	Endo
GACCTTCAGACACTTC-1	Fib
CTCTACGCAATGACTC-1	Fib
TGGGTTAAGGGCTTCC-1	Pericyte
CGAGTTATCCCAGCGA-1	Fib
ACTCGGGGTGTACGCC-1	Endo
TGCGTAAGTAAAGCTA-1	Endo
ATCCTGCCAAGCAATA-1	Endo
TGATGCAAGGTGATGC-1	Pericyte
GTGCTGGGTTCTACCC-1	Endo
TGTGGCGGTTTCTTAC-1	Pericyte
GCATTCCCAAGATTAG-1	Fib
CCTAAAGGTGTCGTCG-1	Pericyte
CCAATGAGTATTCACG-1	Fib
TAATCGGTCGACCCGA-1	Pericyte
GTCCATCTCAAACCCA-1	Endo
TTGCGAATCAGTCAAC-1	Fib
GCCCGAAAGGCCAATG-1	Pericyte
TCAGGGCGTCAGTGTT-1	CM
TATTGCTCATCCTGGG-1	vSMCs
AACGTACGTCTGTTGA-1	Fib
AACCGATAGTAATGTG-1	Pericyte
AGCCCGACACAACGGA-1	Endo
AAACTGCAGTTCGCGC-1	Neuronal
CCGTACTTCTGGTACA-1	Pericyte
GGAACTTAGGCATGCA-1	Endo
AATGGAAGTAGGGTCA-1	Fib
GTTATTCAGACCTATC-1	Fib
TGACAACCAATCACTG-1	Pericyte
GCAGCTGCAAGCCCTG-1	Endo
CACTAAGCAACTTGGT-1	Endo
TTTGTGTTCCTCATTA-1	Fib
GCAAAGGGTTAGTAGA-1	Pericyte
TACGGATTCACATTCT-1	Endo
ATTCGTTAGTCAGGAC-1	Endo
AGTTTGGGTCTGAGCC-1	Fib
AGTTACGGTGGTCGAA-1	Endo
ACTGCAATCGATGTAC-1	Myeloid
ATATTCCAGAGAAGCA-1	Endo
ATTGTCTTCTGCTACC-1	vSMCs
CCGTGAGTCACTCGGG-1	CM
CCAGAATTCGTCCCTA-1	Endo
CAGGGCTCAGAGCCAA-1	Fib
AATGTCGTCGCGATGC-1	Endo
TTGCGAAGTAACTGAA-1	CM
GTAGACTCAAGTCTGT-1	Endo
ACAAAGAGTGAATGTA-1	Endo
GAAAGTACAAGTGGCA-1	vSMCs
ACGTTAGTCCATAGGT-1	Endo
CCACAGGCATGGCCTG-1	Fib
TTTGGTTTCTTAATCC-1	vSMCs
GCCAGCAGTTGGCTTA-1	Endo
TCGGGACTCGCACCGA-1	Endo
CTTAATCTCGTGTGCG-1	Endo
CACTGAAGTATCTGCA-1	vSMCs
GTTACGAAGAGTTCGG-1	Fib
AACCTGATCTGCGTCT-1	Fib
TGTACAGTCCCGGGTA-1	Endo
TAGTCCCGTTGGACGA-1	Pericyte
GCGTTGGAGAACGCCA-1	Pericyte
GGGACCTAGCACCATT-1	Endo
TCCAGAAAGAGAATTC-1	CM
CTCAACCAGGGAGTTC-1	Pericyte
AGTTACGTCTTATCAC-1	Fib
TTGCCCATCGGATAGG-1	Myeloid
CCCGTTACAGCAGGTA-1	Endo
CAAGGCCCAGACTAAA-1	Fib
TTCGGTCAGAGGTGGG-1	CM
TTCTGTAAGTATAGTG-1	Pericyte
TACCTATGTTTGTACG-1	Endo
CAGTGTATCGGGTCCA-1	Pericyte
ACCTGCTTCGTCCCAT-1	Fib
TAACTTCCAGGTTATC-1	Fib
GAGACTTCACGAACGA-1	Endo
GTGTGATAGTTAGAGT-1	Pericyte
ACAAACCAGCTAGTTC-1	Endo
AATGGAATCGGATCGC-1	Endo
TCAATTCCATGGCCTG-1	Myeloid
AAGGTTCCAAGTTGCT-1	Endo
GTTATTCTCGAGGTCC-1	Pericyte
CACCTGTAGTGCTCGC-1	vSMCs
TAACAGCTCGGGAAAC-1	Pericyte
TTACGTTTCTCCTTGG-1	Fib
TGTGTCCCATATAGAG-1	Pericyte
CGCACAGGTGATCAGG-1	Endo
CGTAAACGTAGAATAC-1	Fib
CTCTCGATCGCTATAG-1	Neuronal
CTACAGAAGTCGACCC-1	vSMCs
ATTGTGGGTAACGTAA-1	Fib
GCGATTACACAAGGGT-1	Myeloid
GACTAGTCATTTGGCA-1	Fib
TAGACTGAGAACAGGA-1	Pericyte
CCTCCCTAGGGCTTCC-1	Endo
CTTGCCAAGTCACACT-1	Myeloid
GTTATGGAGGTCCTCG-1	Pericyte
CCCGTTAGTGCATTCA-1	Pericyte
AGGCGTCGTTGCCGCA-1	CM
ATGTCTTTCTTAGTGG-1	Fib
TTCGCGTAGATGCGAC-1	Endo
CAGGGCTCACGCCGAT-1	CM
CCGCATTAGCCATCAT-1	Pericyte
GTCTACCCAAGAGCGT-1	Fib
TGTACGAGTGTCCTTC-1	Fib
TGCACCTCAAGGAGTC-1	CM
AAGGTTCTCAAGGCCC-1	Endo
AACCAACCATTATGGC-1	Myeloid
CAACCAATCCGTTTCG-1	CM
GATCATGCATGCACTA-1	Endo
CCGTACTGTCTGAGCC-1	CM
GTTATTCCATACCCGG-1	Pericyte
GTGCACGAGAAATCTG-1	Endo
TTGACGAGTGCAACAG-1	Fib
TGGGTGCAGATGCGCA-1	Endo
AGTCAACGTACCGGCT-1	Fib
TTGTTCAAGGGCGAAG-1	Fib
GCCCGAACACTGCTTC-1	Endo
TCAGTTTGTTCTACCC-1	Endo
TTGTCTACAACAAACA-1	CM
ACTGCAAGTTTGAAGA-1	Pericyte
ACTCGGGGTACTTGAC-1	Fib
TCAAAGCAGAAATGGG-1	Pericyte
CGCTAGGAGCGATACG-1	Fib
CAACGGCAGAACCATA-1	Endo
ATTACTCGTAGAAAGG-1	Fib
AACATCGCAGGGTAAC-1	CM
TTAGCTTGTTACACTG-1	Endo
GTCACCTGTGAGTCGA-1	Lymphoid
GGCATTAGTGTTTCTT-1	Endo
TCAGTCCGTGATCAGG-1	Endo
TTGCAGATCGGTACTA-1	Endo
CGCAGGTCATTTGTTC-1	Endo
GCATTCCGTTCTGAGT-1	Endo
TCACTCGGTAACCGAG-1	Pericyte
TGATTTCAGTTGACAA-1	vSMCs
CTCAGAAAGTCCGTGC-1	CM
ACAATCGTCGAGAACG-1	Fib
ACCGCAGGTTCCCTTG-1	Myeloid
CTTTGCGCAGGACCTC-1	Pericyte
GCGTTGGTCTCTGCAC-1	Endo
CCTCCCTTCCCGGGTA-1	CM
TCTAGTTCAGATAAGT-1	Fib
CTGGGACAGGGTAATT-1	CM
TGAATCGAGCAGAATT-1	Endo
ATCGAGTAGGGAGTTC-1	Pericyte
GTGGATTTCTGGCCAG-1	CM
CTCACCATCTCGCGGA-1	Fib
TTGCACCAGTGCTGAG-1	Fib
TCACCTGCACCGTCTT-1	Endo
GCCAGCAAGCGGACAT-1	Pericyte
ATCCCTGTCTGTGTCC-1	Endo
AGCCGCAAGTCCTTCC-1	Endo
AGCCAGCAGATGAGGA-1	Fib
GTTCAAGCAAGGCTTT-1	Pericyte
GCGATCGTCAGTCAAC-1	Endo
GGCGAAAAGTGGTGTG-1	Fib
CTGCGTTGTCAGGCTC-1	Endo
TTGCACCTCGATATGC-1	Myeloid
CTTGAAGTCGGTGATT-1	Endo
AGCCTCTGTTACTTTC-1	Endo
GCTGAGCAGAGAGTAG-1	Endo
TTGTCTAAGAAACGCC-1	Fib
CAGTATGCACCGAAAG-1	Endo
TGGCGCAAGGACTTTC-1	Fib
TTAGCTTAGAGCACTG-1	Endo
CAGGATTTCAATGCAC-1	Endo
TAGCCCTAGATGTTGA-1	Endo
AACCTGATCGTCGCAG-1	Endo
CAGGATTAGTAGTCGG-1	Pericyte
CCAGAATGTCGGCTGT-1	Endo
AATACGCGTATGAAGT-1	Endo
GCAGCCAGTGTAGGAC-1	CM
ATGTCTTAGTCTCGAT-1	Fib
ACATGGTCATAGGCGA-1	Endo
GTCCATCGTCATAGCT-1	Endo
GTTATGGCAGGGTAAC-1	Endo
GTGTCCTAGGTTACAA-1	Pericyte
GCTTGCTGTAGTTTGC-1	Fib
CTAGGGCCAAATTGAG-1	CM
GGTACCGTCGCTGATA-1	Myeloid
CTTGAAGGTACGCAAG-1	CM
GTTATGGCATCTCTCG-1	Pericyte
CGTTCCAAGTGTTCCA-1	Endo
TGACTCCTCTCTGAGA-1	Endo
ATCCCTGGTGTGACCC-1	Fib
GGAGAACGTCGACTGC-1	Pericyte
AATGGCTTCTGGCGCA-1	Pericyte
ACTAACGCAATTGTGC-1	CM
GTTACTTGTGTTGGTT-1	Endo
CTCTAGCCATGCCCTT-1	vSMCs
TGCATTTCACGCGACT-1	CM
GAGGCTCCAAACGTTC-1	Pericyte
AGTGCCGGTAACATAG-1	Pericyte
GCTGAGCGTATCTCAG-1	Endo
CATAACGAGGCTTCGC-1	CM
TTACTTGAGGCGACTA-1	Pericyte
CGTGGCATCTTACCTA-1	Endo
AAACTGCTCGCAGATT-1	Neuronal
TGTACGATCTCTGACC-1	Endo
GTAGTACGTGCGCATC-1	Fib
TGTACGACAAGGAGTC-1	CM
TAACGGTTCCGTTTCG-1	CM
TCTCTGGAGATTACGA-1	Endo
ATGTTTCTCATTCATC-1	Fib
TGCATGAAGTTCAAGA-1	Endo
AGCTGGCCATGGATGG-1	Fib
CCTCCCTAGACGCCAA-1	Fib
CTGTTCGGTACGCAAG-1	CM
TTCGATTTCGCAACTA-1	Neuronal
TTTACGTTCGTCCCTA-1	Pericyte
CAGTGCGCAGTGGTCC-1	Myeloid
AACCTTTCATCATAGC-1	Pericyte
GTCACTCCAAATAGTG-1	Endo
TGATCAGTCCATAGGT-1	CM
GTCACGGGTAGTTTGC-1	Endo
CTGTTCGCAGTTCGGC-1	Myeloid
CCCGTTAAGGTTTCTG-1	Endo
ACCAAACTCCCGATTC-1	Endo
ATGCATGTCAGCCGAC-1	Endo
TCAAGACCAACTCAAC-1	Endo
TCACAAGTCGTTCTAT-1	Endo
TGCTCACGTCTGAGCC-1	CM
TAGGTGTCAAAGCTTC-1	Endo
TGGAAGGGTCTAACCA-1	Endo
GTCACCTAGGCTTCGC-1	CM
TGTTAGGAGTGAGCTG-1	Fib
AAACGAATCTCGACCT-1	Pericyte
TAGTCCCTCAAACCCA-1	Fib
GACTAGTTCCACGAGC-1	Pericyte
GTGGCGTCATAAAGTG-1	Endo
CGCGCAATCTCTGACC-1	CM
CAGCTGGGTAGACGCA-1	Fib
TTACGTTGTTGCAGCC-1	Endo
CTTAATCAGACAGCTG-1	Endo
CCACAGGGTAAGTCTC-1	Endo
GGTACCGGTGTCCCAG-1	vSMCs
AAAGGATAGATGGCAC-1	Endo
GCAACCGGTGTGAGGT-1	Myeloid
TACCCTGGTGACGCAA-1	Endo
CATAACGTCGCCACTT-1	Endo
GCAGCCAAGAGGTACC-1	CM
CATTCCGAGTAGAAGG-1	Pericyte
GAGACTTAGCGAATAT-1	CM
CGGTGCATCAGGGTTT-1	CM
GAGACTTAGCGTTAGG-1	CM
CACCTGTAGGACTTTC-1	Pericyte
AGTCCGGCAAGATGCG-1	CM
TCCATCGTCTATTGTC-1	CM
AGGCGAAGTAACACTC-1	Pericyte
TCAGCTCAGGATTTGA-1	Pericyte
GGCGTTGAGACTTCCA-1	Pericyte
GAATCTGCATTTGGTG-1	CM
AAACGAAGTGCCCAGT-1	Pericyte
TCAGCTCTCGCTATAG-1	Pericyte
TGGAAGGGTCTGTGTA-1	Pericyte
CATAACGGTGTCTACA-1	Pericyte
CTAGGGCCAGGCATTT-1	Endo
TCAGGTAAGATATGAC-1	Fib
GCGCCAATCCCTAAAG-1	Pericyte
CAGTGCGCACTGGGCT-1	Myeloid
ATTACTCTCATAGGTC-1	CM
CGGACCACATCCCGGA-1	CM
CCGTGAGAGTAGAAGG-1	Endo
CTGCGTTTCGGATAGG-1	Pericyte
CGCTAGGCATAGCAGG-1	Endo
TAAGTGCAGGCAGTGT-1	Endo
GTCACTCCATCGTACA-1	Endo
TTGTTCACAAGGAAGA-1	Endo
TCACTCGAGTGAGCTG-1	vSMCs
CTGGGACGTAAAGGCC-1	Endo
GAAGTCTAGACTTCCA-1	Pericyte
CGTGGCACATACCCGG-1	CM
TAAACCGCAATGGTCT-1	Fib
ACTTTCAGTTTCTCTA-1	Endo
GCTCCTATCCACGAGC-1	Endo
CCGTGAGTCGTGATAC-1	CM
GCCAGACTCAGTGTAC-1	Endo
AACCTGAAGCGTTAGG-1	CM
GCGAGTCGTAGATTAG-1	Endo
TTCGGTCAGGGCTTCC-1	CM
CGGTGCATCAGGAATA-1	Fib
TGTGACATCCGCCTAT-1	Neuronal
GAGGTCCCACAGTAGG-1	CM
CTTGCTGAGGGACGTT-1	CM
CCTGCTAGTTGCCTGG-1	Endo
TTGCTATTCAGCGGTC-1	CM
GCCCAGAAGACCAATA-1	vSMCs
TTACTTGGTGAATGGC-1	Endo
TAACGGTCATGGATGG-1	Fib
CGTACAACATTGCGAT-1	CM
ACCTGCTGTACTTCGA-1	Fib
ACTTTCAGTCGATAGG-1	CM
AATGGCTGTGTTTCTT-1	vSMCs
CCTGCTAAGCTGATTC-1	Pericyte
AACTTGGAGCCTGGTC-1	Fib
GCTTTCGGTAGTCCAT-1	CM
TTGCTTATCGACTATG-1	Endo
ACTATTCGTCGCTAGC-1	CM
TCAAGACAGCGCGTTC-1	Endo
GATTGACCACGCCGAT-1	Fib
TGATCAGTCGTGGCGT-1	CM
GCCCGAACACAAGTGG-1	Endo
GAACTTGGTTAACCGT-1	Endo
CGCAGGTGTCTGTCCT-1	Endo
AGCTGATAGGGAAGCG-1	CM
TCCATCGCAATCACTG-1	Endo
CCACAGGTCCCGGGTA-1	CM
TCAAGGTAGGGCGAAG-1	vSMCs
ATCCTCGCAGGACCTC-1	Pericyte
CAGTATGTCCCGTAGG-1	CM
GCTGAGCTCCATCTAT-1	Endo
CGCTATCCAATTCGTG-1	CM
GCCCAGAGTCCGTGCA-1	Endo
AACTTGGAGCGATACG-1	Pericyte
TAGCTTTCAATGCATC-1	Fib
GTGCCAGTCGATAGTC-1	CM
GCTCAGGTCTACTGCC-1	Endo
ACCTGCTAGAGGTACC-1	CM
TACGGATCAGGGTAAC-1	CM
AACCTGAAGCGAATAT-1	CM
TTCGATTCACTCGGAC-1	CM
TTGTTCAGTCGCTAGC-1	CM
ACCATCCGTAGTCCAT-1	CM
TTGTTCAAGATGCGAC-1	CM
GATTAGCTCAAAGTAG-1	CM
TGAGCCGAGGCACCTC-1	Endo
GAGTGAGTCTAGCAAC-1	Fib
ATGTCTTAGTCCAGAG-1	CM
GTCCATCCAGTGCTCG-1	Neuronal
CTCAGCTCATTCGTCC-1	Endo
GCTGAGCTCTATTGTC-1	Fib
GAAGTGGCATGGCCGT-1	Fib
GCGGTGTAGTGAAGGA-1	Endo
GCTCGAGCAGCTGATT-1	Endo
CCCTAACGTTAGGAAT-1	Fib
GACTAGTGTTATGCAC-1	Endo
CCGTACTGTACGGATG-1	CM
CGTTCCAAGTCCAGAG-1	CM
AACTTGGCACTGGGCT-1	CM
AGCTGTATCAGCGGTC-1	CM
CACCTTGAGTGGTGTG-1	Endo
CTGTTCGCAAAGACGC-1	Myeloid
CAGTATGAGTTGACAA-1	Myeloid
TCACTCGCACAGTAGG-1	CM
CAATCCCAGGATTGAT-1	Neuronal
TGCCTCAGTAGACACG-1	vSMCs
TAACGGTCAGATTGTC-1	CM
GGAACTTCAAGATGCG-1	CM
TATCGAGAGCACACCC-1	Endo
TACCCTGGTTTGTAGC-1	Endo
CGCTATCCAACTCAAC-1	CM
ATGTCGACAAGCGAAC-1	Endo
GTTGGTAAGGATGTCG-1	Endo
TTCGTTAAGATTACGA-1	Myeloid
ACTACGACAAAGGAAG-1	CM
CGCACAGTCGCATAAC-1	Endo
GCAAAGGTCTCCCTTT-1	Endo
AGTCCGGCAATCACTG-1	CM
AGCCTTCGTCTAACCA-1	CM
AACCAACCAAACCTAC-1	Myeloid
CTGTTCGCAAAGGAAG-1	CM
TCAGGGCGTAGACACG-1	CM
GAGATTCAGCTTCAAC-1	CM
GTTGGTACAGAACAGC-1	Myeloid
AACTGGTAGCTTTCCC-1	Endo
AACAAAGGTGGTAAGC-1	Myeloid
CTGTATTGTTGGGAAC-1	Endo
CTGTTCGCAAGTCTGT-1	Myeloid
TCAAAGCGTCAGTGTT-1	CM
CGGACCACAATGCACT-1	CM
GGCGAAAGTGCCAAGA-1	Endo
GTGTGATAGGAACCGT-1	Endo
TATGTTCGTGATGTGG-1	Endo
CTTGAAGCATTTGGTG-1	CM
CTCCCAATCTTAATCC-1	Myeloid
GTGATCAGTGCATCAT-1	Endo
CAACGTATCCACCTAC-1	Pericyte
CGGACCACACACACCG-1	Endo
TAAACCGTCATTCGGA-1	Myeloid
GGACACCGTATCATGC-1	Fib
CTCGCTACATCAACTG-1	Pericyte
TACCTCGTCGGGAATG-1	CM
TAAGTGCTCTCCAACC-1	CM
AGCCTTCGTCAGTGTT-1	CM
TGGTCAAGTCCGGTAC-1	Endo
CCGTACTGTCGCGCTA-1	CM
AACGGGATCGTAGCGC-1	CM
GTGCACGGTCCAACCG-1	Pericyte
AGTGCGCAGATGAGGA-1	Fib
CAGCTGGGTTCATTTC-1	CM
TATGTGGTCAGCCGAC-1	Fib
CAGTGCGCACATATCG-1	Myeloid
CTGTTCGCACAGTAGG-1	Myeloid
AGCCGCAGTCATTGCA-1	Fib
CGTTCCAGTTGTCGGC-1	Endo
TTCGATTCAGTGGTCC-1	CM
ACGGATTTCGGTTGTA-1	Fib
GTCACAAAGGCTTCGC-1	CM
AACAGTCTCTGTCGTC-1	Fib
TCAAAGCGTCTAACCA-1	CM
CGTTCCACATTTGTTC-1	Endo
