Barcode	cell_type
ACTCGGGTCGAAGCCC-1	Endo
ACATGGTAGCACCATT-1	CM
GCGGTGTAGACTCTTG-1	CM
TTCGCGTTCTGGCTAA-1	Myeloid
CGCAATAAGGCTAAAT-1	CM
CAGTGTATCTCGCGGA-1	Myeloid
ACAAGCTTCTTAAGCG-1	CM
CAACCAACACAGTTAC-1	CM
TGGGTGCGTATTCTGG-1	Myeloid
TCGCCTACAGGATGTG-1	Myeloid
AAACTGCTCAGTACAC-1	CM
TGTGTCCCACACTAGT-1	Endo
TACCTCGAGGGCATTG-1	CM
AGTCCGGAGACGACTG-1	Fib
GCGTAGCCAGTAGGCA-1	Myeloid
AGCTGATCATAGAATG-1	Fib
GTGCCAGTCACTGGTA-1	CM
TCAAAGCAGACGTCAG-1	CM
CACAACACACAGGTAG-1	CM
TAGCTTTGTATCTGCA-1	CM
AACGGGAAGTGAATAC-1	Myeloid
GAGGATGGTGTTGGTT-1	CM
TTCGCGTAGTCGACCC-1	Myeloid
TTGCAGAGTCCTTATT-1	Endo
AAACGAATCAGTGGTT-1	Fib
TCAAGCATCGATTACG-1	Fib
GAGGTCCGTTTGACCA-1	CM
TGCCTGTTCCATCGAA-1	Endo
GCATTGATCACCGCGA-1	Fib
CTAGCGGCAACACGGA-1	CM
AAACTGCAGTTGAATG-1	Endo
GGGAACAAGTTCTCCC-1	Endo
ACATGGTAGTACTCTG-1	Fib
GAACTTGAGTCGAGCA-1	Endo
ATGTCTTGTTTGCCCT-1	CM
CCTAAAGAGTCCAGAG-1	CM
CTGTATTAGTTGGAAT-1	Fib
GGACACCAGCAGGACT-1	CM
TTACGGAAGGTAGGAA-1	CM
TTAGGTGTCTATCTAC-1	Neuronal
TAGCGGCGTGGATTCT-1	Fib
AGGCCCAGTGGTGGTA-1	Endo
TCGCAGGAGTATACGA-1	Myeloid
TTGCTATGTCTGTTGA-1	Myeloid
ACAGAAAAGTAGCAAT-1	Fib
GCCATAAAGCAGGACT-1	Fib
ATCGAGTTCGTTTGAG-1	CM
TTGAGCAAGAAGGGCG-1	CM
TAGCACACAGCACATT-1	CM
GGACACCGTCTCTAAG-1	CM
GTGCACGGTTGGCTAT-1	CM
GTCCATCAGCGATACG-1	Myeloid
GCTTGCTGTGGAAGCT-1	CM
CTTGTCGGTATTCGAC-1	CM
TTGCGAACAAGATGCG-1	CM
GGTCATAGTATTCTTC-1	Fib
ACTACCCTCCGTGCAG-1	Endo
TCACTCGAGAGATTAC-1	Fib
CCCAGAGCACTTATGG-1	Fib
CACCTTGGTCTTAGCA-1	Endo
CTAGCGGAGAAGGGCG-1	CM
GTCGTAATCACATTCT-1	Fib
GGAGGATCACCCATCT-1	Fib
CAATCCCCAGGACTGA-1	Endo
GTTCAAGAGATCTAAG-1	Lymphoid
TCACTCGCAAGACTTC-1	Endo
TCAGGGCGTCTGCACG-1	vSMCs
CTCTAGCAGCAACGGT-1	CM
GTTACGATCACTCCCA-1	Endo
GTTACTTGTCCGTAGC-1	CM
CTGGCAGAGAGGTGGG-1	CM
GGTACCGTCAGTGGTT-1	Endo
GGGTCTGGTATTCTGG-1	Pericyte
CATTGGAAGGTTACAA-1	CM
TAGACTGTCCAGGTAT-1	Fib
TGCCTGTCATCCGTAA-1	Endo
ACTGTCCCACTAGGAG-1	Pericyte
TTCGGTCGTCTGATTG-1	Fib
ACAGAAAGTGTCGTCG-1	Pericyte
GCGCCAAGTAACCGAG-1	Endo
TCGCCTAGTAACGGAC-1	Endo
CTCGCTATCGGTCTAA-1	Endo
ATAGGCTTCGTGAGTT-1	Fib
ATGTCGATCAGGCGCT-1	Fib
AGCCCGAGTTAGGCTT-1	CM
AACCTGATCACGATTG-1	CM
GTGTCCTAGCCGCTGT-1	CM
GCAACCGAGACAGTGC-1	Neuronal
AAGGTTCCACAAACAA-1	CM
AAGGAGCTCCTTTGAT-1	Fib
GGACACCAGACCATAA-1	Myeloid
AGCCTCTTCGTGGCGT-1	Endo
GAACCTAAGCAATAAC-1	Fib
TGGGTTAGTGGATTCT-1	Endo
ATGCATGAGATAGGTT-1	Endo
CCGCATTAGCGTTGCC-1	CM
TTGGTCCGTTAAGGGC-1	Endo
TATGTGGGTAAACGTA-1	CM
CAGTATGAGACGAAAG-1	Endo
TTCGGTCAGGTCGGTA-1	CM
TGCTCGTAGGTGTTGG-1	vSMCs
ACCATCCAGCCATGGA-1	Endo
GTAGGAGTCGCCCTTA-1	Pericyte
ATATTCCTCAGTGGTT-1	Fib
CGTACAAGTTTCTTAC-1	CM
GGATAGGCATGTATCG-1	Endo
ACTGTCCCAGTTCGGC-1	CM
GAAGTCTTCGCTCGGA-1	CM
AAAGGATCAGTATCTG-1	CM
TTCTAACGTTCCTATT-1	CM
TTCTAACAGACACTTC-1	CM
CCAGAATAGTAGTGTA-1	CM
CACCTTGTCCCAATGA-1	CM
CCATACCTCGTCCCTA-1	CM
GTACTTTGTGTGAGGT-1	Fib
CAAGAAACATGCGACC-1	Endo
GTGGATTAGGTCACTT-1	CM
ATTTGTCGTAGGTAAT-1	Pericyte
TGTGGCGAGTCTCTAG-1	Fib
TTAGCTTCACCGTTGG-1	Fib
AAACGAATCGGCAATT-1	CM
CATGCCTAGGTCGGTA-1	CM
TCAGCTCCAAGCCAGA-1	Fib
GAGAACGAGTGCACAG-1	CM
GGTAGGACATCCCAAA-1	Fib
AAACTGCGTGATGCGA-1	Fib
GCACCTTCACCACCAG-1	vSMCs
GGTGAAGTCCCACTAC-1	Fib
ATGTTTCTCAAACCCA-1	Fib
CGGACCATCCAAGAGG-1	CM
TCCGACTAGACCAATA-1	CM
CGATGATCAGTATCTG-1	Fib
GAACGTTAGCCATCAT-1	Endo
CCTTGGTAGTCCCGCA-1	CM
ACAAGCTCACACTAGT-1	Endo
GGCACGTCATCACAAC-1	Myeloid
AAACTCGTCCCGAAGC-1	Fib
CTACAGATCCGGAAAG-1	Endo
GTCGTAAAGAGGAACA-1	CM
TTACTCAGTTCTGAAC-1	CM
GCGCCAATCCATGTTT-1	CM
AGTTACGGTCCCGAGT-1	CM
GCTCGAGAGGTTTCTG-1	Fib
CGAGTTATCCGTACGG-1	CM
CGGACCAGTGCACCCA-1	CM
TCACCTGGTCTGGGAA-1	Myeloid
TGTGACAAGTGAATAC-1	Endo
AAGGTTCTCTGCGTCT-1	CM
AAAGGGCAGAACGACC-1	CM
TGGTCCTAGGTTAGTA-1	Myeloid
TCGGGACAGCCGCTGT-1	Endo
TCCGACTGTAGGGTTG-1	CM
GTAGACTGTACGGATG-1	CM
TCACCACTCCTCCAGT-1	Fib
ACCTGCTAGGCTAAAT-1	CM
CTTAATCCATGCGCTG-1	Fib
TTGCACCTCACTGGTA-1	Fib
ACCTGCTGTTTGACCA-1	CM
TAGGTGTAGTGCAACG-1	vSMCs
GGGTGTCAGAGCGAAA-1	CM
AACATCGAGCCTCGCA-1	Endo
TGCTATTCATCTGCAA-1	Fib
CGTTCCAGTGATCAGG-1	Fib
CCTGCTAGTCAACTAC-1	Endo
CTGGGACCACCGTTGG-1	Pericyte
GTTACTTAGAGGAATG-1	Endo
ACAATCGCATTACTTC-1	Fib
GAGAACGCATGGGTGA-1	CM
ATAGTCGAGAAATTCG-1	Pericyte
GTTACGAGTGAGGGTT-1	Fib
GAGCATTTCGCTGATA-1	Fib
TTGCTATGTCGAGAAC-1	Endo
AATGCCACATCGCTAA-1	Fib
AGGCGAACATAGCAGG-1	Fib
CAAGGCCTCTCTGCGT-1	Endo
TACTGCCCACTTACAG-1	CM
GGAATCTAGAAATGGG-1	CM
TTGTTCAAGGGTGTTG-1	CM
TACCTCGAGACGAAAG-1	Endo
GCACGGTGTCCTCAGG-1	Fib
GTCACTCGTCTAAGAA-1	Fib
TGCACCTTCGAGCGCT-1	CM
GGGCCATGTGTGAGGT-1	Endo
ACTGTCCCAAGCAACG-1	CM
TAAACCGTCGCTACCT-1	CM
AAAGATGCAGTCCTGG-1	CM
TTTGCGCCACATGATC-1	Endo
ACTGCAACATCGCTAA-1	Fib
CCAATGAAGCTAACAA-1	Pericyte
GCGCCAATCCATAACG-1	Fib
CTTGCCAAGGGAGTTC-1	CM
AGGACGATCACTACCC-1	CM
TACAGCACAACTTGGT-1	CM
AAACGAACATAGCAGG-1	Myeloid
AAATGAGGTTAACCAC-1	Fib
ACTAGGTTCTATCTAC-1	Pericyte
TACCTCGAGACTCGGA-1	CM
CTCGCTACAAGCAATA-1	Endo
GAGGATGAGGATTGAT-1	Endo
GAGATTCAGTAACATG-1	Fib
GCGGGTTTCCATTGTT-1	vSMCs
CTCAGCTCATTGCCTC-1	Myeloid
ATGTCGAAGCCAGAAC-1	CM
ACTCGGGCAGGATGTG-1	Fib
TTCTGTAAGAGCCTGA-1	vSMCs
CCCGTTACAGACTAAA-1	Fib
AACCTGATCGATATGC-1	Pericyte
GCTTGCTAGAGGCCTA-1	CM
CAGTGTACAAAGAAGG-1	CM
CTTCCAGAGAACCATA-1	CM
AGCCTCTTCCGAGAGA-1	CM
TAGACTGGTATCTGCA-1	CM
TGACTCCAGTACCCAT-1	Fib
TATCGAGGTTAGGAAT-1	CM
GAATCTGAGTCCGATT-1	CM
GGGTTATTCAGTACAC-1	Pericyte
GTTACGATCAAGTTGC-1	Endo
GTCACAAGTTTCTACT-1	Fib
GACTAACTCCTTTGAT-1	Fib
AACTGGTCACCATTCC-1	Fib
TCGATTTAGGAGAACA-1	CM
GCTTGCTGTTTGCCCT-1	Endo
TGGGTGCGTAATGCCT-1	Myeloid
AACGAGGGTGTCCTTC-1	CM
TCGCAGGAGAGGAACA-1	Endo
AACGTACCATCACAGT-1	CM
CTGTTCGTCGATGCAT-1	Endo
GTAGACTTCGGAAAGC-1	Endo
ACTCGGGGTAGACACG-1	CM
TTAGGTGCATAGAATG-1	CM
TAACTTCGTGGATTCT-1	Fib
AGCCTGGCAGGTAGCA-1	Fib
CCTTGGTTCCCATAGA-1	CM
CTCTCAGGTAGAATAC-1	CM
TGCTCGTAGGATTAAC-1	Lymphoid
GCCCGAATCCTCATTA-1	Endo
CCTTAATTCGTCCCAT-1	CM
TTTACGTAGAAGCCTG-1	Fib
GACCTTCTCCACGAGC-1	Fib
ATCGAGTGTGCTGAAG-1	Fib
TGCCTGTTCTTCCGTG-1	CM
GTGACATGTAGCATGG-1	Fib
CAGGGCTTCGGGAAAC-1	Pericyte
TCCATCGGTACTAGAA-1	Endo
CAGTATGCAATGGTCT-1	Endo
TTGTTGTTCAAACCCA-1	Fib
AGCCTCTCAATAGTGA-1	Pericyte
TTACGGAGTGTTAGAA-1	CM
CTCCCAAGTCTCAAAC-1	CM
ACTGCAAGTATGGGTG-1	Lymphoid
GGAACCCTCGCCACTT-1	CM
AGCCAGCTCTCCCTTT-1	Fib
ACGTTAGAGTTCGTTG-1	Endo
TGGAAGGAGAGGCCTA-1	Fib
TAAGCCACAGAGCCAA-1	Pericyte
GCTGCGATCATTCGGA-1	CM
GTCACCTGTTTCCTAT-1	CM
AGTTTGGTCGGTGATT-1	CM
CTTTGCGGTAACGGCA-1	CM
ATGTTTCAGTCGTGAG-1	CM
TTATGTCCAAGTAACA-1	Fib
CGCTATCCAGTCAGCC-1	Endo
GACCTTCCAAGTCCTA-1	Fib
CGCAGGTCACCACGAC-1	Endo
CTTGAAGTCTCGCGGA-1	CM
ATAGTCGGTGCGCTCA-1	Endo
TGGCAATTCCATTGTT-1	Fib
GAACGTTAGAAAGCAG-1	Myeloid
GATGGCCAGACGAAAG-1	Fib
AGCGTATCACTTGCGG-1	CM
CGATGATGTTTGTGAC-1	CM
CTCAGCTCAATGGTAA-1	Endo
ACAAAGAGTCGGCTGT-1	CM
CGCAATAGTATTCTGG-1	CM
ACCTGCTGTAGTCCAT-1	vSMCs
ATGCATGAGGGTCCCT-1	Pericyte
GGTCATATCCAATCCC-1	Endo
TTCGATTAGCCTGTAT-1	CM
TCACAAGGTAACAATG-1	CM
TCAAAGCCACAGGAAC-1	CM
ATTACCTGTTTAGGAA-1	Pericyte
ATAGTCGAGTGATATG-1	Endo
CGGTGCACATTCACCC-1	Endo
ACAAAGACAGGTAACG-1	CM
ACATGGTAGGATGTCG-1	Fib
TAAGTGCGTAACAATG-1	Endo
TGTGTCCTCGCACCGA-1	Pericyte
CTCAGCTAGTAGGTCG-1	Fib
CAGCCTTTCCCGAAGC-1	CM
GGATAGGTCGCTCTAC-1	Endo
GTAATCGAGGTCCTCG-1	Endo
CATTCCGTCATCGCTC-1	CM
TGTAAGCGTAACCGAG-1	Fib
ACTTCCGAGCATTCCA-1	Endo
GGGTCTGTCCTCCCAA-1	CM
AGGCGTCAGTCTCGAT-1	Endo
GGATAGGTCCAGCACG-1	Endo
CCCTAGTGTGTCCCAG-1	Fib
AAAGATGGTAAGCCTT-1	Endo
TATCGAGTCGGTGATT-1	Endo
TAGGTGTAGACTAGCG-1	Pericyte
ACTAGGTAGGAGTACC-1	Myeloid
ACATGCAAGGCAAGCT-1	Fib
ACTACGAAGCTAACAA-1	Endo
TACTGCCTCTACTTTG-1	Pericyte
TGTGACACACGGCCAT-1	Fib
AGGCCCAGTTACGCTA-1	Endo
AACCAACGTTTGACCA-1	Fib
TCGGGACCAATGACTC-1	CM
TACATTCGTTACCACA-1	Fib
CGTTCCATCTGCTACC-1	CM
TAACGGTTCAGCACGC-1	Endo
GGAACCCAGTCTCTAG-1	CM
ATGCATGCAATGTAAG-1	CM
CTCAGAAAGCTACGTT-1	Endo
GAGACTTTCCAGGTCG-1	Endo
GTAGGAGCAAGCCAGA-1	CM
TAGCTTTGTTGGACGA-1	CM
ACTCGGGGTTATAGAG-1	Fib
CTGTTCGAGCACCATT-1	CM
CAGGATTTCGAGGTCC-1	CM
GGATGAGTCCATCTAT-1	Endo
TCAAGCAGTGCAAGCA-1	Fib
TTGACGACATTATGGC-1	CM
CTCACCATCACCCGGA-1	Fib
TAGGTCATCGGGATCC-1	Fib
TACGCAATCAAACCCA-1	Endo
TCAGGGCGTTCTACGA-1	CM
GCGGTGTTCCCGCAAG-1	Endo
CAGTGCGAGTATCTGC-1	Fib
CTCAGCTTCTATCCTA-1	Pericyte
ACCAAACCATCTCACC-1	CM
TACGCAAGTTCTTTCA-1	Endo
AACCAACTCGACTATG-1	Fib
GGAGAACCAAGAAACT-1	Endo
TCAGTTTTCTTCAGAG-1	CM
CTCAACCCATGCCCTT-1	Fib
GCGAGAATCGCCCTTA-1	CM
GAACTTGTCACTGATG-1	Endo
ATTACTCCATCCTGGG-1	vSMCs
TAACAGCTCGCGCCAA-1	Lymphoid
GATGATCTCTCTGACC-1	Endo
GCGCCAATCGACCCGA-1	Endo
TAGACTGGTTGTATCG-1	Endo
GTAGACTAGATCGAGC-1	Myeloid
GATCGTAGTTTGCGAT-1	Endo
ACCATCCTCCAGGTCG-1	Fib
TAGGTCACAGCTGATT-1	CM
GGTTGCGAGTACAGAT-1	Fib
TACCTCGAGATGTTGA-1	CM
AAACGAACATCTCACC-1	Fib
TTACGGATCAAACCAC-1	Fib
TTCGATTAGTCCTTCC-1	Endo
AACCTTTTCTTCCGTG-1	Pericyte
CAGCCTTGTGTGCTTA-1	CM
AACTTGGCAGTTCGGC-1	Fib
CCGAAGCTCTTTGCAT-1	CM
TGGTCAACATCCCTTG-1	CM
TTGACGATCCCATAGA-1	Endo
AACCGATGTAGGTCTT-1	Endo
GAGATTCGTTCCATCC-1	Endo
CTCAACCGTCTGTCCT-1	Fib
CGCGCAAGTTTGCGAT-1	Fib
CGATGATGTTCTGAGT-1	Fib
GAGCATTAGATGGCAC-1	Fib
TGGTCCTCATTAGCAC-1	Endo
CTTTGCGTCCTAAGTG-1	CM
GTCACTCGTGTGTGTT-1	CM
CTACAGAAGTTACCAC-1	Endo
GAAGTCTCATCGTGAT-1	Endo
AGGCCTGTCTCTCAAT-1	Pericyte
CTGAATGCAATTCGTG-1	Fib
TACTGCCAGAAGACTT-1	CM
CGGACCATCACCACAA-1	Fib
AAAGATGTCGTATAGC-1	Fib
CTTCTAAGTGGTGGTA-1	Endo
AATACGCGTCCTCAGG-1	Fib
AACTGGTAGGCAAGGG-1	Fib
GTTGGGCAGATCTCAC-1	Endo
TCAAAGCTCTGGCACG-1	Endo
CCCACATGTAGAAAGG-1	Fib
TTGTTGTCATATAGAG-1	CM
ATTACCTGTTCTTTCA-1	Endo
ACTACCCTCTTCACTA-1	Endo
TCCATCGAGCAGTAGC-1	Fib
CTGTTCGGTGAGTTGG-1	Fib
GGAGAACCACGGCCAT-1	Fib
TAATCGGTCTCGTGAA-1	Fib
GTGCACGCAAAGCTGG-1	CM
CCCGTTAAGTGATATG-1	Fib
ATCGAGTTCGGGCTCA-1	vSMCs
GCAACCGGTCCTTCAC-1	Neuronal
AGGCCTGTCGGGTCCA-1	CM
CTGAATGGTCATAAGA-1	CM
GGCGTTGAGTACAGAT-1	Endo
CTGGGACTCTTAGTGG-1	CM
GTTACGATCGAACCGC-1	CM
TCAGCTCTCCCGTAGG-1	CM
GCATGATTCTGTTGCC-1	Fib
CGGACTGTCTCTGTTA-1	Endo
AACGAGGCATTGATGC-1	Fib
TTCAACTCACACATGT-1	Endo
AAGGTTCTCTGCTACC-1	Endo
ACAATCGAGAACGCCA-1	Fib
AACCTTTCATACCCGG-1	CM
AAATGCCAGCTCCGGT-1	CM
TTCGGTCTCCATCATT-1	Fib
TAGCCGGTCGCGATGC-1	CM
GATGGCCCAAATGCTC-1	CM
TTCTGTAGTCGTCGCA-1	CM
AACCTGACAAGCTTTG-1	CM
TCAATTCCACTTACAG-1	Fib
AGCCCGATCATTCATC-1	Fib
TAAGCCAGTATCAGCT-1	CM
ACAGCGCAGGAAACTT-1	Fib
CCTAAAGTCGCCACTT-1	Endo
ACCGCAGGTTGGCTTA-1	Fib
ACGTGGCTCAGTGGTT-1	Fib
TGCACCTTCACCACAA-1	Endo
GGGACCTAGAGAATTC-1	vSMCs
GACCCAGAGTGGACGT-1	CM
CGCGCAAAGGCGTCCT-1	Fib
GACCAATCAACGTACT-1	Endo
GCCTACTTCCTTGACC-1	Pericyte
GCGATTATCTCTTAAC-1	CM
GTTACTTTCACAGGGA-1	Fib
TATCGAGTCCTATCAT-1	CM
GATGATCAGATGGCAC-1	Fib
CGTACAAAGTCTTAGC-1	CM
GGAATCTGTATTTGCG-1	CM
TCGATTTGTCCAACCG-1	Fib
GAAGTGGGTAGATGAT-1	Fib
CCCTGATTCTAAACGC-1	CM
TAACGGTAGTGCAACG-1	Endo
ACTAGGTAGTACCCAT-1	CM
CACTGAAAGAGAATTC-1	Fib
AACAGTCGTGCACATT-1	CM
AACGTACAGGCACTAG-1	Fib
AAGGAGCAGTCAGCCC-1	Fib
GCATTGAAGATTCCGT-1	Fib
TAAGTGCCACCTACCT-1	Pericyte
GCCAGACCATTACTCT-1	Myeloid
CAGTGTACAATGGTCT-1	CM
GCTCAGGGTATGGATA-1	CM
AGGCGTCGTGATAAGT-1	Endo
CCAGATATCTATTTCG-1	Endo
TCAGTTTAGGGTATCG-1	CM
CATGTTTTCGCTTACC-1	Fib
AACGTACCAGGATAGC-1	CM
CTGCGTTGTCTGGATT-1	Endo
ATAGGCTAGAGAGTAG-1	Fib
TAGCTTTTCCTCTCTT-1	Lymphoid
TCACAAGGTGACGCAA-1	Fib
AGTCAACCAGGACCTC-1	Endo
TAGCTTTCACATCATG-1	Fib
CCCGTTAGTGTCCCAG-1	Fib
GTGGATTTCTGGACAT-1	Fib
ACGTTAGTCAGCACTA-1	Endo
AATGGCTAGTCTTAGC-1	Endo
ATGTTTCTCCGATGCG-1	Fib
GGTACCGCACCAAGGA-1	CM
TGAGCCGGTCTGGTCG-1	Endo
TTGCACCTCTTAAGCG-1	Fib
CTCAGAAAGAGAACCC-1	Fib
ATTGTCTCAGGATGTG-1	Fib
TCACCACCACGCGCAT-1	CM
ACAAAGAGTCACATTG-1	Myeloid
AACAAAGGTACGCAAG-1	Endo
AATACGCTCAATTCCT-1	Myeloid
AATGCCAGTGAATACA-1	CM
GACCTTCGTGCTTTGA-1	Fib
TGCATGAGTCACTCTC-1	Endo
ACTGCGGAGGCGATTG-1	CM
AAAGGATGTCACAGGA-1	CM
AATACGCTCATCATGG-1	Neuronal
GGTAGGATCCATGACA-1	CM
GTGTGATAGTAGCAAT-1	Fib
ATTTGTCTCTGGACAT-1	Fib
TAACAGCCACATTCTT-1	Pericyte
AACCGATCAAGTTGCT-1	CM
TCACAGACAGGCAAGT-1	Fib
TTACTCAAGAACCCGA-1	Fib
TATGTTCGTGTGTGTT-1	Fib
GGGACCTAGATCCGAG-1	Pericyte
GCCATAAGTAGCCATT-1	CM
TTGTTGTTCCGGCTGA-1	Fib
TTCGTTATCTTTCGAT-1	Neuronal
CTTGTCGCAGCTGATT-1	Endo
ATTGTGGGTTTCTACT-1	Lymphoid
GCACCTTGTGATGCGA-1	CM
GTGATCAGTGAGTCGA-1	Pericyte
TGATGCAGTACGGATG-1	Endo
ACAATCGTCACTGATG-1	CM
AGACAAAGTATCATGC-1	Fib
GGAGTAGCACTCCTCA-1	Fib
TTGCGAAAGAAGCCGT-1	Fib
TGCGTAAGTGCTTGAT-1	Fib
CAACCAAAGTCTGTGT-1	CM
TTTACGTAGGTCGGTA-1	Endo
TCAAGCATCCATAACG-1	Lymphoid
TACATGGGTATCACAC-1	Lymphoid
GGACACCCATCATAGC-1	CM
CCCTCTCTCCTTGACC-1	CM
TCAGCTCCACTGATAC-1	Endo
TTGTTCAAGTCCGTGC-1	Endo
GTCTACCGTAGAACGC-1	Fib
TACCTATTCTTGTCAT-1	CM
TGTAAGCTCCCGTAGG-1	CM
GGAATCTAGAGGAATG-1	Fib
TACATGGGTCATGAGG-1	Fib
CTGTATTTCCACTAGA-1	Fib
CTGCGTTGTGTGCTTA-1	Fib
TTCGCGTAGTGCTGAG-1	Fib
AACCTGATCGGTCTAA-1	vSMCs
AGCTGTAGTCCAAGAG-1	Endo
CTGAATGTCGCAAACT-1	CM
GACCAATAGTTACCAC-1	Endo
TCAAAGCTCGATAGGG-1	Fib
ATATTCCGTTACCCAA-1	CM
GAGCATTGTATCAGCT-1	Fib
GCGATCGCAAGCACTT-1	Fib
AACGGGAAGGTTTCTG-1	Endo
GTGGCGTTCACATTCT-1	Fib
AGTTTGGCAATGGCTT-1	CM
TTACCGCTCCATAGGT-1	CM
GAACCTACAGGTCCTG-1	Fib
CGTACAACATCTCTCG-1	CM
TAAACCGGTTCCAATG-1	Endo
GACTAACTCACATTCT-1	CM
GCTCAGGGTACGCAAG-1	Fib
TAGCTTTCAGAATGCG-1	Endo
GGATGAGAGGGCTCTC-1	Fib
TAACTTCAGGAGAACA-1	Lymphoid
GAAACAAAGTACAGTA-1	CM
TACCCTGAGGAAACTT-1	Endo
CAGCCTTCATTTGGCA-1	Fib
TTCGCGTTCTGTCGGG-1	Fib
TGCCTCAAGCATGATA-1	Fib
GCGGGTTGTCCACCAG-1	Endo
TTGTCTATCGACTTAG-1	Fib
GCGAGTCAGACTCGGA-1	Endo
TTCAACTGTGTTGTTG-1	Fib
GCATTGATCGCTTCAC-1	Fib
CCTGGGACAAGCCCTG-1	Endo
CCCACATGTAACGTAA-1	CM
GCGGAAAAGTGTCACT-1	Endo
ACGTTAGCACTCCCAT-1	Fib
AGGCCCACAAACAGTA-1	Endo
CACTAAGCAGAACAGC-1	CM
TAACAGCCATCCTCGT-1	Fib
AACCAACAGAAATTCG-1	Endo
AACTGTGAGCTGCCAC-1	Myeloid
GCGGTGTAGAACGTCG-1	Fib
CTACTTACATTGCACA-1	Fib
TTGCGGGGTCGCTACG-1	Endo
ATCCTCGTCATTCTTG-1	CM
GCCAGACAGGAGTAGA-1	Fib
AGCTATGAGACTAATG-1	Myeloid
AGTGTACCATCGTGAT-1	Endo
TTGAGCATCACTGGTA-1	Pericyte
TTAACGGTCAGTCACA-1	Endo
TCGAGCGTCTGAGTCA-1	Endo
AATACGCCATCGCCTT-1	Myeloid
GTTCAAGAGTGTCGCC-1	Endo
ATGGATCGTACGCAAG-1	Endo
TGGGTTATCAAACCAC-1	Fib
CGCTGGATCAGGAATA-1	Fib
ATTACCTCATCACAGT-1	CM
AGCCAGCGTAGTCCAT-1	Fib
TGTACAGGTTTGCCCT-1	Fib
TAGGTCACACTCGTGG-1	vSMCs
TCAGGGCGTTTAGGAA-1	Fib
CCCTGATAGTCAGGAC-1	CM
GTCACCTAGAGAGGTA-1	CM
CACCTGTCACATATCG-1	Neuronal
GCTGCGATCTCCTTAA-1	Pericyte
AAAGATGCATGATTGC-1	Fib
GGTGTCGAGCAACGGT-1	Pericyte
GCGTAGCCACTCGTGG-1	Endo
CATTGGAAGCGGACAT-1	Fib
TCACTCGGTGATGCTT-1	CM
CATTCCGAGTGGGACT-1	CM
TACCTATTCGTTGTAG-1	Endo
ATAGTCGCAGCGTACC-1	Fib
TGTGACACACAAACAA-1	Endo
TGGACATTCTAGCAAC-1	Fib
AGATTCGCAGGAGCAT-1	Fib
GCACCTTCACGCGCAT-1	Lymphoid
AGGCCCATCTCCTTGG-1	Endo
CACAACATCTTACCTA-1	Endo
AACTGGTAGTGCCCTG-1	CM
AGCTGATAGTTAGAGT-1	CM
TTACCGCAGTCGAGCA-1	Endo
CCAATGAAGGTTCGTT-1	Fib
AAAGATGGTCGCGCTA-1	Myeloid
GTAGACTGTATCTCAG-1	Neuronal
CTGAATGGTACTTCAG-1	CM
TTCAACTGTACTAGAA-1	Fib
GCGAGAAGTCGAGGAT-1	Pericyte
AACGGGACAGATTTGC-1	Myeloid
CGCTATCTCTCTGCGT-1	CM
TTACTTGGTGAATCAA-1	Fib
GTGCCAGAGTACCCAT-1	CM
TTCGATTCAGGTAGGT-1	Endo
GGGTGTCCAATGTGCT-1	Endo
CACATGACATGTATCG-1	CM
GTTACGAGTGCATTGT-1	Endo
ATTTGTCCACTTTGGA-1	Pericyte
GCGATTAAGCGAATAT-1	Fib
AACTGGTGTCAGTGCC-1	Fib
ACTTCCGGTATCTCAG-1	Pericyte
GGAACCCAGATTGACA-1	Fib
CACAGATTCCCGAAGC-1	CM
TAACAGCCACTGATTG-1	Endo
CCAGATAAGTCAGCCC-1	CM
CCCTAACCACGCGTTG-1	Endo
TTAGCGATCGGTCCGA-1	Endo
CAAGCTACAAGCAATA-1	Fib
CATTGGAAGAAAGGGT-1	Fib
AGTGCCGGTCCAGACC-1	Endo
ATGTTTCCATTCTCGC-1	Fib
CTCGCTACAGCTGATT-1	Fib
GTTACGAAGCTCGGCT-1	Neuronal
ATGCATGTCATCGCCT-1	vSMCs
TGACTCCCAAGTCTGT-1	CM
AAAGATGGTCTGGGCT-1	Fib
CAGTGCGGTAGAACGC-1	Endo
GAAGTCTAGATATGAC-1	Endo
TGAGTCATCGTGGTAT-1	Endo
AAAGGATGTAGCGAGT-1	CM
CCCAGAGGTTGCAGAG-1	Fib
ATTTGTCGTCATCAAC-1	Pericyte
TAACAGCTCACAACAC-1	Endo
TGGCAATCATCACAAC-1	CM
GAAGAGCAGAGCGAAA-1	Pericyte
GCAAAGGAGATATGTG-1	Fib
TAGGTCATCTTAAGCG-1	CM
GTTGGGCGTCCACCAG-1	Fib
CTCACCAAGCTGAAAT-1	CM
CAATCCCGTTAGTAGA-1	Endo
AGCCTTCTCCCATAGA-1	Fib
GAACCTATCTTTGCAT-1	Myeloid
AGTGTACGTCTGCACG-1	Pericyte
TCCAGAATCAGTCTTT-1	Fib
CTGTATTGTGTCTACA-1	Fib
GTAGTACCAACATAAG-1	Pericyte
ACAGCGCGTGCGTTTA-1	Pericyte
GCTTAAGTCGTTCCGT-1	Fib
GTGACATCACTCGCAG-1	Pericyte
CCGCATTCACAGAAGC-1	Fib
GCAGCCAAGCGTTAGG-1	CM
TTGCAGATCCATTGTT-1	CM
CCATACCCATCCTCGT-1	CM
ACAAGCTCAACTCGTA-1	Fib
TAGCTTTGTCAGGTGA-1	Fib
TGCCTGTCAATAGCGG-1	Fib
TGGCCTTTCGCGCTGA-1	Fib
GTGACATCACCTGAAT-1	Fib
TTGCACCCACCGATCG-1	Endo
CGCAGGTTCTATCCTA-1	Fib
GAGTGAGAGTGGGACT-1	Fib
AGTCAACTCGCTTACC-1	Endo
GGTGCTGGTCACCGCA-1	Fib
CCTGGGACATCACAGT-1	CM
GCAGCCAGTACCTATG-1	Fib
CTCAACCCACATATCG-1	Fib
AGCGTATTCCGATGCG-1	Fib
AATGTCGGTGCTAGTT-1	CM
CCCTAACGTACGAGAC-1	Endo
CGAGTTACATTACACG-1	CM
GACTAGTGTGCATTGT-1	CM
GCACGGTAGGAAGGTA-1	Endo
ACAGACTAGAGAGGTA-1	Endo
GGTGAAGGTTCCCAAA-1	Endo
AGCCTGGGTGGAAGCT-1	Fib
AATGTCGGTTGGCGAA-1	CM
AACTGGTTCTGAGTCA-1	Fib
AGCGATTCAGAGCCAA-1	Endo
GAATCTGAGGAGGCGA-1	Endo
GTTACGAGTTCGGGAA-1	Fib
GCGCATGCATGACTGT-1	Pericyte
GCTGAGCCATCCTCGT-1	CM
ACAAAGAGTATACGCT-1	CM
TACATGGCACAAGTGG-1	Endo
TGGTCAAAGTCCCTCT-1	Fib
TCTATTGCAGCGTAGA-1	Pericyte
TAAACCGAGACAACGC-1	Fib
TGGCAATAGGGTATCG-1	Fib
CGGACCATCGCATAAC-1	Pericyte
CCTTGCACAACTCGTA-1	Endo
TCACCACTCCTGACCT-1	Fib
CAACGGCTCCACACCT-1	CM
ACTACCCCAACGGGTA-1	Endo
GTGATCAAGATTACGA-1	CM
TCCAGAAAGGCTCAGA-1	Fib
GTGTCAAGTCGCTACG-1	Endo
CCTTAATGTAAACGTA-1	Fib
CTCTACGGTAGTCCAT-1	Endo
AGCTGTATCCCGATTC-1	CM
GAATCTGTCCTAAGTG-1	CM
CAACGGCAGGCCTCTG-1	CM
TGTGGCGAGCATGTGG-1	Endo
CAATCCCCAAGCAACG-1	Fib
GGTAGGAAGTTGGAAT-1	Fib
CCCAGAGAGTGAGCTG-1	Pericyte
TATGTTCCAACTACTG-1	CM
CTAGGATAGGCACCTC-1	Fib
TCTATTGGTACTATGC-1	Endo
TGCTTCGGTCCTTCAC-1	vSMCs
AGCTGATAGCGCCTAC-1	CM
CACGTTCTCTTACCTA-1	Fib
GGAGAACTCCATAACG-1	CM
TCAAGACAGGAATGGA-1	Fib
TTACCCGGTAAACGTA-1	Fib
ACATGGTAGCGGACAT-1	Fib
GAGCATTTCGATAGCT-1	Endo
TGAATCGCATTACTTC-1	Myeloid
CCAGATACACGACGAA-1	Endo
ATATTCCGTTTGACCA-1	CM
AGATTCGAGCGTATCT-1	Pericyte
GGTCATATCACACGTA-1	Endo
GATGATCTCTATTTCG-1	Endo
ATCGAGTCATCACAAC-1	Endo
ACCGAATCACAAACGG-1	Fib
GCCTACTAGTCCCTCT-1	Endo
AGCGTATGTCCCGAGT-1	Endo
GGGCCATTCGCCTTAC-1	Endo
CGTGGCAAGAACTAAC-1	Fib
TTGCACCGTCACTCTC-1	Endo
TGCATTTAGGGAGATA-1	Fib
ATCGAGTTCTTGTACT-1	Endo
TATGTGGTCACTCCCA-1	CM
TAATCGGCACGTTGTA-1	Fib
GCCCGAACAAATTGAG-1	Endo
GAAGAGCGTAATGCCT-1	CM
ATAGTCGCATCTCACC-1	Endo
CATTGGATCCAGGCCA-1	Fib
TACGCAATCGTTCAGA-1	Endo
TTCTAACCAAGCGACA-1	Fib
GAGAACGAGTACTCTG-1	Fib
GTGTGATGTTAAGTCC-1	Pericyte
TATGTGGTCCGGGCAT-1	Endo
CCTGGGACATCTCACC-1	Fib
AGTCCGGGTCAAATCC-1	Fib
TGCTCGTAGCTAGTTC-1	CM
ACAAGCTAGGTAGGAA-1	CM
AAATGAGAGTTCGCGC-1	Myeloid
GCCTACTCATCCTCGT-1	Endo
ATGTACGCAATCAGGG-1	Endo
GCTGAGCGTAAACCCT-1	Lymphoid
GAAACAATCAGGAATA-1	Fib
TGCATGATCGTTGTTT-1	vSMCs
TCCAGAAAGTGAACCG-1	Endo
GGAGAACGTGGAGTGT-1	Fib
GACTAACTCGGCTATA-1	Fib
TGCTTCGGTGGTCGAA-1	Fib
TCTCTGGAGTGAGTGC-1	Fib
ATCCCTGTCTTCGTTA-1	Fib
TTCGTTACAAGTTGCT-1	CM
ACTTTCATCTTGTCGC-1	Fib
TCAAGCAAGGAATGGA-1	Endo
GCATGATCAAATTCCG-1	Fib
TAGGAGGAGGCTTAAA-1	Endo
CTTGCCAAGAGCCTGA-1	CM
CCAGAATTCTGAACGT-1	Endo
TACCCTGCATCAACTG-1	Lymphoid
TCAGCTCAGGTCCTCG-1	Fib
GACTAACTCTTGTCAT-1	Endo
AGCTGGCAGAACTAAC-1	Endo
GGAGAACCACTTGCGG-1	Fib
AACCTTTCATTTCTTG-1	Endo
TTACGGAAGCTACGTT-1	Endo
TCCAGAATCAAACCAC-1	Myeloid
CAGGGCTAGAGAACCC-1	vSMCs
TTGCTATAGTGCTCGC-1	Fib
ACTGTCCAGTTCAACC-1	Endo
TTCGCGTAGATATGTG-1	Endo
CTCAGAACAGGAGCAT-1	Fib
TTGACGATCTTCTTCC-1	Fib
TAGCACATCCAATCCC-1	CM
ACCGGGTGTCCATTGA-1	Endo
CAACCAAGTGATTCCA-1	Fib
TCCATCGAGCCTTTGA-1	CM
CATAACGCATTGTTCT-1	Pericyte
CTCAACCGTAACCCAT-1	Fib
TAGCATGGTGACGCAA-1	Pericyte
GCGAGAAGTATCAGCT-1	Fib
CCTTAATTCCGGACTG-1	Fib
GAGTGAGAGCTGAGGT-1	Endo
ACTAGGTCATTAGCAC-1	Endo
GTCACAAGTAGCAGCA-1	Fib
CTGGCAGGTGTTGTTG-1	Lymphoid
GTCACGGCATCCGTAA-1	Fib
ACCAAACAGAAAGGGT-1	CM
TGCTATTTCTGTTGCC-1	CM
GCTCGAGGTATGGATA-1	CM
AGGCCCATCAGGTCTA-1	Endo
TTCTAACAGTGAGTGC-1	Fib
ATAGTCGCAACGGACA-1	Endo
ACCGAATAGCAGGAGG-1	Endo
GCGGGTTAGGATTGAT-1	CM
GTCTACCAGCAGGACT-1	Fib
TCGATTTGTGCCAAGA-1	Endo
CCGCATTCAGATAAGT-1	Fib
GTTATTCTCCTTTGAT-1	Fib
TTCATCATCTCCAACC-1	CM
CTCATGCCAAGGCGTA-1	Myeloid
GTCACCTTCTTTCGAT-1	Endo
TTCGCGTAGGGCATTG-1	Fib
CCCACATAGACTCTTG-1	CM
TGGGTGCTCTAGCTGA-1	Endo
TTCATTGAGCCGCTGT-1	Endo
CTCATGCTCGCTCGGA-1	Endo
GTGCCAGCAGCGCGTT-1	CM
ATTTGTCCACCACGAC-1	Neuronal
AATGCCACAATTGTGC-1	CM
TGCTTCGGTAAAGCTA-1	Myeloid
GCATTGATCTGAAAGA-1	CM
CCAATGAGTTCCCTTG-1	Fib
AACTGGTGTGCAAGAC-1	Fib
GAAAGTACATCTCACC-1	Endo
GTTATTCTCGGGATCC-1	Pericyte
TATCGAGGTAACGGTG-1	Fib
CCAGATACAAGGTTCT-1	Fib
TGCACCTCAAACCGAG-1	Fib
ACTGCAAAGCTTTCCC-1	Fib
CAGCTGGGTGCTGTCG-1	Endo
ACCTGCTGTCATTGCA-1	Fib
ATGTACGGTTGGACGA-1	Fib
GTACTTTCAGTGGTCC-1	CM
AGGCGAAAGAGGTGGG-1	Fib
CCTCCCTTCCCAGCGA-1	Fib
TTTACGTAGTTGTCCA-1	Endo
TAGCATGCAATGCACT-1	Fib
CTGCTCACAGCTATAC-1	vSMCs
GAGCGCTAGTCTGTGT-1	CM
GAAATGAAGGTTGACG-1	Fib
TACGCCTCAGTAACGG-1	CM
GGTGTCGAGCTATCCA-1	Fib
GCGATCGCAAGGAACC-1	Endo
GGGACCTAGAGAGTAG-1	Endo
TAGCCCTTCCAACAAC-1	Fib
TGCTTCGGTATTCACG-1	Endo
CCTCCCTAGATCGATA-1	Endo
TGGGTTAAGGGAAATG-1	Endo
CGTTCCAGTCATTGCA-1	Myeloid
CGTACAACACTAAACC-1	Endo
CCATACCCATAGCAGG-1	Endo
GTCACCTAGCTGCTCG-1	Fib
GTGTGATTCAAGAGGC-1	CM
GATTGACAGTAATCAG-1	Endo
ATCCTCGGTACAACGG-1	Pericyte
AAGATAGCAACATAAG-1	Fib
ACTAACGCAACGTCCG-1	Fib
CCACAGGAGCGATACG-1	Endo
ATAGTCGCAAGGATGC-1	CM
AAAGGGCTCACAACAC-1	Fib
AACGTACGTAATGTAG-1	Fib
CAGTATGCAACCTCCT-1	Fib
AACGAGGGTCTCTAAG-1	Endo
ACAGAAATCTAGCAAC-1	Endo
CTGTATTGTGGACGAT-1	CM
GCACCTTGTTGCAGAG-1	Fib
GCGTTGGGTGTGTGTT-1	Endo
GTCCATCTCTGAAAGA-1	CM
TACATTCCAGGAGCAT-1	Fib
AATGGCTGTCAGTGTT-1	Fib
GCGTTGGTCACATCCC-1	Endo
TTTGGCCAGCCGCAAA-1	Endo
TTTGGTTAGGTAGGCT-1	Fib
GAGTGAGAGGAAACTT-1	Neuronal
ACAGCGCCATGATTGC-1	Pericyte
CTTGCCAAGCTACGCC-1	CM
TGCTTCGCATGACTGT-1	Fib
CAGCTAAAGAGCTGTG-1	Pericyte
CTCTCGATCGGGAAAC-1	vSMCs
ATGTACGAGGGTTCTT-1	CM
TGTGGCGTCCGGAAAG-1	Fib
CATTCATAGGGACGTT-1	Endo
TGTTAGGCACGGCCAT-1	Endo
TTGAGTGTCCTTCGAC-1	CM
GAGAACGAGGAATGGA-1	Endo
GTACTTTTCGGTCTAA-1	Fib
TGCTTTAGTTTGATCG-1	Endo
CGTAAACCATATTGGC-1	Endo
GCAGCCAAGTAATCAG-1	CM
CTCTCAGAGCTATCGT-1	Fib
CCCTAGTGTCAAACAA-1	Fib
GAGGCTCCAACGTCGC-1	Fib
AGTTTGGAGTCGTATC-1	CM
AAGGTTCGTTCCCAAA-1	Fib
GAAGTCTAGCTCGGCT-1	Neuronal
TTCGTTACAAGCAGGT-1	Fib
GGAGTAGAGGTCCTCG-1	CM
GAGGCTCTCACTAGGT-1	Fib
CCTTAATAGTCCGATT-1	Fib
ATCCTCGCAAGCCAGA-1	Lymphoid
CTTCCAGGTTATGCAC-1	Fib
TACCTATCAGCAAACG-1	Pericyte
ATGTCTTGTGCACTTA-1	Lymphoid
GAGACTTCAGGTAACG-1	Endo
GAACTTGGTAACATAG-1	Fib
AAACTCGCATTCCCGT-1	Endo
ACAGGCCGTGCAAAGC-1	CM
CTCTAGCCACTACACA-1	Fib
TCGCAGGTCCAGGGAA-1	Endo
TCGCAGGTCGGTCTCT-1	Fib
CACCACTCATACTGCA-1	Endo
CAGCCTTAGTTCCCGG-1	Fib
CAGCCTTCAAGGAACC-1	Endo
CGCTGGATCCATAACG-1	Endo
AACAGTCAGACAGCTG-1	Endo
GCGAGAACAGCTATAC-1	Endo
TTCTAACAGGGAAGCG-1	Fib
TGAATCGGTTATCGAC-1	Endo
GGAGAACCAACTCCCT-1	Endo
GGAATCTGTCTGGATT-1	Endo
ACAGCGCGTATGGGTG-1	Endo
GAAACAAAGGTTCGAG-1	Myeloid
TAACAGCAGGCTAAAT-1	Endo
CTTTGCGTCGCTATAG-1	Endo
ATGTTTCGTAGCATGG-1	Endo
CCTAAAGAGATCTCAC-1	Fib
GCGATTATCCCAGCGA-1	Endo
ATTACCTGTAAGGTCG-1	Fib
AACTGGTGTCTCTGCT-1	Fib
ATGTCTTCAAGCGTCC-1	Fib
TACCTATGTCAGAGTG-1	Endo
GCGGAAAAGCATTGGG-1	Fib
GTTACTTCAGCTATAC-1	Endo
CGGTGCAAGTTACCAC-1	Fib
TGTGTCCCACTGATTG-1	CM
AGCCGCAGTTGTGAGG-1	Endo
GCCCGAATCTCGACAA-1	vSMCs
TGACTCCTCGCTCTAC-1	CM
ATGGATCAGTATACGA-1	Fib
CTTTGCGAGCTTACCA-1	Endo
TCTCTGGTCGCGTGAC-1	Fib
CATTCATGTCAACAGG-1	Endo
ATTCGTTAGGAGACTC-1	Endo
TGATCAGGTACCTATG-1	Myeloid
CCTAAAGCACAATAAG-1	Endo
GCTTAAGGTAAAGCTA-1	Endo
ATCCCTGTCCCAATGA-1	Fib
GGTGCTGAGGCCTAAG-1	Fib
CTCCCAAAGATATGTG-1	Endo
CTACAGAGTAACTGAA-1	Endo
TGTGACAAGCCATCAT-1	Endo
CAAAGCTTCACTAGCA-1	Pericyte
ACAATCGGTCGATAGG-1	Fib
TCGAGCGGTGATCAGG-1	Endo
TGATTTCCAAGACTAA-1	Fib
TCACCACAGAAATGGG-1	Fib
AGCCGCATCACTCCCA-1	Endo
GAATCTGCAAACAGTA-1	Endo
TAAGTGCAGTAGCAAT-1	Endo
TATTGCTCAGGACTGA-1	Endo
TTACCCGGTGTAGGAC-1	Lymphoid
TAGCACATCAGGAATA-1	Endo
TTTGTGTCATTAGCCA-1	Fib
GCCCGAATCCAACGCG-1	Fib
TTCGCGTCAGGACTGA-1	CM
GGGAACACATTACCTT-1	CM
CTCACCATCGTCTAGA-1	Lymphoid
TCACCTGGTACTTGAC-1	CM
GAACTTGGTGAGGGTT-1	Endo
GCGTTGGAGCAACGGT-1	Endo
TTAGCGAGTAGAGAGA-1	Endo
CCACGTTTCCCGTAGG-1	Fib
TAAGTGCCAGGGTAAC-1	Pericyte
GACCAATCACGACGAA-1	CM
TACTCGCGTGGTAGAC-1	Endo
TCTATTGAGCAGAAAG-1	Endo
ATATTCCCACACATGT-1	Endo
CATGCCTAGTGATCTC-1	Pericyte
CTCAGCTAGAGAGGTA-1	Endo
TAGCCCTTCTCTGAGA-1	Fib
CGATGATCAACTAGAA-1	Fib
GAGCATTTCCAGGCCA-1	CM
TGCATTTTCATCATGG-1	CM
ACTACCCGTCTGCACG-1	Endo
GCATTGATCGTGTGCG-1	Fib
TGGCCTTAGGCTCAGA-1	Endo
ACCGAATGTACCGGCT-1	CM
CTTTGCGTCCCGTAGG-1	Endo
GCAGCTGAGATCGATA-1	Fib
GATTGACGTTACGCTA-1	CM
GAGACTTAGCCCATGC-1	Myeloid
CCACGTTAGCCTCGCA-1	Endo
GCTTAAGTCTCATCCG-1	Fib
GTTATGGCATCATCGA-1	Fib
AAACTCGCACTCCTCA-1	Endo
TCAGTTTGTGACAAGC-1	Pericyte
CGTAAACTCCGTCAAA-1	Endo
GGGTGTCAGGCACCTC-1	Fib
GGAACCCGTGCATTCA-1	Fib
CCCTGATTCGCGCTGA-1	Endo
GGGACCTGTAGTTTGC-1	Pericyte
CTAGCGGAGACCAATA-1	Endo
TAGGTGTCAGAAAGAG-1	Endo
GCACCTTGTCCAAGAG-1	Fib
AGGCCTGTCTTGCGCT-1	Endo
CAATCCCTCGCCTTAC-1	Fib
ATGGATCTCGCACAAT-1	Fib
AGGCCTGCACATCATG-1	Endo
GATTGACCAAGCAATA-1	CM
TACCTCGCAAGCAATA-1	Myeloid
TACCTCGGTAAAGGCC-1	CM
ACTAACGGTACGGTTT-1	Endo
GACCCAGAGGTAGGCT-1	Fib
GAGGTCCTCTCTGCGT-1	Fib
GCACGCAGTTTGCCCT-1	Endo
GCCTAGGTCGTGTGCG-1	Endo
TTAGGTGAGAGAGTTT-1	CM
AGCTATGCACCGTTGG-1	Endo
AATGCCATCCGAATTG-1	Pericyte
TGGCGCACAATGATGA-1	Endo
TGGTCCTTCCACGGCA-1	Endo
CGGACCATCCAGAGAG-1	Endo
GCGATTACAGTAACTC-1	Endo
TCAAGCATCCGAGAGA-1	Endo
TTGACGACAAATAGTG-1	Endo
GGCGAAAAGTTCTCCC-1	Pericyte
TCACCTGAGGGTCTGA-1	Endo
ACCTGCTGTATTTGCG-1	Endo
GTGTCCTAGGGCGAAG-1	vSMCs
GCTGTTCGTCCCTTTG-1	Myeloid
GAGAACGTCAGTGGTT-1	CM
GCATGATAGAATGCTA-1	Neuronal
TAATCGGTCCATAGGT-1	Pericyte
GTGTCCTCACTTACAG-1	Pericyte
ATTGTCTCACAGTTCA-1	Endo
CGTACAACAAGCCCTG-1	Pericyte
GGGTCTGGTGAATCAA-1	Endo
GAGCGCTAGGATATCA-1	Endo
TCTAGTTGTTCTTTCA-1	Pericyte
TGCTTTACATCTGCAA-1	Endo
ATATTCCTCGGTTAGT-1	Endo
AGCGTATAGACCAATA-1	Fib
GACCGACTCAGGGTTT-1	Endo
TAATTCCTCTAGTCGA-1	Endo
GAACCGCAGGCCTCGT-1	Pericyte
CTGTATTTCAGTGGTT-1	Fib
TTGTTGTGTGATGTGG-1	Pericyte
TACGCCTGTACGCCCA-1	Fib
TGACAACTCCACGAGC-1	Endo
TAATTCCAGCATTCCA-1	vSMCs
GGAGAACTCTGAAAGA-1	Pericyte
CCACAGGGTGTTTCTT-1	CM
TGGACATGTTAACCAC-1	Fib
GGCGAAAGTGGACTGA-1	CM
CAAAGCTCAAGGAACC-1	CM
TGCTCGTTCTTCACTA-1	Myeloid
TTCGTTAGTGGAGTGT-1	CM
CGCTGGAGTAACAATG-1	Endo
ACTGCAACATTGCACA-1	Endo
GTCACTCGTCAGAAGC-1	Pericyte
TTCTGTAAGGAAACTT-1	Fib
ACCGGGTTCTGTAGAC-1	CM
GCGTTGGAGTAGTCGG-1	Fib
GAAACAATCTTTATCG-1	CM
ACTTCCGAGCGTCAAG-1	Fib
ACGGATTCACCGAATT-1	CM
ATTACTCCACATTGCA-1	Pericyte
CTGCTCACACCATTCC-1	Pericyte
AACCTTTAGACTCGGA-1	Fib
GACTAGTGTCACCGCA-1	CM
CTCACCATCGTCGCAG-1	Endo
ACCGGGTTCAGTGTGT-1	CM
TTACCGCCATTCTTTG-1	CM
AAGATAGAGAGGAATG-1	Fib
CTGCGTTTCAGGAATA-1	Endo
TATGTTCAGTACCACT-1	Myeloid
CCTTAATTCGTTACAG-1	Fib
TAACTTCGTCATAAGA-1	Myeloid
GTCACAATCAAGTTGC-1	Endo
TGACAACGTAGTGATA-1	Fib
CATTGGAGTCCAAGAG-1	Endo
ACCTGCTGTAAGTGCG-1	Pericyte
GCTCCTAAGCGCACAA-1	CM
GACCCAGGTTCTTTGT-1	Endo
GCAGCTGTCGCACCGA-1	CM
GAGAACGCATGGTAAA-1	Lymphoid
CAGTGTAGTCAGTGCC-1	Lymphoid
GGACACCTCGGAGTTT-1	Endo
TAGTCCCCATGGCCCA-1	Endo
GGGAACACACTGTTAG-1	Endo
TGCTTCGCAAGTAATG-1	vSMCs
CACATGATCGGGAAAC-1	CM
CGCGCAAAGAAGACTT-1	Fib
GGTGAAGCACCCTTAC-1	Pericyte
ACCGGGTAGGATGTCG-1	CM
AGCTATGGTTCCATCC-1	Endo
GGGACCTTCAGAATGA-1	Fib
GTGTGATGTTGGCGAA-1	Pericyte
CTGTTCGGTCCCTAAA-1	vSMCs
TTCAACTTCCTCCCAA-1	Endo
GTGGCGTCACCTACCT-1	Fib
CGTACAACAGGATAGC-1	CM
ATCCAGAAGCAATAAC-1	Endo
CGGACTGCATCCTGGG-1	Pericyte
TCGATTTAGTTCGACT-1	Pericyte
TTACGGAGTAACGGTG-1	Endo
AACATCGCAATGTGCT-1	CM
TGTTAGGTCGTGAGTT-1	Pericyte
GTAATCGGTCTGGTTA-1	Lymphoid
CGCTAGGAGCAGAAAG-1	vSMCs
ATCCAGAGTTGGCTTA-1	Myeloid
CAGTGCGTCCCACTTG-1	Endo
GCTCACTCAAGTCTGT-1	Endo
TGATGCAGTGGCCTCA-1	Fib
GACCTTCCAATTCGTG-1	Fib
TGTTAGGAGCGCAATG-1	Pericyte
GCCCGAAAGGAATGGA-1	Endo
CGTTCCAAGGTTGACG-1	Pericyte
ACAAGCTGTACGCCCA-1	Fib
GTCGTAAAGAATACTG-1	Fib
GCTTGCTGTGAGTCGA-1	Pericyte
CTTGTCGCAGTAGGCA-1	Myeloid
AAATGCCTCCTAGAGT-1	CM
GAATCTGCAAAGAGAG-1	Neuronal
CACAGATCAGTATACC-1	Endo
AGCGTATGTTCCATCC-1	Endo
TGCCTGTAGCTAGCAG-1	Endo
TTAACGGGTAGGTAAT-1	CM
ATTACCTTCCACTAGA-1	Endo
GGCGTTGCACCTCGTT-1	Endo
TTTGGCCGTTTCCGGG-1	Fib
GACCGACCAAGGAAGA-1	Endo
TTCATTGTCGTTGTTT-1	Fib
AGGCGTCAGTGCTCGC-1	Endo
TGGTCAATCGTTGTAG-1	Endo
ACTGTCCCAAAGCTGG-1	vSMCs
CAGTATGTCGCTATTT-1	Pericyte
CGCACAGTCGGTCCGA-1	CM
CACGTTCAGAGCTCCC-1	Endo
GAAAGTAAGTCGGGAT-1	Endo
TCTCAGCCAAAGGTCG-1	Endo
TCAGGTAGTAACCGAG-1	Fib
TTGCGAAGTGAATACA-1	Endo
CTAGCGGCAACGTAGG-1	Endo
AGCCAGCGTAACTCCA-1	Fib
TGATCAGAGGGAGATA-1	Endo
ACAGACTGTTCCTATT-1	Neuronal
CCCTAGTCATGCCTTC-1	CM
AGCCTCTCAGCTTACA-1	Endo
TGATCAGGTGAATACA-1	CM
CCTGGGACATACAACC-1	Fib
TCCAGAACAAGGTTCT-1	Pericyte
TTCGGTCTCTTAACGG-1	Endo
GGGACCTTCCGATTGA-1	Pericyte
CTCCCAACAGATACAA-1	Endo
TTACTCATCGCCGAAC-1	Endo
TGACAACGTTCTACGA-1	Neuronal
CCGTACTAGATCACCT-1	Endo
TGTACGACAGGTAACG-1	Endo
AGGCGTCAGGGAGTTC-1	Fib
ATCGAGTTCTTGTCAT-1	Endo
TTCGCGTCATCAGAAA-1	Endo
GCTTTCGGTTCTCGAA-1	Pericyte
TGACTCCTCGGGCTCA-1	Pericyte
TCTCAGCGTCTGGATT-1	Endo
AGCCAGCGTGCTAGTT-1	Endo
AGTTACGTCAAGGCAG-1	vSMCs
GCCTACTGTCTGATTG-1	Endo
TCACAGACAGTGCGAA-1	Pericyte
CCACAGGGTATTCTCT-1	vSMCs
CAGCTGGTCGTCTAGA-1	Endo
CTGGCAGCACCTCGTT-1	Fib
ACTAGGTAGCTCCGGT-1	Endo
GCTTTCGGTCGACTGC-1	Fib
AGCCGCAAGAAATTCG-1	Endo
AAAGGATTCCGTGCGA-1	CM
AGCTGGCAGGGCTTCC-1	vSMCs
CCATACCGTGCAAGAC-1	Pericyte
GGAGGATTCAATGCAC-1	Fib
CTACTTAAGATTACGA-1	Endo
GCATTCCTCTCTGAGA-1	Myeloid
CACAGATAGTCGACCC-1	vSMCs
CCCTAACAGAAGCCTG-1	Endo
CGTGGCATCAGGAATA-1	Endo
TAAGTGCCAGATTTGC-1	Endo
GCTCCTATCTGGGCGT-1	Endo
TTTGGCCTCGCTCTAC-1	Endo
ACCGGGTCAGAGATGC-1	CM
AGCCCGATCCTAGAGT-1	Fib
TAAACCGAGAACCATA-1	Fib
TTACGTTAGCGTGTTT-1	CM
GTGCTGGAGGATTTGA-1	Endo
TGGGTTAAGCACGTAG-1	Pericyte
ATGTCGATCGATAGGG-1	CM
TAGCATGTCTGTGTCC-1	Fib
TAGCTTTTCTATGAGC-1	Endo
TTCGATTTCTCTGCGT-1	Endo
TTACGTTTCCATTGTT-1	Fib
TGCCTGTCATGCCTTC-1	Fib
TGACAACAGCGGACTA-1	CM
GAATCTGTCCATAGGT-1	CM
TTATGTCCAGCGCGTT-1	Endo
TTGCGAACACAAACAA-1	Endo
AGGCCCAAGGTAAGCC-1	Endo
AGCGATTGTGTGCTTA-1	Endo
TGATTTCAGCTTACCA-1	Lymphoid
GAGGCTCAGAGGAAGT-1	Endo
CAAGAAAAGGCACCTC-1	Endo
TTGCGGGAGTCACACT-1	Endo
TAGCATGTCACATCCC-1	Pericyte
ATGTACGGTGCTTACA-1	Pericyte
TTACTTGGTGATTCCA-1	Endo
ACTATTCCATTACTCT-1	Endo
TCTCTGGCACTCAGCG-1	Endo
ACATGGTGTAGCTGTT-1	Fib
ACTTTCACAAGGTCGA-1	vSMCs
CACTAAGTCTTCCACG-1	CM
CTCAACCTCGATCTTT-1	Endo
TTGAGTGGTTACTTTC-1	Endo
GCATTCCTCCTGGGAC-1	Endo
ATCCTGCAGAGCCTGA-1	Myeloid
TCAATTCGTGTTTCTT-1	Endo
CTGCTCATCCTCATTA-1	CM
CGCTATCGTGCCCTAG-1	Endo
GTCTACCGTACGTAGG-1	Endo
GTTACTTCAGATTAAG-1	Fib
GATCGTAAGCGATACG-1	Endo
CTCACCAAGTTGCTTG-1	Myeloid
AATACGCAGAACGTTA-1	Neuronal
TGCCTGTCAGGACCTC-1	Myeloid
CGCAGGTTCGTCTAGA-1	Fib
GCGGTGTCAGTATCTG-1	Fib
TCACAAGCAAGGGAGG-1	CM
CGTGGCATCTTCCACG-1	Fib
GGAACTTTCAGCACGC-1	Endo
TTGTTGTTCGTGGTAT-1	Endo
CCCTAGTAGCGGACTA-1	Fib
TTGAGTGCAGGTAACG-1	CM
GAAAGTAAGGGTCTGA-1	Endo
GGGAACACATAGCCGC-1	CM
AACCAACTCAACGTGT-1	Endo
TGCTCGTAGAATCAGT-1	CM
TGTTAGGGTTTCTCTA-1	Fib
TTGAGCAGTGAGGGTT-1	CM
TCAAGCAAGTCACACT-1	Endo
AACAGTCCAACAAACA-1	Pericyte
GAGCGCTAGGCACCTC-1	Fib
ACAAACCTCTCTATTG-1	Endo
AGTGCGCCAAGTAATG-1	Pericyte
CCAGAATGTTACGAAA-1	Fib
GTTGGGCAGGCCTAAG-1	Endo
CCCTCTCAGATTACGA-1	Fib
TAGCTTTAGTATACCC-1	Pericyte
CAACCAAAGGGCTTCC-1	Endo
CCGTACTGTAAAGGCC-1	vSMCs
GAACCGCCAACCTCCT-1	Endo
CCACAGGCACATAAAG-1	Lymphoid
TTGTTCAGTGTCGTCG-1	Endo
TGGCGCAAGCGTCAAG-1	Fib
TCAAGCAGTTGGAGGT-1	CM
TCACTCGTCATTGCCC-1	Fib
AGCCTTCAGAGAAGCA-1	Endo
GTGTCCTGTCTGTGTA-1	Endo
CTAGGATTCTGGCCAG-1	Endo
AGCCTTCCACCACAGC-1	CM
TGTGACATCCTTCGAC-1	Endo
ACTACGAAGAGAATTC-1	vSMCs
GTGCACGTCCTCCAGT-1	CM
GCAGCTGCAATGATGA-1	Endo
ATTTGTCTCCGGCGAT-1	Endo
CAGTGCGGTTTCGACA-1	Endo
TACTGCCCACACTAGT-1	Fib
ATTTGTCCACTGTAAC-1	Fib
GTCCATCTCGAGGCTC-1	Endo
TCCGACTGTACTTCAG-1	Endo
ACTTCCGCAAGCCAGA-1	Endo
TGCATTTCAAATTGAG-1	Fib
GTGCCAGAGTGCCCTG-1	Endo
TCCATCGCACGTTAGT-1	Lymphoid
GCCATAATCCAGGCCA-1	CM
CTCTACGTCTCGCGTT-1	Endo
GATTGACTCCGGGCAT-1	Neuronal
GGAGAACTCGTGCTTC-1	Lymphoid
GGTGTCGGTTAGTAGA-1	Endo
AATGGAAAGTTGAATG-1	Endo
CAACGGCGTTCCCGGA-1	CM
GAGGTCCCATCTCACC-1	Endo
TATTGCTAGGCTGGAT-1	CM
CCGCATTTCTGGAAGG-1	Endo
AGTGCGCCATATACGC-1	Endo
CTTCCAGCAATGCACT-1	Endo
CTTGTCGCACGTGAAG-1	Endo
CGCAATATCGGGTCCA-1	CM
TTACGTTCACCAAGGA-1	Endo
ATCCCTGAGAGCTGTG-1	Endo
AGCTGGCTCGCAAACT-1	Lymphoid
CTAGGATCACGCTGTG-1	Endo
TGCTCGTAGTCGGGAT-1	CM
GTCTACCGTGAATCGG-1	Pericyte
TGACAACCAAGTTCGT-1	Fib
TGTAGCAGTGATGCTT-1	Endo
CAACGTAGTTTGATCG-1	Endo
CATGCCTCATCGACCG-1	Fib
TAAGCCAGTTACCACA-1	Fib
AACTTGGCATACTGCA-1	Endo
TTCATTGGTGCTTGAT-1	Endo
TACATGGCATGGTAAA-1	CM
TCTCTGGAGAGTGGAA-1	Endo
CAGCCTTGTTTGTCTT-1	Endo
GGAGGATTCACATTCT-1	Endo
GCTTTCGTCCCTATTA-1	Endo
ACCATCCCACTGTCGG-1	Neuronal
GAAACAATCTTATCAC-1	Endo
AAAGGATGTATGTTCG-1	CM
AACTGGTCATGGCCTG-1	Endo
CGCTGGATCGCACAAT-1	Endo
CCCAGAGAGCGATACG-1	Endo
GTTATTCCACTGTCGG-1	vSMCs
TACCCTGTCAAATGGA-1	Pericyte
CACCTGTAGTATAGTG-1	Endo
GATTAGCAGAACGCCA-1	Endo
GCCCGAAGTTACTTTC-1	Endo
ACTAGGTTCCGCGATG-1	Endo
CAAGCTAGTACCCACG-1	Myeloid
TGGCAATAGGCAATTA-1	Endo
CAGCCTTAGGTAAGCC-1	Fib
TCACCTGAGCCTTTGA-1	Fib
CTAGGATCACACATGT-1	Endo
TAAGTGCCACATAAAG-1	Endo
TCACCTGCATAGCCGC-1	Fib
TAGGTCAGTGTGTGTT-1	Endo
TAACGGTCACATTGCA-1	Endo
TAGGTGTGTAAACGAT-1	Endo
GTGCCAGTCTGTAGAC-1	Endo
AACGTACTCAAGAGGC-1	Endo
TGATCAGCAGAGTCGA-1	Endo
AAGATAGGTCAAATCC-1	Endo
TTCGTTATCACAGGGA-1	Fib
TACCTCGAGCCGCTGT-1	Endo
TAGCCCTAGACGAAAG-1	Lymphoid
AGCTGATTCGCTCGGA-1	Fib
GAACGTTTCTTTCGAT-1	Endo
GCCATAATCGTTGTAG-1	Endo
ATAGTCGAGGGTCCCT-1	Endo
GCGCCAAAGCTTTCCC-1	Fib
TTCGTTAGTACCTATG-1	Fib
GCCCGAAGTAAAGGCC-1	Endo
TTACGTTCAGGACTGA-1	Endo
CCACAGGCAGCAACCC-1	CM
TGGTCCTCAATTGTGC-1	Endo
TAGGTGTGTAGATTAG-1	Myeloid
CTGTTCGTCGGTTGTA-1	Myeloid
ATCCTCGCAATAGCGG-1	Endo
AACTGGTGTAACCATC-1	Endo
AATGGCTCACATTGCA-1	Pericyte
TTACGTTGTATCGCGC-1	Endo
ACTAGGTTCTGAGTAC-1	Endo
CACTGAATCCACGGCA-1	Endo
GACCAATGTTCTGAGT-1	Fib
GCTTGCTCAAACCCTA-1	CM
TCAGGGCGTACGAGAC-1	Fib
CCTGCTAGTACGGATG-1	CM
TTTGCGCCATCATCGA-1	CM
TAATTCCTCGATGAAA-1	Fib
GTTACTTGTCCAGACC-1	Fib
ATTGTCTAGTGTAATG-1	Endo
TTTGGCCCATTGCGAT-1	Neuronal
AGCTGTACAAGGTCGA-1	CM
CAAGCTAGTGCTTTGA-1	Endo
ACATGCATCTCTATCA-1	Endo
TGGAAGGGTTGGTAAA-1	Endo
AATGCCACAATGTAAG-1	Endo
GCACGGTAGCTCCGGT-1	Fib
TGTACGATCTATATCC-1	Endo
TCCATCGCAGCGCGTT-1	Endo
CAAGGCCAGCTTTCCC-1	Endo
CGCAATACAGTGCGAA-1	CM
CCTTGGTCAGTAAGCG-1	Endo
TGGAAGGAGGCCTCGT-1	Endo
CACATGATCGTTACAG-1	CM
TAGGTGTTCACTAGCA-1	CM
ATTGTGGGTATGTCCA-1	Endo
TGCCTCAAGATCACCT-1	Pericyte
ACCGAATAGGGTTCCC-1	Endo
GCAGCCATCCTCCAGT-1	Endo
CTTGAAGAGAGTGGAA-1	Fib
TTTGTGTAGGGAGATA-1	Fib
CCGAAGCAGCGCAATG-1	Fib
AGCCTCTAGGGTTCTT-1	Endo
ACTTTCAAGGAACCGT-1	CM
AAATGCCTCTCGACAA-1	Fib
TGGCGCACACCAAGGA-1	Fib
AAGGAGCGTCCGCTTT-1	Endo
TAAGCCACATATTGGC-1	Neuronal
AGTTACGGTGGTAAGC-1	Endo
CCGAAGCTCGTCCCAT-1	Endo
TATCTGTCAAGACTAA-1	Endo
GTGACATTCATACTTC-1	Neuronal
TCGCCTATCCCAGTAA-1	Fib
ACGGATTAGAACGACC-1	vSMCs
ACCTGCTTCAGGTTTG-1	Fib
CGCGCAAGTAACCATC-1	Endo
TGAGTCATCGTGGCGT-1	Endo
ACCGAATCATAGACGG-1	Endo
ACAGACTGTATATGGA-1	vSMCs
ACTAGGTCACCTATTT-1	Myeloid
TACTAGGAGAACCCGA-1	Endo
CTGGCAGGTATCACAC-1	CM
GCAGCCACATGCCCTT-1	Fib
GCTGCGAAGTGATCTC-1	Endo
CCTAAAGAGTTCAACC-1	Endo
GGAACTTCAATGATGA-1	CM
GCCTACTTCCCTAAAG-1	Endo
AAAGATGCAGGCAAGT-1	Endo
ACGGATTGTACGTATC-1	Fib
ATTCGTTAGTGCCCTG-1	CM
AGCGATTGTTCCGGCA-1	Endo
CGCACAGCATCATGTG-1	Fib
AGCTATGCAACGCACC-1	CM
CTCTCGACACATTGCA-1	CM
GTTGGGCGTCCTCAGG-1	CM
GCTTGCTCATTGCGAT-1	Endo
CAACGTAAGACCGCAA-1	Fib
GCACCTTAGTATACGA-1	CM
TAAGCCAAGATATGTG-1	vSMCs
AGTGTACCAAGTGGCA-1	Endo
GGGTGTCCAAATGTCC-1	Endo
GCTTTCGTCTGATCTT-1	CM
CCACGTTGTGCCCAGT-1	Endo
GATTAGCGTTATGCAC-1	Fib
GACCAATGTCACCGCA-1	Fib
CTACAGAGTATTTGCG-1	Endo
AGCCTCTGTTCTACCC-1	Endo
AAAGGGCAGCTAGTTC-1	Fib
AAACTCGTCAGTACAC-1	Fib
GGAACTTGTTTCACCC-1	CM
AGGCGTCGTAAACCCT-1	CM
TACGGATGTTTGTACG-1	Pericyte
CTTGCTGCACTCAAGT-1	Myeloid
GCGTTGGTCACAGGGA-1	CM
TAGCCCTAGGATTAAC-1	Myeloid
TGGGTGCGTGAGGTCA-1	Myeloid
AATGGAAAGTTTGGAA-1	Fib
TCGCAGGGTAGCTGTT-1	Endo
AGTCAACCAAGGATGC-1	Endo
CTTTGCGCAATTCGTG-1	Myeloid
CCCTGATGTGATAAGT-1	CM
CCACGTTAGAGGCGGA-1	Endo
GACCCAGTCAACACGT-1	Pericyte
ATTCGTTAGTGTCCCG-1	Fib
CAGTGTACACTGATTG-1	CM
TAGCCCTGTTACGCTA-1	CM
AGCCAGCGTCGAGGTA-1	Endo
TGAATCGAGGAGGCGA-1	CM
CGATGATCACGTTGTA-1	Endo
ATCCTCGAGTATCTGC-1	Fib
TACTCGCTCTTGTCGC-1	Fib
CTGGGACGTAGAAGCC-1	CM
GCACGCAGTGCATCAT-1	Myeloid
GGCATTAGTCAAATCC-1	CM
ACCTGCTAGCCGCTGT-1	Lymphoid
TACCTATCAAGCGACA-1	Endo
ACGTGGCCAGGTTATC-1	Fib
ACGTTAGTCTTGTACT-1	Endo
ACTACCCGTGGGTAGT-1	Fib
ATCCAGATCATGTTCT-1	CM
GAAAGTAAGATAGGTT-1	Endo
GCTCGAGAGGGAAGCG-1	Myeloid
CGCGCAAAGTACCACT-1	CM
CATGTTTCAAGGTTCT-1	Endo
CCCTAGTCATCTCTCG-1	Endo
CTGCTCAGTTTCACCC-1	Endo
CAAAGCTAGGCAAGGG-1	Endo
ACTCGGGTCCAACAAC-1	Endo
GACTAGTTCACTTACT-1	Endo
GGTACCGGTGCTGGCT-1	Fib
TAGCACATCCAGGCCA-1	Fib
TTAGCGACACAAGGGT-1	Fib
CCGTACTCACCATTCC-1	Myeloid
GTCACTCTCTTACGGA-1	Endo
TGGCAATTCAGCACTA-1	Endo
CTAGGGCAGAGGTGGG-1	Endo
TCCCACATCTTCAGAG-1	Endo
ACATGGTAGTGGGACT-1	Pericyte
TAATCGGCACAAGGGT-1	CM
GATCGTAGTTCCCGGA-1	Myeloid
TCAGGGCAGGTTACAA-1	CM
AGGCGAAGTTTGCATG-1	Endo
GCGATTAGTTACGAAA-1	Endo
TAATCGGCACTGTCAA-1	Pericyte
ACAGGCCAGGCAATTA-1	Endo
TGAATCGTCTGTTTAC-1	Fib
TTCTAACGTTCAGTAC-1	Endo
GATTGACAGTTGAATG-1	Endo
GTTATGGTCTCTCAAT-1	CM
GCGCATGGTTTCACCC-1	Endo
GGGTTATGTTCCCGGA-1	Endo
CGCTGGAAGGATGCCA-1	Myeloid
TAGCCGGGTCCAGACC-1	Endo
CACCACTTCAGGCGCT-1	CM
AAAGGGCGTACGCCCA-1	Endo
GCTCACTAGTTGCCGC-1	Fib
CTCAACCAGGGTTCTT-1	Endo
GTTATGGCAGTTGGAG-1	Fib
TACTCGCTCTCGCGGA-1	Fib
GTGGATTGTCGCTAGC-1	Endo
ATCCTCGAGACACTTC-1	CM
TCACAGAGTCACCCGA-1	CM
GTCACCTAGCGTTAGG-1	Fib
CTTCTAAAGTCTTAGC-1	Pericyte
GTTGGGCGTAACACTC-1	Endo
TACTCGCCAATAGTGA-1	Pericyte
ACCTGCTAGTGTCGGA-1	CM
AGACAAATCGTGGCGT-1	Pericyte
GCAACCGCAGTTAAAG-1	CM
CCCTGATTCCTTTGCG-1	Endo
AGGACGATCTGATCTT-1	Myeloid
ACTAACGGTCCCTAAA-1	Endo
GTGTCAAAGAATACTG-1	CM
GAAAGTACAATTGCCA-1	Neuronal
AGGCCCAGTTACGGAG-1	Endo
AAATGAGCAAGTCTGT-1	Pericyte
GTGGCGTCAAGCGTCC-1	Endo
TTCATTGAGACGCCCT-1	Pericyte
CACCACTTCTGTCGGG-1	CM
TCTCAGCGTCTAAGAA-1	CM
CACCTTGCAAGACTTC-1	Endo
CGCTGGAAGAACTCCT-1	Endo
ACTACCCCACTAGCCG-1	Endo
ATCCCTGGTTCTGATG-1	Endo
AAATGCCTCAGTACAC-1	Fib
GTCTACCGTTGGCTAT-1	Endo
GCGGAAAAGTATGCTC-1	Fib
CGTGGCAGTTATGCAC-1	Endo
ACAATCGCAAGAAACT-1	CM
GATCATGCACTGCTTC-1	Endo
ACATGGTGTCTGGTCG-1	CM
GGCGAAATCTTCCAGC-1	Fib
GACTAACCAATGATGA-1	Endo
TAAACCGCAGTCAGAG-1	Fib
GGCACGTGTCCGTGCA-1	Endo
GAGTGAGCACAGAAGC-1	Endo
TGGGTTATCACTAGGT-1	Endo
CCAGATAGTTTGTCTT-1	CM
GCTCACTCATCCATAG-1	CM
TTATGTCAGTGATATG-1	CM
GCAAAGGAGCTATCCA-1	Lymphoid
GTGGCGTAGTGTAATG-1	Endo
ACAGGCCCACCGATCG-1	Lymphoid
GCACGGTTCCGGAAAG-1	Endo
TTACGTTCACACACCG-1	Endo
CTCACCAAGTTCGACT-1	CM
TCACCACTCACCCTTG-1	Endo
CAACGTACATTAACGC-1	CM
GAACCTACAGAAGTGC-1	Endo
