Barcode	cell_type
ACGTGGCTCTAGCAGT-1	CM
TTTGGCCAGTAACATG-1	Endo
AGCCTCTCACAGCCAC-1	CM
TGGCCTTGTGGTACTT-1	CM
GATTGACGTAAGGTCG-1	CM
ACATGCAGTGAGTCGA-1	CM
TCAAGACCACTCAAGT-1	CM
ATGTACGCAAGGAACC-1	Fib
GTTGGTAGTGGTTCTA-1	CM
AGCGTGCAGCTATCCA-1	CM
AAAGGATTCTTCTTCC-1	CM
GCAAAGGGTAGTAACA-1	CM
TGGTCCTCAAAGCATA-1	CM
ACAATCGCAATGATGA-1	CM
GAGCATTAGGTTCTCA-1	Fib
ATTCGTTGTTCTGAGT-1	CM
TGATTTCAGCGAATAT-1	CM
CACCACTGTGAATGTA-1	CM
TGCTTCGCATCAACTG-1	CM
AGTGTACGTAGTATCC-1	CM
TACATGGGTACAAATG-1	Myeloid
TTAGCTTCACAATAAG-1	CM
TGGCCTTTCCGTTTCG-1	Myeloid
CAACCAACAATTGCCA-1	CM
AAACTCGTCACTACCC-1	Fib
AACCGATCATCATGTG-1	CM
GAAAGTACATGCCCTT-1	CM
AGACAAATCGACTGGC-1	CM
GGGTTATGTCCAAGAG-1	CM
GAACCTAAGCTTACCA-1	CM
ATCCTCGTCGCCCTTA-1	CM
CGCACAGGTGGAGTGT-1	CM
TAACAGCGTTACCACA-1	CM
TTTGCGCAGCTCGTTA-1	CM
TTCGGTCGTCACATTG-1	CM
ACAGAAACACCGAATT-1	CM
CCGCATTTCGTTTGAG-1	CM
TCACCACTCGATGAAA-1	CM
TGTAAGCAGTCTCTAG-1	Fib
GAGGTCCAGTAGGTCG-1	CM
AGCTGGCGTCAGGCTC-1	CM
TCTAGTTTCCAGAATC-1	CM
AGATTCGAGCTACGTT-1	CM
CACCACTAGAGGCGGA-1	CM
ACTGCGGCAGGATGTG-1	CM
ATGGATCTCACATTCT-1	CM
TCTAGTTCATCGACCG-1	Fib
CTAACTTTCCATAACG-1	CM
ATGTCGAGTATGGGTG-1	CM
ATCCTGCAGGGATCCA-1	CM
TGCGTAAGTGCTGAAG-1	CM
CGAGTTAAGGAGACTC-1	CM
AAAGGATGTTCATTTC-1	CM
GCACGCATCTCGGCGA-1	CM
GCATTCCAGAGATTAC-1	Myeloid
GCAAAGGGTATGCTAC-1	CM
CGCAGGTTCACACGTA-1	Fib
TTGCTTACAGGACTGA-1	Fib
AGTTACGTCCCTATTA-1	CM
TGTGTCCAGATGGGAA-1	CM
CCGTGAGAGTGTCACT-1	CM
CAAAGCTGTCAACGGA-1	CM
CTTGCCATCTGGCTAA-1	CM
TTGTTGTCACGGTTAT-1	CM
CCAGATAGTGCTGAAG-1	CM
GAGCGCTCATCGAGTT-1	Fib
CAGGATTCACAGGAAC-1	Fib
ACATGCATCAAAGTAG-1	Fib
TTGCGGGTCAGTGTAC-1	CM
AGTTTGGGTACGTAGG-1	Fib
GTTACTTTCTAGTCGA-1	CM
GCACCTTGTTAGGCTT-1	CM
CCCACATGTAACCCAT-1	CM
CAACCAACATAGAATG-1	CM
CCCTAACTCCATAACG-1	CM
GGAACCCGTAATGCAA-1	Fib
GCGAGTCCATACTGCA-1	Endo
TAGACTGAGAAATCTG-1	CM
GCATGATCAACTGCGC-1	Fib
AAACTGCGTAGCATGG-1	CM
GTAGACTAGGCTCCTG-1	CM
TTTGTGTCAGGATAGC-1	Fib
GATGGCCAGAGTTTGA-1	CM
TACTAGGCAAACCGAG-1	Fib
CCTGGGAAGGCCAATG-1	CM
GAAGTCTTCCGTCAAA-1	Myeloid
GGCACGTCAGGCAAGT-1	CM
TATCTGTAGCAGTAGC-1	Fib
TCACCTGTCTAGCAAC-1	CM
AAACGAAAGGCCTCGT-1	CM
TTGAGTGTCCCAGTAA-1	Fib
GCGAGTCGTTGCTTGA-1	CM
TAATCGGTCGTGTGCG-1	CM
GACCCAGCATAGCAGG-1	CM
GCACGCAGTGCCCAGT-1	CM
TTACGGATCTGCTACC-1	CM
CTAGGATCATGGAGGT-1	CM
AGACAAAAGTGAGTGC-1	Fib
ATTTGTCTCGGCATAT-1	CM
CCCTAGTAGGTCTTTG-1	Fib
GCGAGTCGTCACAGGA-1	CM
GTGACATTCTTACGGA-1	CM
GAGACTTAGTACAGTA-1	CM
TTACTCAAGTGAGCAC-1	CM
ATGTCTTAGGAAGAAC-1	CM
CACGTTCTCTTACGGA-1	CM
GAGACTTTCTGAAAGA-1	Fib
ATTGTGGGTGCCCTAG-1	CM
TCAGTCCTCGCGATGC-1	Fib
GTTATTCCAAGAAACT-1	CM
ACTATTCAGGTAGGCT-1	CM
CGGACCATCCAACAAC-1	CM
TGTGACACAATTCAGC-1	Fib
GAAGAGCGTCATGAGG-1	CM
TAACGGTAGAGCTACG-1	CM
CCACGTTTCGCATAAC-1	CM
ACCAAACTCGTGAACT-1	CM
CATAACGAGAGTAAGG-1	CM
TGGAAGGTCCAGTTAG-1	Myeloid
CATGTTTAGCTCCATA-1	CM
GTTCAAGCAATGGTCT-1	CM
TCAGCTCTCGCATACA-1	CM
AGCTGGCCAATACTGC-1	Endo
CAGGATTTCGTGAACT-1	CM
TATCTGTTCGGGAAAC-1	CM
TAGCACAGTTACACTG-1	CM
GATTGACCACAGGAAC-1	CM
CCCTAACGTGGAGTGT-1	CM
TTCTAACAGACCTATC-1	CM
ATCGAGTGTGGTGGTA-1	Fib
AGCTGTATCGTCCCTA-1	Fib
CAACGGCTCCGCGATG-1	Fib
TTGAGCATCTCTGCAC-1	vSMCs
TGCATGAGTACCAAGG-1	CM
CACCACTCAGGATGTG-1	CM
AGGCCTGCAGTCAGAG-1	CM
GTTGGTACAGGTCCTG-1	Fib
TTATGTCGTTAGGCTT-1	CM
TAGCATGGTTACCACA-1	CM
TACATTCTCGGATAGG-1	CM
TTGACGATCTTCACTA-1	Myeloid
TAGCCCTTCTGGAAGG-1	CM
GGGTTATCAGCAACGA-1	Fib
CGCTGGATCCATTGAG-1	CM
AATGCCAGTGCGTTTA-1	CM
GTCACCTAGTCGAGCA-1	CM
AACAGTCTCCGCTATC-1	CM
GATTAGCAGGTTACAA-1	CM
CGCTGGAAGAAAGGGT-1	CM
TCAGGTAGTTATGCAC-1	CM
ACCGGGTAGAGAGTTT-1	CM
TGCGTAATCGAGTTAC-1	Fib
TGTGACAAGCCTCGCA-1	CM
CGGTGCATCGTTACAG-1	CM
AACAGTCAGCGTTGCC-1	CM
GGCACGTTCTTGTGCC-1	CM
CCTGCTATCGTTCCGT-1	CM
CAGTATGGTAACAATG-1	CM
GCATTCCGTCACAGGA-1	CM
ATTGTGGAGGCAATTA-1	CM
TAGCGGCGTGAATGTA-1	CM
GTTACTTGTGATTCCA-1	CM
TGTACGACACAGAAGC-1	CM
TCCGACTTCTGCGTCT-1	Fib
TGGAAGGTCCCGCAAG-1	CM
GAAGTCTAGTATAGTG-1	CM
AATGGCTGTTTAAGCC-1	CM
GTAGACTAGAGTTCGG-1	Endo
AACGTACTCGGTCTCT-1	Fib
GAACCGCTCAGTGGTT-1	CM
TTTGGTTAGCTGCCAC-1	Myeloid
AGCCCGATCGTTCAGA-1	CM
CTAGCGGAGTTACCAC-1	CM
GCACGCAGTTTAAGGA-1	CM
AACAAAGGTATCTCAG-1	CM
GCCATAAGTTTCAGCA-1	CM
CCCTGATGTGCTTACA-1	CM
ACCGAATTCCAAACCA-1	CM
AAAGGATAGCGATACG-1	CM
CCTGCTACAGGCATTT-1	CM
ACCGAATAGAGCGGTT-1	CM
TAGCGGCCAAGTAATG-1	CM
AGTCAACGTTTGATCG-1	CM
CCGTGAGAGACGTCAG-1	CM
CATTCATTCGTAGCGC-1	CM
ATCCTCGGTACATGGG-1	CM
AACAGTCCATTAGCCA-1	CM
TACATTCTCAGTCTTT-1	CM
TAAGCCATCGATAGGG-1	CM
TTGACGAGTAACTCCA-1	CM
GAGGTCCAGTAGTTCC-1	CM
AGGCGTCAGTGGTGTG-1	CM
TATTGCTGTTTCCACC-1	Fib
CTGAATGGTGACAAGC-1	CM
GCAAAGGAGAAGACTT-1	CM
GTGTCCTTCCTGTGGG-1	Myeloid
TAAGTGCTCACAAGCT-1	CM
TTAACGGTCTCTATTG-1	CM
TGATTTCAGTTACACC-1	CM
AACAGTCCAAGCAACG-1	CM
GTACTTTCAAGGAAGA-1	CM
GAAACAAGTAACTGAA-1	CM
GTGGATTGTTGAATAG-1	CM
CTCTAGCCAATGAAAC-1	CM
GGGACCTAGTGAAGGA-1	CM
TAATTCCTCTTCCAGC-1	CM
TGGGTTACAGTTAAAG-1	CM
GGTTGCGTCCCACTAC-1	CM
ACCGCAGAGTCGGGAT-1	CM
ACATGCACAAGCGGTA-1	CM
GTGACATGTGGCCTCA-1	Fib
TTACCCGGTAGACGCA-1	Fib
GGGAACAAGGGTCTGA-1	CM
TTGCGAACACCACAGC-1	Fib
ACTCGGGGTGCACTTA-1	CM
GCGGTGTCAAGGAGGG-1	CM
TTGCACCCAGAAAGAG-1	CM
TGCCTGTAGGACTTTC-1	CM
ATGTCTTCACTCGTGG-1	CM
GTTATTCTCGGTAGGA-1	CM
GTCACGGGTGGACTGA-1	CM
CAGCCTTGTAGAAAGG-1	CM
TTCTAACAGCTTACCA-1	CM
CCCGTTACATGTGGGA-1	CM
AACGTACGTCAAGACG-1	CM
ACTACCCCAGTAAGCG-1	CM
AAACTGCTCGCCAGAC-1	CM
TGCCTCACATGGAGGT-1	CM
CGCTATCTCCGTGCAG-1	CM
TTCATTGAGTTGTCCA-1	Fib
CAGTGTACATCGTACA-1	CM
GTTCAAGAGAGCCTGA-1	CM
TCGTTCGCACGCGATC-1	CM
AGACAAACATGGCCCA-1	Fib
TCTCTGGAGTTGAATG-1	CM
GAACGTTAGAAATGGG-1	CM
CATGTTTTCAGAGTGG-1	CM
ACAGACTTCTTAACGG-1	Myeloid
TACCTATCAGCGTACC-1	Fib
CTGGCAGGTACGTAAA-1	CM
AAACTCGTCCCAATAG-1	CM
AGCCTCTCAAGGAACC-1	Myeloid
ACTACCCCAAGCACTT-1	CM
GACTAACGTAACGGAC-1	CM
ATTGTGGGTGGTGGTA-1	CM
CACCACTGTACGGTTT-1	CM
GCTTTCGGTCAGACGA-1	CM
AACAGTCAGCTCGTTA-1	CM
TTGTTGTCATGCCTTC-1	CM
TGCCTCATCTCCTTGG-1	Fib
ATTGTCTAGACTCGGA-1	CM
CTAGGATAGCGTATCT-1	CM
GCTCACTCACCATTCC-1	CM
CTCTCAGTCTGTTTAC-1	CM
CGTGGCAGTGCGTCCA-1	CM
GCATTGAAGGTCGGTA-1	CM
GTTGGTAGTATTTGCG-1	CM
CGAGTTAAGGGTTCTT-1	CM
GCGTAGCCAAGCGACA-1	Fib
ATGTTTCAGCGGACTA-1	CM
GCTGAGCTCTTCAGAG-1	CM
GTTACTTCATCCGTAA-1	CM
TTGAGTGTCTGACATG-1	CM
CATGCCTCAAAGAGAG-1	CM
CGGTGCAAGCGTCAAG-1	CM
GCCCGAACAAGGACCA-1	CM
GCGCCAACACACTAGT-1	CM
CTTGTCGGTGCCCGAT-1	CM
TGTGTCCCACGGTTAT-1	CM
GCCTACTCAAGAGATT-1	CM
TAGCATGGTACGGATG-1	CM
TCGTTCGTCTGAGTCA-1	CM
CGGACTGTCTCAGATG-1	CM
GCGGTGTAGGCAGTGT-1	CM
GGAGGATGTTTCCACC-1	CM
AACCTGATCTCTCAAT-1	CM
ACATGGTCACCGATCG-1	CM
GACCTTCAGATCCGAG-1	CM
AACTTGGAGACTAATG-1	CM
CGTAAACCAAGAGCGT-1	CM
CCTTGCAAGAAGCCTG-1	CM
TACCTCGCAACACGGA-1	CM
TACTGCCCATTGAACC-1	CM
CTACTTAAGGCCAGTA-1	CM
GCCAGCATCACGTGTA-1	CM
GTGCCAGTCGACTCGG-1	CM
CGCTGGACAGGTTATC-1	CM
TGCTCGTCAAGCCTTA-1	CM
TTGACGAAGTCAGCCC-1	CM
TACTAGGAGGATCCTT-1	CM
CAAGAAACACATATCG-1	Fib
ACTAGGTGTAGTATCC-1	CM
GCTGAGCGTAGAAAGG-1	CM
CTCAGCTGTACGGTTT-1	CM
CGTGGCACAGACTAAA-1	CM
AAAGGATCATGGTTTG-1	CM
GGAATCTCATCCGTAA-1	CM
TAAGTGCAGAAGACTT-1	CM
TTGCTTAGTACTAGAA-1	CM
TACTCGCGTGCTGTCG-1	CM
GAACCTACACTGTTAG-1	CM
TTGGTCCAGCAGGAGG-1	CM
CCTTGCAGTTTGCATG-1	Fib
AGCCAGCGTTAGGAGC-1	CM
CTTGCTGGTACGGTTT-1	CM
AGTCCGGGTGGTACTT-1	CM
ATTGTCTTCAGTCAAC-1	CM
AAGATAGTCTGCCGAG-1	CM
ATCCCTGGTTTGATCG-1	CM
TGATCAGGTAGGTAAT-1	CM
GGCACGTTCTTACGGA-1	Fib
TTATGTCTCGCTTGAA-1	CM
CTCATGCGTCCACCAG-1	CM
CCTTGCAGTAAGTGCG-1	CM
TTGCACCGTAGTATCC-1	Myeloid
CCCTGATAGATGCGAC-1	Fib
GCAGCTGGTACGGTTT-1	CM
GCATTGACAAGCGGTA-1	Fib
TTCGATTAGCTCGGCT-1	Myeloid
ATCCAGATCGAGTTAC-1	Fib
GACCCAGAGACGCCCT-1	CM
TACAGCACAAATGCTC-1	Fib
CCGTAGGGTTTCTCTA-1	CM
CCCTAACAGCAATAAC-1	CM
ATTGTGGAGGTTGTGG-1	CM
TCACAAGTCGCATACA-1	Fib
TCACAGAGTTCCAGTA-1	CM
TAACAGCGTATGGATA-1	CM
GCCAGCATCGGGAAAC-1	Myeloid
ACTTTCAAGACTTCCA-1	CM
TTGCCCAGTTGGTAAA-1	CM
AAGGTTCGTCAGGCTC-1	CM
CTAGCGGCAAGCAGGT-1	CM
AAATGCCGTAGTGATA-1	Neuronal
GGACACCTCAAGGCAG-1	CM
GCGATCGTCGACTGGC-1	CM
TTGTTCATCCAGTACA-1	CM
ATGTACGAGTCCAGAG-1	CM
AAACGAACATTGTTCT-1	CM
TAGCCCTAGGTCGTTT-1	Neuronal
GCGAGTCCAGTCCTGG-1	CM
TCAGCTCTCTTACTCA-1	Fib
TGGCCTTTCCACACCT-1	CM
CCGAAGCTCAGAGTGG-1	CM
CTCAGAAAGTATACGA-1	CM
GCTCACTCATGTATCG-1	CM
CCCTAACAGGTCGGTA-1	CM
ATCCAGATCATGCTTT-1	CM
GTCGTAACAAACCCTA-1	Endo
AAAGGGCCATAGATAG-1	CM
TTGCCCAAGTGAGTTA-1	CM
GTCACTCGTGCACATT-1	CM
AGGACGAGTTTAGGAA-1	CM
TTACTCAGTTTGTACG-1	CM
GGAGTAGGTTGGGAAC-1	CM
GTGCCAGAGGTCGGTA-1	CM
TGCATTTCAAAGCATA-1	CM
CACTGAAGTAGGGTTG-1	CM
ATCCAGATCGCAAACT-1	Neuronal
CCTAAAGAGGTAGGCT-1	CM
GGCGTTGTCTTACTCA-1	Fib
AGGCGTCGTCGACTGC-1	CM
GGACACCCAGGTAGGT-1	CM
TGCTCGTAGTCTAGAA-1	Fib
TCCCACAAGCGTGTTT-1	CM
TTACTCATCGGTCGAC-1	CM
TTCGTTAGTTCTTTCA-1	CM
GGGCCATTCGCTTACC-1	Myeloid
CTGGCAGTCCGTTTCG-1	CM
GATGGCCGTTTGCGAT-1	CM
GAGAACGAGACTAGCG-1	Fib
GAACTTGCAACAAACA-1	CM
GGGACCTGTGAGTCGA-1	Fib
CCCTAACTCCCTACCA-1	CM
TACGGATGTCAGAGTG-1	Myeloid
GGGACCTCATCAACTG-1	CM
GTGACATCAAGCGTCC-1	CM
GGCGAAACACTGTTAG-1	Fib
GAAACAAGTCGTCGCA-1	CM
CCCAGAGAGATCCGAG-1	CM
CTGAATGCATCGGCCA-1	CM
AAACTCGAGCTGATTC-1	Fib
GGCGTTGCAACGTCGC-1	CM
TTTACGTAGATAGGTT-1	Myeloid
AGGCCCATCCTGAAAC-1	CM
TGGCAATCAAGTAATG-1	CM
TAGTCCCTCCTGGGAC-1	CM
TTCGATTAGTGGACGT-1	CM
CCGTAGGAGTATAGTG-1	CM
GGCGTTGGTGGACTGA-1	CM
CACCTTGCATGGTATC-1	CM
GTGCCAGTCTAAACGC-1	CM
TGGGTTATCTGACTTT-1	CM
GCATGATAGGTTAACA-1	CM
TACGCAACAGGGTACA-1	CM
ACAGGCCAGCTTACCA-1	Fib
GCGTTGGGTACCCATA-1	CM
GTCGTAAAGAGGTGGG-1	Myeloid
TATCTGTGTTCTGAGT-1	CM
ATTCGTTTCGCTATAG-1	CM
GCCTAGGAGACGTCAG-1	CM
TCCCACAGTGCAAGCA-1	CM
CCGTGAGAGTGAAACT-1	CM
CCTTAATTCCAAGTCA-1	CM
CTCTAGCCACCACGAC-1	Endo
TGGACATTCTACTGCC-1	CM
GCCTACTCACCTGGTG-1	CM
GGTGTCGAGGTGTTGG-1	Pericyte
AACCAACTCGCGTTCT-1	Fib
AAGGTTCAGAGCTACG-1	CM
CCAGAATGTACAAGCG-1	CM
CAGTGTACAACTACTG-1	CM
AACCTGAGTAACGTAA-1	CM
TATGTGGCAGGTCTGC-1	Fib
GCTCACTTCTGATCCC-1	CM
GTTGGGCGTACCTATG-1	CM
GCAGCTGGTACTTGAC-1	CM
ACTAGGTGTAACGGTG-1	CM
CGATGATAGATAGGTT-1	Endo
GGTCATACAGGCACAA-1	CM
TACATTCCAACAACTC-1	CM
TAACTTCAGTCAACTC-1	CM
TAACAGCTCCGATTGA-1	CM
ACTAGGTAGATGGCAC-1	CM
ACCAAACAGACCAATA-1	CM
GAAGAGCGTTCTGAAC-1	Fib
CTAGCGGAGTTCCAGT-1	CM
AATGGCTCAGGTCCTG-1	CM
ACGTTAGTCAAACCCA-1	CM
ACCTGCTCAACTGCGC-1	CM
AGGCCTGCAAAGCATA-1	CM
CTACAGAGTAACTCCA-1	Endo
GTGGCGTAGTTAGCGG-1	CM
CACAGATGTATTCACG-1	CM
TAAGCCATCTTGCGCT-1	CM
TAGCCCTCAGTAAGAT-1	Fib
GACCTTCTCTTAATCC-1	CM
GGGCCATGTGGCATAG-1	CM
AAACTGCGTGGATTTC-1	CM
TCAATTCGTACCCATA-1	CM
AGCCTTCCACGTTACA-1	CM
TGCGTAAGTTTGATCG-1	CM
TTTACGTCAACGCACC-1	CM
AAACGAAGTGGAAGCT-1	CM
AAACTCGCACCACAGC-1	CM
CCGTGAGCAATTCTCT-1	CM
GTTATTCCAGAAAGAG-1	Fib
TTTGGTTAGAACTCCT-1	CM
GCTCGAGCAGCGCGTT-1	CM
CCGCATTAGTCGATAA-1	CM
CAATCCCGTCCACCAG-1	CM
GGCGTTGGTCTCTGCT-1	CM
AAACGAATCTATTTCG-1	CM
GTCACAAAGAGTAAGG-1	CM
CCGCATTTCCGATTGA-1	CM
AGCCCGATCATCGCAA-1	CM
ATTGTCTTCGCGCTGA-1	Endo
AAGGAGCCAACTACTG-1	CM
GACCTTCCAAACGACG-1	CM
GATGATCTCGCTAGTA-1	CM
CCACGTTGTATTGTCG-1	CM
AGCCAGCGTCCCTTTG-1	Fib
AGATAGACACGCGTTG-1	CM
CTCATGCTCACTAGCA-1	CM
CGCTATCGTCAGAAAT-1	CM
GGTCATACATGCACTA-1	Myeloid
GCTCACTGTCGCTACG-1	CM
ACTATTCTCACCACAA-1	CM
GACTAACAGTCTGCTA-1	CM
GAACCTAAGATTAGAC-1	CM
GACCCAGAGAGGCAGG-1	CM
GCCATAAGTAAGTGCG-1	CM
ACTAACGTCCACCTAC-1	CM
ACGTGGCGTCGGCTGT-1	CM
GCTCAGGAGATGCGCA-1	CM
TTAGGTGGTTTGTACG-1	CM
ACTGTCCGTATCTAGC-1	CM
CTTGAAGTCCAGAGAG-1	CM
GAGACTTGTCTGCACG-1	CM
TACCTATAGGCCTCTG-1	Fib
TGCTCACGTGAGTAAT-1	CM
CACATGAAGATATGAC-1	Fib
CTTAATCAGGCACTAG-1	CM
GTAATCGAGATGCGAC-1	CM
CTCAGCTTCGCGTTCT-1	CM
CAAGCTATCAGAATGA-1	CM
CCCTCTCTCCATGTTT-1	CM
AGCCTCTAGTACTCTG-1	CM
GGGCCATCATCCCAAA-1	Fib
AGCCTGGTCCGTCAAA-1	CM
TACGCAAAGTTGGAAT-1	CM
ACATGCAGTTACTTTC-1	CM
GAGACTTAGTTAGAGT-1	CM
TAACGGTTCTGGCTAA-1	CM
GGGACCTAGCTTCAAC-1	CM
CAGCTGGGTGCACTTA-1	CM
TGGCCTTTCGTCTTAT-1	CM
AAGGAGCTCGCAACTA-1	Fib
TCTATTGCAGCGTCGT-1	CM
TTGCGGGGTGAGCTAG-1	CM
TTCTGTAAGTTCAGGG-1	Fib
GTTGGTACAAACAGTA-1	CM
TAGGTCAAGGTCTTGT-1	Fib
TTCATCAGTTGGTAAA-1	CM
CCACAGGAGTGTGTAA-1	Fib
GCTGTTCCATTAACGC-1	CM
CGGACTGTCTCCACTG-1	Myeloid
TAGCTTTCACTCGGAC-1	Fib
GAGGATGAGTAACACA-1	CM
TGTGTCCAGGTGATGC-1	vSMCs
TGGCGCATCTTACGGA-1	CM
CAACCAACATGATCGT-1	Fib
GGGTTATGTAGAGAGA-1	CM
CACAGATTCACACGTA-1	CM
TGAGCCGGTACTTCAG-1	CM
ATCCTGCCAACTAGAA-1	CM
CACGTTCGTGTCGTCG-1	CM
TGCTATTGTGTTTCTT-1	CM
AGGCCTGAGATGGCAC-1	CM
TTACCCGGTCTGATTG-1	Myeloid
GCATTGAAGTTACCAC-1	CM
TCGCCTATCGCCACTT-1	CM
TGATTTCTCATGAACC-1	CM
TTAGCGATCTGTGTCC-1	CM
TTATGTCGTAGCAGCA-1	CM
CTTTGCGGTGAATACA-1	CM
GCCCGAACATAGCAGG-1	CM
CAGTATGTCGAGAACG-1	CM
CTCTACGGTAGAAAGG-1	CM
TCAGGGCAGTCAACTC-1	CM
TCTCTGGAGTAGCAAT-1	CM
ACAAGCTCAATGTAAG-1	CM
AAATGAGCATCATCGA-1	CM
CTGCGTTGTCTCTAAG-1	CM
TGAGCCGCACACACAT-1	CM
TGTAGCAGTCGAGGAT-1	CM
ATTGTGGGTAGGGTTG-1	CM
ACAGGCCTCTCTGCAC-1	Fib
CAAGAAATCGGCATAT-1	CM
CATTCCGTCTGGACAT-1	CM
GTCACCTTCGGTTGTA-1	Fib
ACCCAAAAGTGTGTAA-1	CM
CGGACCATCCATCGAA-1	CM
ATTCGTTCATAGCCAT-1	CM
ATGCATGCAAATTCCG-1	Endo
CGCTATCCACAAGTGG-1	CM
GACCAATCACGTACAT-1	CM
AGCGTGCGTATCTGCA-1	Endo
GAAATGAGTTGGCTTA-1	Fib
TGAGCCGAGGTCCTCG-1	CM
GAAGTCTTCCTAAGTG-1	CM
AGCGTATCATCGGCTG-1	CM
TATGTTCCAGATACAA-1	CM
GAACTTGGTATCAGCT-1	CM
TCAGGGCTCCTTTGAT-1	CM
CAGGATTGTAGTGATA-1	CM
GAAATGATCTCTTAAC-1	CM
CTGGCAGTCTATCTTG-1	Endo
GAGAACGCACAATAAG-1	CM
GAGGATGTCCTATCAT-1	CM
GCGCCAAAGTGTAATG-1	Pericyte
TCCCACAAGGGAGTTC-1	CM
CATTCATGTCAAACAA-1	Fib
GTGGCGTTCTGCGTCT-1	Fib
TATGTTCGTATTCGAC-1	Myeloid
GTGGATTAGACGAAAG-1	CM
GTGACATAGCATGATA-1	CM
TGCTTCGGTAAACGTA-1	CM
ATGCATGTCAGATACC-1	CM
AACGTACCATTTCACT-1	Myeloid
TATGTGGGTACGGTTT-1	CM
TGTTAGGCAACTTGGT-1	CM
AATGTCGGTAACTCCA-1	Myeloid
TGAGTCAGTTCCAGTA-1	Fib
TTACTTGGTCCTATTT-1	CM
GTAGACTTCATACTTC-1	CM
GCAGATTTCGGTTAGT-1	CM
AGCTATGAGCATGTGG-1	CM
GACCTTCGTAAACGTA-1	CM
TGCTTCGGTAGTACAA-1	CM
TATGTTCGTATATGGA-1	Fib
TGGCGCAGTTTCGACA-1	Fib
ATTCGTTAGGTACTCT-1	Fib
TGATGCAGTTGGCGAA-1	Fib
ACTAGGTGTAGAAAGG-1	CM
ATTCGTTGTACCCACG-1	CM
GTAGGAGTCAGGCCGT-1	Endo
CTGAATGTCCTATCCG-1	Fib
CACATGAGTTAGAGAT-1	CM
TTAGCTTTCGGGCTCA-1	CM
TCAAGGTGTGCGTTTA-1	Endo
TCAGGTAAGATGGCAC-1	CM
TAGGTGTCACTGTAAC-1	CM
ATAGGCTTCCAGAGAG-1	Myeloid
TCACAGACAATTAGGA-1	CM
CGTGGCAGTCATCAAC-1	CM
CTACTTAAGGAAGGTA-1	Neuronal
GTAGTACGTCTCGGGT-1	CM
GCTCAGGCAGGTGGTA-1	CM
AAACTCGCATGCGTTA-1	Endo
GGTGAAGCACGCGTTG-1	CM
CACCACTGTGCTTACA-1	CM
GGATGAGAGCAATGTA-1	CM
TCAGGTAAGTCGACCC-1	CM
TCAGGGCCAGGCAAGT-1	CM
CACCTGTGTACGTAAA-1	CM
ACATGGTGTAAACGTA-1	Fib
CACGTTCCATCCTGGG-1	CM
ACAATCGTCCGTGCGA-1	CM
TGCACCTTCGTGGCGT-1	CM
CGCTGGAAGTCCTTCC-1	Fib
TGTGGCGGTAGTCTGT-1	Fib
CTCGCTAGTAGGTGAC-1	CM
TGCATTTGTCATGAGG-1	CM
ACTTCCGGTAGCAGGT-1	CM
TGAATCGGTGATAGAT-1	CM
GCTCACTGTGACAAGC-1	CM
TTGCAGAGTCGGCTGT-1	CM
TGTGTCCCACAAGGGT-1	CM
CGAGTTACAAGGAGGG-1	CM
TAGCATGCATCCCTCA-1	CM
GTTCAAGCATTAGCAC-1	CM
TCAGTTTGTACGTAGG-1	CM
TGGCCTTAGTGTAATG-1	CM
AACCTTTTCGCTGATA-1	CM
GAACTTGGTTGAATAG-1	Fib
GAAGAGCCACGGCCAT-1	CM
ATAGTCGAGGCCAATG-1	Fib
GTCACTCAGTACTCTG-1	CM
TGCATTTTCTTCGTTA-1	CM
CTTCTAAAGAGCGAAA-1	CM
AACCTGAGTTGTATCG-1	CM
CTTCCAGTCCGATGCG-1	CM
CTACAGACATCGTACA-1	CM
CTTCCAGAGGGTGTTG-1	CM
TGCTTCGGTGAGTCGA-1	Fib
ACTCGGGCACAGTTCA-1	CM
CACTAAGGTTTCACCC-1	CM
TTCATCACATTTGGCA-1	Fib
GCAGCTGTCCCTACCA-1	CM
GAAACAAGTTATCGAC-1	CM
CTGCGTTTCTTAATCC-1	CM
CCCTAGTCAATAGTGA-1	Fib
CCTGGGAAGTCTGCTA-1	CM
CCCTCTCCAAGTCCTA-1	Fib
TCGCAGGTCACCCGGA-1	CM
TAGCATGCAGACCTGC-1	CM
CTCTAGCCATGGATGG-1	Fib
CGTAAACCAAGGAAGA-1	CM
GACCGACGTTAACCGT-1	CM
CGCTATCAGAGCGAAA-1	CM
ATGGATCCAAAGAAGG-1	CM
TATGTGGCACAAGGGT-1	Myeloid
CTTGCTGCAAGCAACG-1	CM
CCTTGCAGTTAACTCG-1	CM
TCAAAGCTCGCTACCT-1	Fib
CTGCTCAGTGAATCGG-1	CM
GAAGTGGCATTGCACA-1	CM
TTGTTCATCTTACGGA-1	CM
TAGTCCCGTTGCAGAG-1	CM
TTAACGGGTTCTACCC-1	CM
GAAGTCTTCTTAGTGG-1	CM
ACATGCACAAGACTAA-1	CM
GGATGAGAGCTTCAAC-1	CM
CGTGGCATCGAACCGC-1	CM
CCCACATTCGTTTGAG-1	CM
GCCAGCATCACAAGCT-1	CM
CGTTCCACATCGCCTT-1	CM
CCGTGAGAGTGCAACG-1	CM
CTCGCTACAGTAGTTC-1	CM
AAACTGCAGACGAAAG-1	CM
GCTGCGAAGGGAGATA-1	Endo
TCTAGTTAGTATACCC-1	CM
GCCAGACGTTACCACA-1	CM
GATTAGCTCGTTCTAT-1	CM
GAGAACGGTTAGTAGA-1	CM
GGATGAGGTTGGCTAT-1	CM
CGCACAGTCGACCCGA-1	CM
GATCATGGTGATGTGG-1	CM
GGAGAACAGTCGGGAT-1	Fib
CTAGGATGTCGAGAAC-1	CM
AGCGATTCATTGCACA-1	CM
CATGTTTCATCCTGGG-1	Myeloid
GGAACTTAGAGCTCCC-1	Fib
CGGACCACATCGTGAT-1	Myeloid
CCAGATATCTGCGTCT-1	CM
CCTGCTAGTGGTAGAC-1	CM
AACTGTGCATTACCTT-1	CM
TGACAACGTATCACAC-1	Fib
GTCACGGTCGCTATAG-1	Myeloid
CCACAGGAGCATGTGG-1	CM
AGCTATGTCCGGAAAG-1	CM
CACCACTGTAGTTTGC-1	CM
TTACCCGAGTCGGGAT-1	CM
TAGCCCTTCTATATCC-1	CM
CGCTGGAAGCGAGAAA-1	CM
CAACGTACAGATAAGT-1	CM
CCCTAACTCTTGCGCT-1	CM
TTCGTTAAGATCACCT-1	CM
GCATTGATCTTGGCCT-1	CM
GCCATAAAGCTCCATA-1	CM
GTCACCTAGTTAGAGT-1	Fib
GGAACTTGTGCACCCA-1	CM
CAACGGCGTGCTGAAG-1	CM
ACATGCATCCCGAAGC-1	CM
AACAGTCTCCTTTGAT-1	Myeloid
GTTCAAGCAGGTGTGA-1	Myeloid
GGAGAACGTCAGCAAG-1	CM
GAAATGAGTTCCAGTA-1	CM
TCTATTGCAGCGTACC-1	CM
TCAAAGCGTATCTCAG-1	Endo
AAACTCGAGCCCATGC-1	CM
TTTGGCCGTGGACTGA-1	CM
ATCGAGTAGATGGCAC-1	CM
GAACCGCGTCAGAAGC-1	CM
TATCTGTGTTGGCTTA-1	Myeloid
TTGTTGTAGCTATCCA-1	CM
TCACCTGGTTTGAAGA-1	CM
GCTTTCGGTAAACCCT-1	CM
GCGGGTTAGGAATGGA-1	CM
AGTTACGTCTTAACGG-1	Fib
GAGGCTCCAGTAGTCT-1	CM
GGAATCTGTGAGTCGA-1	Endo
TTCGTTAGTTCCCTTG-1	CM
ACCGGGTTCGAGCGCT-1	CM
CTCATGCGTACGGAGT-1	CM
TACATGGAGCAACTGG-1	Myeloid
TTTACGTTCTGCTACC-1	Myeloid
CAGCTAACAAGGATGC-1	CM
CTCAGCTAGTTCGTTG-1	Pericyte
ATCCTCGAGTCGAGCA-1	CM
TGTGTCCAGGCTAAAT-1	CM
ATGCATGCACACACAT-1	CM
ACGTGGCCAATGTGCT-1	Fib
CCGCATTAGTGATATG-1	CM
TCACTCGGTTCAGTTG-1	Fib
TAGACTGAGAAAGGGT-1	Myeloid
GAGGTCCTCCCACTAC-1	CM
AGCCGCACAAGAAACT-1	CM
GGGTTATAGCCCATTA-1	CM
TCAAGGTCATGGTATC-1	CM
GTGTCAAGTGGCATAG-1	CM
TACATGGAGCCTCGCA-1	CM
GCCAGCACAGTTAAAG-1	CM
GACTAGTTCACTGGTA-1	CM
CCTTGCAAGAGCTCCC-1	CM
GTTACTTCAAGATTAG-1	CM
GCCAGCACACAGATGG-1	Myeloid
AAACGAATCTGAGTAC-1	CM
CGCACAGTCACACGTA-1	CM
TACATTCAGGTTAGTA-1	CM
GCATGATCATGGGAAC-1	CM
TTGCGAAGTCTGCGCA-1	CM
ATTGTGGGTGCGCTCA-1	CM
TTACGTTAGCGCATTT-1	Fib
TCTATTGCAGGGCTTC-1	Fib
CCGTGAGGTTCTTTGT-1	CM
TAACAGCTCGGATGTT-1	CM
CAGCTGGGTTAGTAGA-1	CM
GCATTGATCAGTCAAC-1	CM
GGCGAAAAGGCGACTA-1	CM
GCGGAAACAGAACTTC-1	CM
AACTGTGAGGTCTTTG-1	Pericyte
TTTGCGCCACTGGGCT-1	CM
AACTGGTTCACCCTTG-1	CM
GGGACCTGTCCGTGCA-1	Fib
AACTGGTGTTCTTAGG-1	Fib
CAACGGCAGAGCGAAA-1	CM
GATGGCCAGCATACCT-1	CM
AACGAGGCAAAGCATA-1	Fib
TACGCAATCCAAGTCA-1	Fib
AAACGAAGTAGACACG-1	CM
TGCTTCGGTATCCTTT-1	CM
ACATGCATCACTTACT-1	CM
ATCCTGCGTGTACGCC-1	CM
GCATTGATCTCGACAA-1	Fib
CAACCAAAGGACTTTC-1	CM
TCAAAGCGTAGGTGAC-1	CM
CTTAATCAGAGATTAC-1	CM
GAGGTCCAGAGACTCG-1	CM
TGAGCCGCAGTCCTGG-1	Lymphoid
CCTTGGTGTTATCGAC-1	CM
TGCATGAAGAGATTAC-1	CM
CATTCATAGTATGCTC-1	CM
AAACTCGAGGATCCTT-1	CM
GCCTACTGTACGGATG-1	CM
TTGTTCACAATAGTGA-1	CM
CATGCCTCAGAGCCAA-1	CM
GGTGTCGCAGTGCTCG-1	CM
GCATGATCACTGATTG-1	Myeloid
TGACAACTCTTCGTTA-1	CM
GGGAACATCACCCGGA-1	Fib
TCGGGACGTTTCCGGG-1	CM
GAGGATGAGGAAGGTA-1	CM
TATGTTCCAGAACGAC-1	CM
GTCTACCCACCGTCTT-1	CM
CAACCAATCCCGAAGC-1	CM
CGTAAACAGACGCCAA-1	Fib
TTACCGCCACGCTAAT-1	CM
ATGTACGGTCGCTAGC-1	CM
GGATGAGAGATGGGAA-1	Fib
AACTGTGAGAGGTCCA-1	CM
GCTCACTTCCTAGAGT-1	CM
CTGGCAGAGCAATAAC-1	CM
ATAGGCTGTGCGTCCA-1	Fib
GTCACCTAGCGCAATG-1	CM
TCGCAGGAGGACTTTC-1	CM
TGTACGACATCGCCTT-1	CM
GCACCTTCAGATTTGC-1	CM
AGACAAATCGCTATTT-1	Myeloid
TAGGAGGGTGTCGTGC-1	Fib
TCACCACGTAACCCAT-1	CM
AAAGGGCGTACAACGG-1	CM
AGTCAACCATTTGGTG-1	CM
AACTTGGGTATATGGA-1	CM
ACTTTCATCCCATAGA-1	CM
GGCACGTGTGATTCCA-1	CM
TTTGGTTGTGCCCAGT-1	Fib
AGTCCGGGTAGCGGTA-1	CM
ACTAACGGTCAAGACG-1	Endo
GTAGGAGCAGGTCCTG-1	CM
GTAGGAGAGGGTGTTG-1	CM
AGGCCTGAGTCAACTC-1	CM
TAGCTTTCAAAGGTCG-1	CM
TGCTTTAAGACTCTTG-1	Fib
GGGACCTCATCCCTCA-1	Myeloid
ACCTGCTGTTAAGTCC-1	CM
CTCATGCTCCTGTGGG-1	CM
CTCAACCGTGTTTCTT-1	CM
AGTTTGGTCAGTCAAC-1	CM
TAGCGGCTCTCCTTAA-1	CM
GCTCCTAAGTCCCGCA-1	CM
TTGCTATTCATTCTCA-1	Myeloid
ATCCTGCCAACACGGA-1	CM
AAAGGATGTAACAATG-1	CM
GAAAGTAAGGACTAGC-1	CM
TTGCACCTCGGCATAT-1	CM
TCTAGTTTCGGGACAA-1	CM
AAAGGGCGTAGGGTCA-1	Fib
TGGAAGGCAGTTGGAG-1	CM
CAACGGCTCGAGAAGC-1	CM
AACTTGGTCGCTACCT-1	Fib
ATCCAGAAGCCATCAT-1	CM
CGCAATATCTTCAGAG-1	CM
TAGCCCTGTACGTATC-1	CM
GTGGCGTTCGGGATCC-1	CM
AGCCTTCCACCGTCTT-1	Myeloid
TAAACCGAGTGAGCAC-1	CM
TAACTTCTCGTGATAC-1	CM
GTGTCCTGTCCCTTTG-1	CM
ACAGAAACATATACGC-1	Fib
GGTACCGAGTTCAACC-1	Neuronal
AGCGTGCGTATCGCGC-1	CM
AGCTGATGTAGGTGAC-1	CM
AGTCCGGAGTCCCGCA-1	CM
ATCCAGAAGCTAGCAG-1	Fib
CACCTGTGTGCCGGTT-1	CM
GACTAACGTCATAGAA-1	CM
CACAACACATGACTGT-1	CM
TTGCTATAGCGGACAT-1	CM
GTAGTACCAGAACAGC-1	Fib
AGCCTTCGTAACTGAA-1	CM
CTGTTCGTCAAGGCCC-1	Fib
TAAGTGCCAAGCAACG-1	Fib
TGTAGCAAGGATGTAT-1	Fib
GTCACAAGTAACCCAT-1	CM
ACGTTAGGTCAGCTTA-1	CM
TAGTCCCCACTGATAC-1	CM
AGTGCCGTCCTCATTA-1	Fib
AACAGTCAGCTGATTC-1	CM
CCATACCTCTTGTACT-1	Fib
CTCAACCCAGGCATTT-1	CM
CGCAATAGTAAACGTA-1	Myeloid
ATCCTGCAGGTTACAA-1	Fib
AGTTACGGTGGAAGCT-1	Fib
TCTCAGCTCCCGTAGG-1	Fib
TGGCAATCATGCACTA-1	vSMCs
CCAGATAGTTGTATCG-1	Myeloid
GAGATTCAGCAATGTA-1	CM
CTGTATTGTGCTTTGA-1	CM
GTCACGGGTATGTCCA-1	CM
AACATCGAGGCATGCA-1	Fib
CCCTAGTTCCTCCCAA-1	CM
CCGTAGGCAGGTCCTG-1	CM
GCTGAGCAGAGAGGTA-1	CM
CTAACTTAGGGAAATG-1	Fib
CCCACATCAGATTAAG-1	CM
TTACGGAAGTACGCGA-1	CM
ATCCCTGAGTACAACA-1	CM
GGAACTTCAACCTCCT-1	Fib
AACGTACAGTCGAGCA-1	CM
AACGAGGAGTGAAGGA-1	CM
AGATTCGTCTATGAGC-1	Fib
TTGCGAATCTGGCTAA-1	CM
ATGTTTCGTTCTTAGG-1	Fib
GTCACTCTCACGTGTA-1	CM
AGCTATGAGAAGACTT-1	Fib
TTCGATTCATTACCTT-1	Fib
TTGACGACACACTAGT-1	CM
GAGAACGGTAACGGTG-1	Fib
GTTATGGTCATTCTCA-1	CM
TACATTCAGGTTCGAG-1	Fib
GAAAGTAAGTCGTACT-1	Endo
CCCACATGTGCATTGT-1	CM
ATGTACGGTGGCCTCA-1	Myeloid
TACATGGCAACTCGAT-1	Myeloid
GCACCTTAGGCCAATG-1	CM
AACGTACAGTTATGAG-1	CM
CAATCCCCATTCCCGT-1	CM
GACCTTCGTTTCCACC-1	CM
GCCTAGGTCTGTAGAC-1	Fib
ACAAGCTGTGCTGTCG-1	Endo
GCATTCCCAGTCCTGG-1	Fib
TTTACGTTCCTGTAGA-1	CM
ATCGAGTCAGAAAGAG-1	Fib
GTCACTCCATCATGTG-1	CM
TTGGTCCAGAGCGGTT-1	CM
TTGAGTGGTTAAGGGC-1	CM
TGACAACAGAGGTGGG-1	CM
GGATAGGGTAACTCCA-1	CM
CTTGCCATCCTAAAGC-1	Fib
GGAGAACTCGTAGCGC-1	Endo
TGGTCAATCCGTCAAA-1	Pericyte
AACCGATCATTGCCTC-1	CM
GGGCCATGTATTGTCG-1	Fib
CTTGCCAGTTTGAAGA-1	Myeloid
CATTGGATCGTGCTTC-1	CM
CAGTGCGCACGCCGAT-1	CM
GACTAACGTAGAGAGA-1	CM
ATGCATGCAGGTGTCC-1	CM
TACGCCTCAGATTAAG-1	Fib
CAAAGCTGTGAGTAAT-1	Endo
CCGTACTCAATCATCG-1	CM
AATACGCAGTGCTCGC-1	CM
CATAACGCATTACACG-1	Fib
TTTGAGGTCAACACGT-1	CM
CCATACCAGTAGGTCG-1	Fib
TTCTAACGTCGATTAC-1	CM
ATCCTGCAGAAAGCAG-1	CM
ACGGATTAGCAGAGCT-1	Fib
TACCCTGGTTTGCGAT-1	CM
TTACCGCTCTACTGCC-1	Fib
GGTCATAAGTCATACC-1	Myeloid
CTGCTCAGTGAATGTA-1	Endo
ACCCAAAAGATTCCGT-1	CM
GCGATCGGTTCCATCC-1	Fib
TCACTCGAGAGCCACA-1	CM
CCTATTAGTTACTTTC-1	CM
TGCTATTAGAGAAGCA-1	Fib
CTCAGAAAGTAGAAGG-1	CM
TACATGGTCGTTGTTT-1	CM
TCACAGACAATGTAAG-1	CM
TTGCACCAGTCAACTC-1	CM
CTCAGAACAATGCCAT-1	Fib
TGCTATTTCCGTGCGA-1	Pericyte
GGTGTCGTCGCTACCT-1	CM
AGGCCTGTCGCACCTT-1	CM
TAGTCCCTCCATCATT-1	CM
CAAGCTATCACGATTG-1	Fib
CTTCCAGCAACTCGAT-1	Endo
CCGTACTAGAAATCTG-1	CM
TCTATTGTCCGTTTCG-1	Fib
GCTCAGGCAAATAGTG-1	CM
GCCTACTGTAGCAGCA-1	Fib
TCACAGAAGCCTGTAT-1	Myeloid
TCGCCTAAGAATCAAC-1	Fib
TCAATTCGTTTCTCTA-1	CM
GCACGCAGTAGATGAT-1	CM
GGAGTAGCAGTCAGCC-1	CM
TTGCAGACATCAGAAA-1	CM
CTCATGCGTGCAACAG-1	CM
CTCAACCGTGCGACCT-1	Fib
TATGTTCGTGGTTCTA-1	Fib
GACTAGTAGGATGTAT-1	Endo
TGGGTGCCAAATGTCC-1	CM
AGCGTGCGTGTGCTTA-1	CM
GCTTTCGGTAACTGAA-1	CM
GGAGTAGGTTGTCGGC-1	Endo
CTTGAAGGTCGATTAC-1	Fib
CAGCCTTGTCGATTAC-1	CM
CTCACCAGTATGGTTC-1	CM
TGGCGCATCTTGTCGC-1	Endo
TGGCCTTCAGTTAAAG-1	vSMCs
CGGACTGAGACAGCTG-1	CM
TGTGGCGGTAGGTGAC-1	Myeloid
TAATCGGAGTCAACTC-1	CM
TTACGGACATAAAGTG-1	Endo
ATATTCCCAAGTAACA-1	Fib
GATCGTACAATGGCTT-1	Myeloid
ATTGTCTAGGGTCCCT-1	CM
AGGCCTGGTAAACGGC-1	Lymphoid
TTTGTGTAGATATGAC-1	CM
GCATTGAAGAACAGGA-1	Fib
CCCTAGTGTTTCCGGG-1	Myeloid
CCTGGGACACATATCG-1	CM
GGATGAGCAGGTAACG-1	Fib
AGCGTGCTCATTCTCA-1	CM
TAAGTGCCATATAGAG-1	Fib
TACCTCGAGTCACACT-1	Fib
GAAATGAAGAGCTGTG-1	Myeloid
ACGTGGCCAATGGCAG-1	Fib
TGCTCGTCACGCGTTG-1	Pericyte
GCGTTGGCAGATACAA-1	Fib
ACAAGCTTCCTATCAT-1	CM
CTCAACCAGAGCTGTG-1	CM
AACGAGGAGAGCTGTG-1	CM
TTACGTTTCGTGCTTC-1	CM
TGCGTAATCACTGATG-1	CM
GCCAGACCATCGACCG-1	CM
CTTTGCGCACTTATGG-1	CM
TAGCCGGGTTAAGTCC-1	CM
AGCCTTCCACAGCCAC-1	Fib
GGAGGATAGAGTAAGG-1	Fib
TCAATTCTCCACCTAC-1	CM
CGCAATAAGTACGCGA-1	CM
TTGCAGAGTAGCAGCA-1	Fib
AACAAAGCAGCGCGTT-1	Endo
TGGCCTTAGCCCATGC-1	Fib
AGTGTACCAGCGTCGT-1	Fib
GATGGCCTCCCATAGA-1	Fib
GTCCATCAGGCGTAGT-1	CM
GGTGCTGCAAATTGAG-1	CM
TGACAACGTCAGTGTT-1	CM
AGTTTGGAGGGTTCTT-1	Endo
CTCAGCTAGTTACCAC-1	CM
CTAACTTTCATTCTTG-1	Fib
GTCACAAAGGTAGGCT-1	CM
TACCTCGCAGTCAGCC-1	CM
CTTGCTGGTAGAATAC-1	CM
TATTGCTCAAAGAAGG-1	Fib
CAACGTATCCATAGGT-1	CM
GTGATCATCTATAGGC-1	Fib
TGTACAGTCACAACAC-1	Fib
GAACTTGCATACAACC-1	CM
GCGTTGGCATATACGC-1	CM
TATGTGGCAGGCATCC-1	Fib
CGGTGCAGTCTGCACG-1	Pericyte
GAGTGAGCACCCATCT-1	Endo
TACTGCCGTTAACCGT-1	Myeloid
GGCGTTGGTATCACAC-1	CM
TACTCGCAGAGCGGTT-1	Fib
AGCTGTATCGTTCTAT-1	Fib
GTTACGATCCGTGCGA-1	CM
GTAATCGCATCATCGA-1	Fib
TTGAGTGAGCGTTGCC-1	Fib
AGCTGTACAAATAGTG-1	Fib
CTGGCAGGTCCGAGCT-1	vSMCs
TTCGATTTCCGGGCAT-1	Endo
TAGTCCCCATCGACCG-1	CM
GTTGGGCGTTAGAGAT-1	Pericyte
TTTGGCCGTCTGGATT-1	CM
TCCCACAGTGCTGTGC-1	CM
ACTTTCAAGTGAGTTA-1	Fib
AGCCGCATCCGCTATC-1	CM
TCGATTTCACTAGCCG-1	CM
TGCATGAGTGAATGTA-1	Pericyte
AGCTATGAGGGCTTCC-1	Fib
TTTGAGGTCAGCACGC-1	Endo
CGTACAAAGTATGCTC-1	CM
ACGGATTAGACAACGC-1	CM
GCTCAGGCATTATGGC-1	CM
AGGCGAAGTTCCTATT-1	Fib
TTGTTCACAACCTCTC-1	CM
TCAAAGCTCCTGTAGA-1	CM
CCTCCCTGTGTCTCGG-1	Fib
TACGGATTCCCGGGTA-1	Endo
ATCGAGTTCCTCTCTT-1	Fib
TAAGTGCTCATCGCAA-1	Fib
TACCTCGGTAACGTAA-1	Fib
GAAGTCTGTGATGCTT-1	Endo
TCAGTTTGTCATAGAA-1	Fib
TACCCTGTCTCGTGAA-1	CM
GTCACAAGTCCTATTT-1	Fib
GATGATCAGGGCTCTC-1	CM
TGGACATCACCTACCT-1	Fib
CACCACTTCTCGTGAA-1	Myeloid
GCCAGACGTAAACCCT-1	Pericyte
ATTACCTTCTTCATAC-1	Fib
ACCTGCTGTAACGGTG-1	CM
TGCATTTAGGTAAGCC-1	CM
ATGGATCCAGAACTTC-1	CM
TGAATCGCAGGGTAAC-1	CM
CACTGAACACAAACGG-1	Fib
TTGCTTAAGAAATCTG-1	Fib
GGAATCTTCCAGGTCG-1	Myeloid
ATAGTCGAGTCGACCC-1	Endo
GCCTAGGCATTAAGGA-1	CM
TAACAGCCAACGTACT-1	Fib
GCAGCCAAGTTCGTTG-1	CM
TGGGTGCAGTAGGTCG-1	Fib
TCGCCTATCCGAGGAA-1	CM
AACATCGCATCTCTCG-1	CM
TTGGTCCTCCTTGACC-1	CM
TCAGTCCGTCGCTACG-1	Fib
GCGTTGGAGGACTAGC-1	CM
CAGCTGGTCTTCGTTA-1	Myeloid
CTGTTCGCACGGCCAT-1	CM
TTGCGAAAGCTCGGCT-1	Endo
GTGATCAGTCAGGCTC-1	CM
TTGCGGGGTCTAAGAA-1	Fib
TGGTCCTGTTCCCTTG-1	Fib
ACCATCCCAGTATACC-1	Fib
GTAATCGTCCTCCATG-1	CM
TCTAGTTAGAAAGGGT-1	Fib
TTACTCACAACATAAG-1	Fib
ATGTTTCAGTCGTACT-1	CM
TCAGCTCAGCGTATCT-1	Fib
GGTAGGACAAGCAACG-1	Fib
TACTCGCCATGATTGC-1	CM
ATTACCTTCGTCAACA-1	CM
GTAGTACTCTGGGCGT-1	Endo
AGGCGAACAACGCACC-1	Pericyte
ATGTCGATCTGTTTAC-1	Endo
CCTTGGTTCAAACCCA-1	Fib
AGTCCGGGTAACGTAA-1	Endo
TCAAAGCAGTGCTCGC-1	Fib
GACCCAGCAGCAACAG-1	Fib
CTGGCAGTCTCGCGGA-1	Fib
GAAACAATCGTCCCTA-1	Endo
CCGTGAGCAGCAACAG-1	Fib
TTGAGCATCTCGTGAA-1	Fib
AAACTCGTCAGAACGG-1	Fib
TTATGTCGTCCATTGA-1	Endo
AGTGCCGGTAACCATC-1	CM
GACCTTCAGGGCATTG-1	Fib
CCTTGCAAGAACGACC-1	CM
GTTCAAGCAGCCACGT-1	Endo
TAACAGCCATGGTTTG-1	Fib
GCAACCGCATGGAGGT-1	Fib
GCCAGCAGTACGGATG-1	Fib
TCTATTGGTAGCATGG-1	Fib
TAGTCCCTCCTCCTGA-1	Fib
ACCCAAATCAGGATCT-1	Myeloid
TGTGACAAGTCTCTAG-1	Myeloid
GTGTCAAAGTTCGTTG-1	Fib
TAATCGGTCGCGATGC-1	CM
GACTAACTCCAGGCCA-1	Fib
TATGTTCAGCCTATAC-1	CM
TAACGGTGTAGCAGGT-1	CM
ACTTCCGCAATTAGGA-1	Fib
ATGCATGGTAGTTTGC-1	CM
CTAGGGCGTCAGCAAG-1	CM
ATTACCTCAGGGAGTT-1	Pericyte
ATATTCCAGTTGGAAT-1	CM
AGTTTGGCAGGATAGC-1	CM
TGACAACGTGCATTGT-1	Fib
ATTACTCGTTCCCTTG-1	CM
GACCGACAGCAATAAC-1	Fib
GAGAACGTCAAGAGGC-1	Fib
AAAGGGCCAGGTGTGA-1	Fib
TGCGTAAAGTGTCGGA-1	Fib
CTTGAAGGTTCCGCGA-1	Fib
CAAGCTAGTAGGTAAT-1	Fib
ACTCGGGTCGACGGAA-1	CM
GCTCGAGGTAGACGCA-1	CM
GGAATCTGTCCCGAGT-1	Endo
ACAGGCCTCCGCTATC-1	Myeloid
TACATTCAGGCAGATC-1	CM
TTCGCGTCATGATCGT-1	Fib
AGATAGACATTATGGC-1	CM
ATCCCTGCACTCGGAC-1	CM
GCTGTTCAGGGCGAAG-1	Myeloid
ACCGGGTCACACATGT-1	Fib
GAACCTACAAAGCTTC-1	Endo
CGGACCAGTTGGCTAT-1	CM
CACATGAGTCTCTGCT-1	Fib
GTCACGGGTTCTGAAC-1	CM
TTCGCGTGTATGGATA-1	Endo
CTCACCAAGACCCATT-1	Myeloid
TCAAAGCAGCTACGCC-1	Fib
GTTATTCCACGATATC-1	CM
GCATTCCGTGATAGAT-1	Myeloid
ACAAAGAAGGGATCCA-1	Fib
CTAGGGCGTCGTCGCA-1	Fib
CCCTAACTCCATATCT-1	Endo
AGCCTGGTCGTGGGTC-1	CM
AACTGTGGTGGAAAGA-1	Pericyte
AAAGGGCAGACCGCAA-1	CM
ATTACTCAGGCGATTG-1	CM
ACCCAAAGTCCAAGTT-1	Endo
AGTGCCGCAAGGAAGA-1	Fib
CTTTGCGTCCATACGA-1	Endo
TCAAGGTCACTGTAAC-1	Endo
TACATGGAGCTGATTC-1	CM
TAGCGGCTCTGCGTCT-1	Endo
GAGTGAGCAAGTTCGT-1	Fib
TGAGTCACACAGTTAC-1	CM
GGTAGGATCCACGCTT-1	Myeloid
GGAGGATTCAGTCACA-1	Fib
GTGGCGTTCCTTACGC-1	Fib
CTTAATCCAAGTCTGT-1	Myeloid
AGCGTGCCACAGCCAC-1	CM
CACCTGTTCGTGCTTC-1	Fib
TCTATTGTCAGTCAAC-1	Myeloid
TGATGCATCCAGAATC-1	Myeloid
AGGCGTCAGAACTAAC-1	Fib
TGCTATTTCCTTCGAC-1	Fib
ACAGCGCAGAAGCCGT-1	Myeloid
GCCATAAAGCTGAGGT-1	CM
ACATGCACAATTCTCT-1	Endo
TCAAGCATCGAGCGCT-1	Pericyte
AACGAGGGTTCCGGCA-1	CM
CAGCCTTGTCTCTGCT-1	Myeloid
ACCCAAACACTGTTAG-1	Fib
TTTGAGGCAACATAAG-1	Myeloid
TTGCACCAGCCATGGA-1	CM
GCAACCGAGGAGTACC-1	Fib
TAGTCCCGTTCTTTCA-1	Pericyte
GTGATCAGTAACTGAA-1	Fib
ACCATCCGTCAGAAGC-1	Fib
CCCTGATGTATGGGTG-1	Endo
CAAGGCCGTAAGTCTC-1	Fib
CGTGGCAGTTTCCTAT-1	Myeloid
TGCCTGTTCTGAGTCA-1	Fib
GGGTCTGGTGTACGCC-1	CM
TTGTCTATCGGAGTTT-1	CM
TAACTTCAGGATTGAT-1	CM
AGACAAAAGTTACCAC-1	Pericyte
GCATGATGTCCGTGCA-1	Myeloid
GGTCATAGTGAATCGG-1	CM
TTGCCCAAGTGTCGCC-1	CM
AGCTGGCTCGGTCCGA-1	Fib
CACCACTAGAAGACTT-1	Endo
GGATGAGAGGCACCTC-1	CM
ATTGTGGGTATACGCT-1	Endo
CATAACGAGAAGACTT-1	Myeloid
AGGCGAAGTTGCAGAG-1	Myeloid
TTGTTCAAGACCTATC-1	Fib
GCTTGCTGTGCAACAG-1	Endo
TTGCACCGTTTGTAGC-1	CM
CCAGATATCGCTAGTA-1	Pericyte
CTAGGATCATCCCTTG-1	Pericyte
CATGCCTTCGGGCTCA-1	CM
TTGACGATCCATCATT-1	Fib
GCCAGCAGTCCTTATT-1	Fib
GAACTTGCACAATAAG-1	Endo
TAACTTCGTCAGTGTT-1	CM
CTCATGCCAGTAGTTC-1	Fib
TAACTTCCAAGAGCGT-1	Endo
TGTGGCGAGTACGCGA-1	CM
GCATTCCTCCGGAAAG-1	Endo
GCACGGTGTCAGTGTT-1	Fib
CCGTGAGCACAGAAGC-1	CM
AGATAGAAGTGTTCCA-1	Fib
CAACGTAAGCCAGAAC-1	CM
TGAGTCACAAGCCAGA-1	Myeloid
GTTACGAAGGCCTCGT-1	Fib
TCACAGAGTTAACCGT-1	Myeloid
GCACGGTGTAGGTGAC-1	Fib
AGCGATTTCTATTTCG-1	Fib
CAATCCCCATTGATGC-1	Fib
GCGTAGCAGGAGTCTG-1	Myeloid
GTTACGACATAGACGG-1	Fib
ATAGGCTGTAAGTCTC-1	CM
GCTTTCGCAATCCATG-1	Endo
TTGAGTGTCTTCGTTA-1	Endo
GGTACCGTCAGTGTGT-1	Lymphoid
GCGTTGGGTCGCGCTA-1	Myeloid
CTCATGCAGAACCCGA-1	Pericyte
TCAAAGCGTCCCTAAA-1	Endo
AGCGATTTCGTATAGC-1	Fib
AACGTACCACTTATGG-1	Fib
CAGCCTTCACTGGGCT-1	CM
TAGCCCTGTACGACCC-1	CM
CCCTAACTCAATGCAC-1	Endo
CATGCCTAGCCATTCA-1	Pericyte
TCCGACTAGTACGACG-1	Fib
GTTGGTATCGCTTACC-1	CM
TTCATCACAATAGTGA-1	Fib
GTGTGATTCTCGACAA-1	Fib
TCGATTTTCCCACGGA-1	Endo
CTTGCCAGTATCAGCT-1	Endo
CAGTGTATCAGGTCTA-1	Myeloid
ATGTCTTGTTCAGTTG-1	CM
CAAAGCTAGCTGATTC-1	Fib
TCGCCTAAGGTGTCGA-1	Endo
TACTCGCCAACCTCTC-1	CM
GATTGACAGTGCTCGC-1	Myeloid
TTCATTGAGCGGACTA-1	Neuronal
AACGTACCAACGCACC-1	Myeloid
ATTGTGGCATTCACCC-1	Myeloid
CCTCCCTAGATGTTCC-1	Fib
TTACTTGGTGCTTTGA-1	vSMCs
GCATTCCTCCCTAAAG-1	Fib
ACAAAGACACTCGTGG-1	CM
GAGGATGCAGCCACGT-1	Myeloid
CCAGATAAGACACTTC-1	Fib
CTCAGAATCTGGCGCA-1	CM
TTCGTTAAGGCTCCTG-1	Endo
GAATCTGAGGTCGTTT-1	Fib
GGCACGTGTCGACTGC-1	CM
TTGACGAGTCAAACAA-1	Pericyte
TAATTCCCATTCGTCC-1	Endo
GAGGCTCGTCAACTGT-1	Fib
AACCAACAGAGAGGTA-1	CM
CTCAACCGTAGCTGTT-1	Pericyte
AACGTACAGTTGCGCC-1	Fib
CAGTGCGGTATCATGC-1	Pericyte
TGCCTGTTCCATATCT-1	CM
GCTGAGCTCTCGGCGA-1	Lymphoid
CCGAAGCAGGCGCTTC-1	CM
ACAAGCTCAATTGTGC-1	Endo
TTGGTCCCAAACCCTA-1	Lymphoid
ATGTACGCAAGAGCGT-1	Myeloid
AACCGATGTCCAGACC-1	Endo
GGAACCCAGTTCAAGA-1	Fib
CAGCCTTGTCACTCTC-1	Fib
ACATGGTAGGCAAGGG-1	Fib
ACTACCCCAATTGCCA-1	CM
TCGGGACAGCGCCTAC-1	Fib
CCCTGATGTGATGTGG-1	Fib
GCTCACTAGAGACTCG-1	Pericyte
CTCAGAAGTTACGGAG-1	Fib
CCGTACTTCCCAGCGA-1	Fib
GGGTCTGAGGTTGTTC-1	CM
ATTACTCGTGTGACCC-1	Fib
CATGTTTCATTATGGC-1	Fib
GGTGCTGTCTACATCT-1	Fib
TGCACCTGTGTAGGAC-1	Fib
AGCGATTGTGATGTGG-1	CM
CAACGTAAGCATGATA-1	CM
TAGCCCTCATTTGTTC-1	Fib
GCGATTATCATTCATC-1	CM
TTGTCTAGTATCTGCA-1	Endo
ATCGAGTCAAAGCTTC-1	Fib
GCCCGAACAAGTAATG-1	Endo
TAAGTGCTCGATCGCG-1	Myeloid
TTACGGAAGTCTGTGT-1	Fib
TGCACCTGTGGGTAGT-1	Fib
CACGTTCGTATTCGAC-1	Fib
CGCTAGGCATGCGACC-1	Fib
GGTCATATCGCTCGGA-1	Fib
AGCCTTCGTTCTGAGT-1	Pericyte
CATGCCTTCGACGGAA-1	Pericyte
AACTTGGAGCGCCTAC-1	Fib
GGCGAAAAGTCAGGAC-1	Fib
GTCACTCTCCATCTAT-1	Endo
CTCTAGCAGACAGTGC-1	CM
AATGGCTGTAGCGAGT-1	Pericyte
GTCACGGGTCGACTGC-1	Endo
CCCTAACAGGGAAGCG-1	vSMCs
TTTGGTTCATGTGGGA-1	Pericyte
TTGACGAGTCCGAGCT-1	CM
TCAGTTTTCGAGAAGC-1	Fib
GCTTGCTGTGAGTAAT-1	CM
TCAAGGTCAGTCAGCC-1	Fib
GAGCGCTTCGCAAGCC-1	Pericyte
CACCTTGTCGTCTTAT-1	Myeloid
GAAAGTAGTGGAAAGA-1	Pericyte
AAACTCGGTTAACTCG-1	Myeloid
TTGTCTAGTTTGTACG-1	Neuronal
TCGTTCGTCCATACCC-1	Pericyte
CTGAATGGTCTGCGCA-1	CM
CAACGTAAGGAAGGTA-1	Fib
TGCTCACAGCTCCATA-1	Fib
GGAGGATCATTCGTCC-1	CM
TATGTTCGTGTTAGAA-1	Fib
CACAGATTCGCACCTT-1	Lymphoid
GAAAGTAGTGCCGGTT-1	CM
GCGGGTTTCGTTGTAG-1	Pericyte
TATTGCTAGTTGCGCC-1	CM
TATGTTCAGTGGACGT-1	Pericyte
TCAGCTCAGTCGACCC-1	CM
AACGTACCATGCCTTC-1	Endo
TCTCAGCCACATATCG-1	CM
ATTGTCTCATTAAGGA-1	Pericyte
TATTGCTAGATGTTCC-1	CM
CTCACCAAGTCAGGAC-1	Fib
TGGCAATGTGGCCTCA-1	Endo
TGCTTTAGTGATGTGG-1	Pericyte
AACTTGGAGTCTGTGT-1	vSMCs
CCTTGGTAGACGACTG-1	CM
GGAATCTCACAGGAAC-1	Endo
TCAGTCCAGAATAGTC-1	Fib
TGCCTCAAGAGTTCGG-1	Pericyte
ATGCATGGTCGCTAGC-1	Fib
ATGCATGAGAGGCAGG-1	Fib
AGCTGGCAGCAGTAGC-1	Fib
ATGCATGTCGTGCTTC-1	Neuronal
CAGCTGGAGAGGAACA-1	CM
GTGTCCTTCTGAGTCA-1	Fib
AGCTGTAAGAACGACC-1	Fib
AGATAGACAACCTCCT-1	Fib
GTGTCAACACTGTCGG-1	Myeloid
ATGTCGACAAGATTAG-1	Fib
CTGCGTTCAACCTCTC-1	CM
ATGTCTTCAGAGCCAA-1	Endo
GCACCTTCATGATTGC-1	Neuronal
TAGCCCTGTCGATAGG-1	CM
CAACCAACAACGTCGC-1	Endo
GTCACTCGTATGTCCA-1	Fib
ACCGAATGTCATAGCT-1	Myeloid
TTTGCGCGTCTGCGCA-1	Pericyte
TAACTTCGTCTAACCA-1	CM
GGATAGGTCCTCCTGA-1	Fib
GACCGACTCATCGCAA-1	Fib
GGAGAACTCCGAGGAA-1	Endo
CTAGGGCAGCGTGTTT-1	Fib
GTCACCTAGAAGACTT-1	Myeloid
GGGTTATAGTGAGTTA-1	Fib
GAGCGCTTCCGAATTG-1	Myeloid
ACGTTAGCAGGGAGTT-1	Endo
TGATCAGAGGGTAATT-1	Pericyte
AGCGATTTCGACTCGG-1	Endo
AGCTGGCCAGCTGATT-1	CM
ACAGGCCAGAGAATTC-1	Myeloid
TAGCATGAGTCACGCC-1	Fib
CTCTAGCAGTAGGAAG-1	Endo
ATGTTTCGTTTGCCAA-1	Pericyte
GGGTCTGAGATTACGA-1	CM
ATGCATGAGTTGTCCA-1	Pericyte
GCACGCACAACGCACC-1	Fib
GAGTGAGAGAGATTAC-1	Endo
GACCCAGAGTACGCGA-1	Pericyte
TATTGCTCAACGGGTA-1	Neuronal
AAATGCCAGGGCTTCC-1	Neuronal
TGATTTCTCAGCACGC-1	Pericyte
ACTACGATCCAAGTCA-1	Fib
ACTATTCGTGTCGTCG-1	Endo
TTGGTCCGTGCTTTGA-1	Endo
AGCTGGCAGATGTTCC-1	Fib
TCACAAGAGTTGCGCC-1	Fib
TACCTATCATTATGGC-1	CM
TGACAACAGGTGAACC-1	Myeloid
AAAGATGGTCATTGCA-1	Pericyte
CTCATGCAGATTACGA-1	Endo
GGAATCTCAGTGGTCC-1	Fib
TTCAACTGTATCGCGC-1	Pericyte
TACCTATAGTTGAATG-1	Endo
CGCTGGAGTGCTTACA-1	Endo
GGTCATAGTTACACTG-1	Fib
CCATACCAGTTTACGC-1	Pericyte
AATGGCTAGCGAATAT-1	CM
CACATGAGTATGTTCG-1	Pericyte
AACATCGGTGGCCTTG-1	Lymphoid
CCCTAACTCTTTGCAT-1	CM
TTAGCGAGTGATAAGT-1	Lymphoid
TTACTCAAGTCGTACT-1	CM
CGCAATAAGGCAGTAC-1	Pericyte
GTCACCTAGCGATACG-1	Fib
TTGCACCAGGGTAGTC-1	Fib
ATCCAGATCAGCACGC-1	CM
GTAGTACCAAATTCCG-1	Myeloid
CGCACAGTCGGATAAA-1	CM
GTGCTGGAGTCCGATT-1	CM
AACGGGAAGAGCTCCC-1	Myeloid
TTAGCTTAGTTGCCGC-1	CM
TGTACGAAGAACGACC-1	CM
TAATCGGAGCGAATAT-1	Endo
ACAAACCAGGGAAGCG-1	CM
GCTGAGCGTATCCCTC-1	Myeloid
GGTGTCGAGAAGCCGT-1	Pericyte
CACCACTTCCATTGAG-1	CM
TAAGTGCCACAACGGA-1	Myeloid
TCACTCGTCGATGAAA-1	Fib
GAGACTTAGCTCGGCT-1	Fib
ATTGTCTTCATCGCCT-1	CM
TTCTGTAAGGTTGTGG-1	Fib
AGCCCGACAGGTTATC-1	Endo
CGCGCAATCTCGCGTT-1	Lymphoid
TAGCATGCACATTCTT-1	Pericyte
TACCCTGTCGATGAAA-1	CM
GGACACCAGTCACGCC-1	Fib
CGATGATGTTTAGAAG-1	Endo
GTCACGGAGCTAGTTC-1	Myeloid
TTGCACCGTCACTCTC-1	CM
TCAGTCCCACCACAGC-1	Endo
CAACGTACATTCGTCC-1	CM
AGTCCGGAGTAACACA-1	Endo
TTGAGTGTCGAGAAGC-1	Endo
AATGGAAGTCAGTGTT-1	Endo
TGGTCCTAGCTACGCC-1	Lymphoid
ATGTTTCAGTGTCGCC-1	Fib
AGCTGGCGTGTCTCGG-1	CM
TCAGTCCCACCACCAG-1	Pericyte
ATTGTCTTCGACTCGG-1	Fib
TTTGCGCGTGCTGGCT-1	Myeloid
TGTGGCGGTCAGTGTT-1	Fib
TCTCAGCAGGATGCCA-1	CM
AATGTCGTCACGGGTC-1	CM
GCTTTCGAGACGACTG-1	CM
AGCCAGCAGAGTGGTC-1	CM
AACGTACCAGGGTAAC-1	Pericyte
TGACAACTCCGAGGAA-1	Pericyte
AATGGCTCAAAGAAGG-1	Fib
ACCTGCTAGTTCGTTG-1	CM
TATGTTCGTCTAACCA-1	Endo
ACCCAAAAGGATTGCG-1	Endo
ACGGATTAGAACTCCT-1	Endo
TATCGAGCATGTAGAA-1	Endo
GCGCCAAGTCAACAGG-1	Pericyte
ATCCTGCGTACGAGAC-1	CM
GACTAGTTCGCTATAG-1	Endo
CCTTGCAGTTGGGAAC-1	CM
GTCACAAAGAAGACTT-1	Myeloid
GTCACAAGTAGTATCC-1	CM
CATGTTTCAAACCTAC-1	Fib
GGGAACATCTAAGGTC-1	Fib
ATCCTGCCATGGCCCA-1	Lymphoid
CAAAGCTCACACGGTC-1	Fib
GATGATCTCAGAACGG-1	Pericyte
GCGTTGGTCGCCGAAC-1	CM
GATGATCCAGTTGGAG-1	CM
GCTCAGGCAAACCTAC-1	CM
CAGGATTAGAGAACCC-1	Fib
AGTTTGGTCATCGCCT-1	CM
TGAGCCGGTGGCATAG-1	CM
TCACCACTCACGGGTC-1	CM
GAAGAGCAGGCGATTG-1	Neuronal
TAAACCGCAGATTAAG-1	Fib
TTGCACCGTGTAGGAC-1	CM
GACCTTCCACACGGTC-1	CM
CCTGCTAGTCTGAGCC-1	CM
TACCTATCAAACCTAC-1	CM
AACAAAGGTGTACGCC-1	Endo
AGTCCGGCATAGCAGG-1	Endo
TAGCCGGTCATACTTC-1	CM
ATTCGTTGTAGTCCAT-1	CM
CTCACCATCGTGCTTC-1	CM
CTGTATTGTTCTACCC-1	Fib
CTGGGACAGTGTCGCC-1	CM
GAGCGCTAGAATAGTC-1	CM
AGCTGTATCGGGCTCA-1	Endo
CAGCTAACAGTGCGTC-1	CM
GCATTGATCATCGCCT-1	CM
AGCTGGCCATGATTGC-1	CM
ACTGTCCAGAGTGGTC-1	CM
TCAAGCACACTGCTCT-1	CM
GTCACAAAGCGATACG-1	CM
AACAAAGAGCATTCCA-1	CM
TGCCTCAAGCTCCATA-1	Endo
CTGCTCAAGGGTAGTC-1	CM
AGCTGGCCAACCTCTC-1	CM
GCTTTCGGTTTAGAAG-1	CM
TACGGATTCAAGGCCC-1	Endo
CCCACATGTCAATACC-1	CM
CCGTACTCAGTGCGTC-1	CM
GCTCACTAGTCAACTC-1	CM
GCGGTGTGTTAACCGT-1	Myeloid
GCTCAGGCAACTTGGT-1	vSMCs
ACTACGACAGGCATTT-1	Lymphoid
CACAGATAGAAATGGG-1	CM
AGTCCGGCAAGGACCA-1	CM
ACTACGAAGTTCAACC-1	Neuronal
GGAATCTAGCGATACG-1	Endo
AACCGATAGTCAACTC-1	CM
AAACGAAGTCAGTGTT-1	CM
TATCGAGCACTCGGAC-1	Endo
CATTCATAGGCTTTAC-1	CM
ACAGCGCGTCATCAAC-1	CM
TGTACGATCTTTGCAT-1	CM
TCTATTGAGGTGATGC-1	Lymphoid
AGTTTGGTCGAGAAGC-1	Fib
AGCGTGCCAGTGCGTC-1	CM
GGAGGATGTTTAGACC-1	CM
TTGCACCAGCCTGGTC-1	CM
GTTACTTAGAGCTGTG-1	Endo
TCCAGAAAGCATGATA-1	CM
GGGTCTGAGCAGAGCT-1	CM
CGCAGGTTCGCGTTCT-1	Fib
TCCAGAAAGGAAGGTA-1	Pericyte
AGATAGACAAACCTAC-1	CM
TACCTCGCACGGCCAT-1	CM
TGCATTTCAACTAGAA-1	CM
ACATGCAAGGGTAGTC-1	CM
CTGTATTAGTCAACTC-1	CM
ACTAACGCAGTCCTGG-1	Fib
GGAACTTAGTCAACTC-1	CM
TATCGAGAGAAGACTT-1	Myeloid
TCCAGAAAGTCAACTC-1	CM
ATATTCCAGAAGCCTG-1	Endo
AGCGTATTCAAGAGAT-1	CM
TGCACCTAGAAATGGG-1	CM
CAGCTGGGTGAATGTA-1	CM
AACGAGGGTACGCCCA-1	CM
GATGATCCAAACAGTA-1	Pericyte
CCCTAACTCATTGCCC-1	Myeloid
GAGCGCTGTCGAGGAT-1	Myeloid
ACTTCCGCACCTTGTC-1	CM
CACATGACAACTGCGC-1	CM
CTGTATTAGCCAGAAC-1	Endo
AGGCGAAAGAAGCCTG-1	Endo
CGTTCCAAGAAGCCTG-1	Endo
TCAGTTTCAAAGAAGG-1	CM
TGCATTTCAACACGGA-1	CM
GCCAGCACACTTGCGG-1	CM
ACTTTCAAGTGCACAG-1	CM
ATGTCGAAGAAGACTT-1	Myeloid
TGTGGCGGTAGACACG-1	Fib
GTGACATCAAAGAAGG-1	CM
ACAGCGCTCACTCGTC-1	CM
ATTCGTTTCGGGAAAC-1	CM
TAGCATGCACTCGGAC-1	CM
GGGTCTGAGCCCATTA-1	Myeloid
CGTACAACAACACGGA-1	CM
ACGTGGCGTCCGTGCA-1	CM
CCCACATGTCCGTAGC-1	CM
GGAATCTAGAAGACTT-1	Myeloid
CGTAAACAGTCAACTC-1	CM
TATCTGTGTAGTCCAT-1	CM
TCCAGAAAGCCAGAAC-1	CM
CCGTAGGCAAAGAAGG-1	CM
TTCATTGCAGTTGGAG-1	CM
TGCGTAACATTGAACC-1	Endo
CCTCCCTTCAGTCAAC-1	CM
TCTATTGTCATCGCCT-1	Myeloid
GCTTTCGGTTGGAGGT-1	CM
TTGAGTGGTTAACCGT-1	CM
TTACTTGTCGACGGAA-1	CM
