Barcode	cell_type
CCCACATGTTCCAATG-1	CM
CCATACCGTTCTGAGT-1	CM
ATTTGTCAGATTGACA-1	CM
GATTGACAGTCATACC-1	CM
GCGCATGTCGGTGATT-1	CM
GCCAGACAGGGCTCTC-1	CM
CCACAGGGTACAAATG-1	CM
CCTGCTAAGCTAGCAG-1	CM
CCCTAGTAGGGAAATG-1	CM
ATCGAGTTCTCTGCGT-1	Pericyte
TTCAACTGTGCAACAG-1	CM
CACAGATGTTAACCGT-1	CM
AGCCTGGCAAGTCTCA-1	CM
AAAGGATTCAAGGCCC-1	Endo
ACTCGGGGTACCGGCT-1	CM
CCCAGAGGTGAAACAT-1	CM
AACATCGCAAGCGAAC-1	CM
AGCTGATCACTGATAC-1	CM
TAGGTGTCAAACCGAG-1	CM
AGCCGCACAATCAGGG-1	Fib
TTGGTCCTCCTGTGGG-1	CM
GCGGAAAGTCTCTGCT-1	CM
TACATTCTCACCGCGA-1	CM
TAAACCGCAGCACATT-1	CM
TCACAAGGTAAACGTA-1	CM
GCGAGTCAGCGCCTAC-1	CM
ACTCGGGCAGGGTACA-1	CM
TTCAACTCATTTGGTG-1	vSMCs
CCAGATAAGGCCTAAG-1	CM
TACATTCTCCGTGCAG-1	CM
GTCACTCCAAGTCTCA-1	CM
TGCGTAAGTTGGCGAA-1	CM
GAAATGAAGCAACGGT-1	CM
GAAATGATCGCGCTGA-1	CM
AGATAGAAGTGCTCGC-1	CM
GTGGATTGTTTAGGAA-1	CM
GAACCGCCATCCTGGG-1	CM
ACCTGCTCATCGAGTT-1	CM
CATAACGTCTGAACGT-1	CM
ACTCGGGGTCATAGAA-1	CM
GAAGTGGAGAGCTGTG-1	CM
CCAATGAAGATATGTG-1	CM
CCGAAGCCAAGAGATT-1	CM
CAAGCTAAGGTTACAA-1	CM
ACAAAGATCAGTCTTT-1	CM
GAAGTCTTCCTCATTA-1	CM
ATCGAGTGTAAGGTCG-1	CM
TAGCCCTGTGCAAGCA-1	Endo
TGGTCCTAGCCCATGC-1	CM
TAACTTCGTCCAAGAG-1	CM
CACGTTCCAAGAGATT-1	CM
CACCACTAGGTAGGCT-1	CM
CTCTACGAGGTCTTGT-1	CM
GGATAGGAGGGAGATA-1	CM
GTTGGTATCACTAGCA-1	CM
ACAGAAAAGATGGGAA-1	CM
CTCGCTATCCAAACCA-1	Endo
TGCATGATCCATACCC-1	Endo
TGCCTGTGTGCACCCA-1	Pericyte
AACCTGACAGGTAACG-1	Myeloid
GCCATAATCGAGGTAG-1	CM
CGCACAGGTAGTAACA-1	CM
GCAAAGGAGGTTAGTA-1	CM
TGTGACACAAGGGTAC-1	CM
TGATCAGTCAGGTTTG-1	CM
CACTAAGGTGCAAAGC-1	Fib
CAATCCCGTCAAATCC-1	CM
GCCTAGGGTTAACCAC-1	CM
TTTGGCCCAAGCAATA-1	CM
CAAGAAATCCGCTCTA-1	CM
CTCATGCTCGGTACTA-1	CM
TATGTGGGTACGAGAC-1	CM
GCCCGAATCTATATCC-1	CM
TGCTCACAGATACCAA-1	CM
TAAACCGAGCAACTGG-1	CM
TAGCATGCAACGCAAG-1	CM
TACCCTGAGTGGACGT-1	CM
CGTGGCAAGGCTTTAC-1	Myeloid
GAGGATGGTGGCCTTG-1	CM
TCAAGGTCACCGAATT-1	CM
CAGCTGGTCAGTTGAC-1	Fib
ACTATTCCAGCGTGAA-1	CM
CCCAGAGCAATGATGA-1	CM
CTACTTATCCAGGTCG-1	CM
ACAGCGCCATATTGGC-1	CM
TAGCGGCGTTTCCTAT-1	CM
CCGTACTCAAGCCTTA-1	Endo
TGACAACCATCCCTCA-1	CM
TGGAAGGTCATGTTCT-1	CM
CTGGGACAGAGGAAGT-1	CM
GAGACTTTCGCCACTT-1	Pericyte
GCATTCCCACCCATCT-1	CM
GCCAGCAGTGCACCCA-1	Myeloid
TCAGCTCCAGCGCGTT-1	CM
GCTCACTGTATCGCGC-1	CM
ATTGTCTAGCCTGTAT-1	CM
GCACCTTAGGAATGGA-1	CM
TCAAGACCAACGAGGT-1	Pericyte
TTCATCAGTCTAAGAA-1	Fib
ACGTTAGTCCACGAGC-1	CM
AACCTGATCACACGTA-1	CM
GCTGCGATCGTATAGC-1	CM
GAACTTGCACGTTACA-1	Fib
GAACTTGGTGTTGTTG-1	Endo
CCGTGAGCACTGCTCT-1	CM
TACTAGGAGGATATCA-1	CM
ATTGTCTAGACACGGT-1	CM
CAGTGCGCATTTCTTG-1	Fib
GCTTAAGTCGGGACAA-1	CM
TGGCAATAGCTTTCCC-1	CM
TTGCGAACAATCATCG-1	Fib
GCGGTGTGTTAACTCG-1	CM
TGTGGCGGTGTGTGCC-1	CM
AATGGAAGTTACCCAA-1	Fib
TCACAAGTCACCCGGA-1	CM
CTCAGCTTCTAGCAAC-1	Fib
GTAGGAGGTGAGCTAG-1	Endo
CTGGGACGTAGTAACA-1	CM
GCCAGACGTCTGATTG-1	Endo
GCGGAAAGTCTCTGGG-1	Pericyte
GGTGAAGGTGCATCAT-1	Endo
AGTCCGGTCTTCGTTA-1	CM
GTTACGAGTAGTGATA-1	CM
ATCGAGTGTAGAATAC-1	CM
GAAGTCTTCTTCAGAG-1	CM
CTTGAAGTCGTCCCTA-1	Pericyte
TGTGGCGAGCGCATTT-1	CM
TCAGGGCTCCCAGCGA-1	CM
TCCGACTGTTATCGAC-1	Pericyte
CGTAAACGTGTTGTTG-1	Endo
AGCGTGCTCAGGAATA-1	CM
GATTAGCCAAGGATGC-1	CM
ACGGATTCAAGCGAAC-1	Pericyte
ACTAGGTAGTCGTACT-1	CM
TTTGTGTAGGTTCGAG-1	Fib
TCGTTCGAGGAGTAGA-1	CM
TGTACGAAGTGTCACT-1	Fib
TGATGCACATTTAGGC-1	CM
TAGCATGTCTTTATCG-1	CM
AGATTCGTCTCGCGTT-1	CM
CTGTTCGCAGTTACAC-1	CM
GGTACCGTCTATGAGC-1	CM
TAGCATGGTTTGTACG-1	CM
TGTAAGCAGCTACGCC-1	CM
TACTCGCGTTGCAGCC-1	Endo
CTGCTCATCCGGCTGA-1	CM
TATCTGTGTGGACTGA-1	CM
TAAACCGAGGAGTACC-1	CM
GCAAAGGGTGCTTTGA-1	CM
TACTCGCAGATAGGTT-1	Pericyte
ACCTGCTTCAGGTTTG-1	Endo
GGTGCTGTCGTTTGAG-1	Fib
CAGCTGGTCTATCTAC-1	Pericyte
GAGATTCCATTACTCT-1	Fib
GGGTTATTCCGTTAGA-1	Fib
CTTGCTGTCAGGCGCT-1	CM
ACATGCACAGGTAACG-1	Endo
GCACGCATCGGGAAAC-1	Pericyte
GCGTAGCAGCATACCT-1	vSMCs
CAGGGCTAGTACGACG-1	CM
GCGCATGTCAGAGTGG-1	CM
TGGTCCTAGCTATCCA-1	Endo
GTTATTCGTCAACTAC-1	Fib
GTACTTTTCTGCGTCT-1	Pericyte
GAACTTGGTGTCCCAG-1	Endo
ACTAGGTTCCCAGCAG-1	Endo
TCAAGACAGAATCAGT-1	Endo
TTTACGTGTACGCCCA-1	CM
GCGGAAACAAGCAACG-1	Endo
AGCTGGCGTCTGTGTA-1	CM
GTGGCGTCATGGAGGT-1	Myeloid
GTCTACCGTCAACAGG-1	Endo
TGATTTCAGACGCCCT-1	CM
ATCCAGACAATACTGC-1	Pericyte
TCAAGACGTGGTGGTA-1	Endo
TTACGTTGTTTAGGAA-1	Endo
ATTTGTCCATTCTTTG-1	CM
ACTACCCGTTTCACCC-1	CM
ATGTCGACAGTCAGAG-1	Endo
GCGGAAAAGCCATTCA-1	Myeloid
GAGGCTCAGTTAGAGT-1	Fib
TCCGACTGTGATAACA-1	Myeloid
CGTAAACTCAGTGTAC-1	CM
TCACCACTCTTGTGCC-1	CM
GGCATTAAGTACAGAT-1	Fib
TCCGACTCATCGCCTT-1	Myeloid
GGGCCATAGTAGTCGG-1	Endo
GAGACTTCATTCACCC-1	Endo
GCAGCTGTCTTACCTA-1	Endo
GCACCTTAGTGATTAG-1	Pericyte
TGGAAGGAGCATACCT-1	Endo
CAACGTACACGCGACT-1	Endo
AGCCTCTTCTAGCAAC-1	Endo
GGATAGGGTATTGTGC-1	CM
TGATCAGAGACCGCAA-1	Myeloid
GGACACCTCGATAGCT-1	Endo
CCACGTTGTGAAACAT-1	Myeloid
AAGGTTCAGTAGCAAT-1	Myeloid
ATCCTGCTCGCCGAAC-1	CM
ATGTCTTGTTTGCCCT-1	Endo
TCACCACAGAACCCGA-1	CM
GCACCTTAGCTAGCAG-1	Myeloid
GGTGAAGAGCCTTTGA-1	Myeloid
GAGCGCTAGCAGAATT-1	vSMCs
CTGAATGCAAGATTAG-1	Endo
TTACGTTAGTCAACTC-1	CM
GGGTCTGCACTACACA-1	Endo
TAGACTGTCCGTACGG-1	CM
GCAGCCACAAGCAACG-1	Pericyte
TTGCAGATCGGTCTAA-1	vSMCs
CTACTTAAGGGTCTGA-1	Pericyte
CTTTGCGTCATGCTTT-1	Endo
TTTGTGTAGGAGTACC-1	Myeloid
GTTGGTAAGGTCGGTA-1	Endo
CAGCTGGAGATCGCCC-1	Endo
GCCAGCATCGGTCGAC-1	CM
GCCAGACGTCCCGAGT-1	Myeloid
ACAAACCCACCTCGTT-1	Myeloid
GGTAGGACACACACAT-1	CM
GCGTTGGTCAGAGTGG-1	Endo
CTGGCAGGTTACACTG-1	Endo
ACAGAAACACCATTCC-1	Endo
ACGTTAGAGTCGACCC-1	Endo
TGCACCTAGCAATAAC-1	Myeloid
ATGTACGGTGCAGACA-1	Pericyte
TTACCCGGTACGACCC-1	Pericyte
CCTATTATCCTGTAGA-1	Myeloid
GCGGTGTTCAGAGTGG-1	Endo
TGGTCAAAGACGTCAG-1	Endo
GAGTGAGAGTTCCAGT-1	Myeloid
ATCCCTGTCGTTGTAG-1	vSMCs
AAACTGCCATATAGAG-1	Endo
GCTGCGAGTCCGAGCT-1	Myeloid
GCACCTTAGGTGTCGA-1	Endo
ATTACTCTCTCTTAAC-1	Endo
AGTCAACCAATTCAGC-1	Myeloid
GTCACCTGTCACCCGA-1	Endo
GTCACTCAGATATGAC-1	Neuronal
AAATGCCGTTTGTCTT-1	Endo
TAGACTGAGCTTCAAC-1	Fib
ACAGCGCGTTTAGAAG-1	Endo
GCATGATCATGTCCCT-1	Myeloid
AAAGGATAGTACCACT-1	CM
CGTTCCAAGAGAGTTT-1	Lymphoid
CGGTGCAAGGTCACTT-1	Myeloid
TTACCGCAGCGAGCTA-1	Lymphoid
TACGCAATCCTCCTGA-1	Endo
GCGGTGTAGTTGACAA-1	Myeloid
CTGAATGGTAACCATC-1	Myeloid
ACTAACGCACCCATCT-1	CM
TGATTTCCACATAAAG-1	Endo
AGCGTGCCAAGCCTTA-1	Lymphoid
AACCGATCAGGTAACG-1	Myeloid
GCAGCTGAGGGCGAAG-1	Myeloid
TAGCGGCCAACGAGGT-1	Endo
ACCTGCTGTGGATTTC-1	Fib
CACAGATGTTAAGGGC-1	CM
TGGCCTTCAGCGCGTT-1	Myeloid
CTAGGGCCAGGTAACG-1	Myeloid
CCATACCGTAGTCCAT-1	CM
GCGGTGTGTTGGGAAC-1	CM
CACATGACATCGAGTT-1	CM
ACTGCAATCTTACGGA-1	Endo
TCGAGCGAGCCTGGTC-1	Endo
TACCTCGCAGTTACAC-1	CM
CAAGGCCAGTCATACC-1	CM
ATAGGCTTCCGAGGAA-1	Endo
