Barcode	cell_type
TCTAGTTGTGTGAGGT-1	CM
TACATGGGTCAACTGT-1	CM
GACCTTCCAATCCATG-1	CM
TCACCACAGACTCGGA-1	CM
GAGGCTCGTAGTATCC-1	CM
TGAGTCAGTAAGTGCG-1	CM
TGATGCAGTATCTAGC-1	CM
AGTCCGGGTGAGCTAG-1	CM
TCAAGACTCATCGCAA-1	CM
ACTAGGTAGCGTCAAG-1	CM
GGTAGGACATATAGAG-1	CM
CCTGCTATCCCGGGTA-1	CM
GTTATGGCAGTAGGCA-1	CM
CTGTATTGTTACACTG-1	CM
GATTGACGTAAGGTCG-1	CM
ACAAGCTTCCTGGAAT-1	CM
ACCCAAAGTTTAGGAA-1	CM
ACCCAAATCTTCATAC-1	CM
GCTTAAGCAGGGAGTT-1	CM
AGCCGCATCCAGTTAG-1	CM
TCGTTCGTCACCCGGA-1	CM
CTTCCAGAGACACGGT-1	CM
TCAGTCCAGGCAAGCT-1	CM
TCCATCGGTCAGTGTT-1	CM
TCAAAGCGTAACAATG-1	CM
GAACTTGCACAGTTAC-1	CM
GGTACCGAGCTAGCAG-1	CM
AGGCGAATCCCGATTC-1	CM
AGCGTATGTGATAAGT-1	CM
ACCGGGTGTGCCAAGA-1	CM
AGATAGAGTTAGGCTT-1	CM
ACTATTCAGAGTAAGG-1	CM
TGTGGCGTCGTCGCAG-1	CM
ACCGCAGGTCAGCTTA-1	CM
CTTGCCATCTCATATC-1	CM
ACCGGGTCACCGAATT-1	CM
GATTGACCAGATACAA-1	CM
TAAGCCAAGAATATCG-1	CM
GAGGCTCGTTATAGAG-1	CM
ATTGTCTAGTAGTCGG-1	CM
GCTCAGGTCGATCTTT-1	CM
TCGAGCGGTAGGTAAT-1	CM
GACCGACTCCCTAAAG-1	CM
TATTGCTAGGATTAAC-1	CM
TAGCCCTAGGGTTCTT-1	CM
AAGGAGCGTCGAGAAC-1	Endo
GTTGGGCAGTTCAGGG-1	CM
CTCTACGGTTGAAGCG-1	CM
TGGTCAATCCCGGGTA-1	CM
TTGCCCATCTCTGAGA-1	CM
AAGGTTCTCCGGACTG-1	CM
CCCAGAGCAAGGTTCT-1	CM
TTCATTGTCCTATCCG-1	CM
AGATTCGAGGGTGTTG-1	CM
ATTTGTCCAAGGCTTT-1	CM
CAAGCTAAGTTACCAC-1	CM
CTCTCGAAGTTATGAG-1	CM
CGGACCAGTTAACCGT-1	CM
GTGGATTCATTCACGA-1	CM
CGGACTGGTGAGTCGA-1	CM
ATAGTCGCAAACTACC-1	CM
TGCGTAATCGGTTAGT-1	CM
AGCTGATTCCATACGA-1	CM
TGGAAGGAGAGGAAGT-1	CM
GGGTCTGGTAGCATGG-1	CM
TGGGTTAGTTCCCAAA-1	CM
TGTACAGCAGTAACCT-1	CM
ATTCGTTGTACGGATG-1	CM
TGACTCCGTTGGACGA-1	CM
TCAGTTTAGGGTGTTG-1	CM
CTCAGCTCAGTGCTCG-1	CM
TTCATTGGTATCAGCT-1	CM
CTAGGATAGGAAGGTA-1	CM
TATGTTCAGAGACTCG-1	CM
AGCTGATTCGGTTGTA-1	CM
GAACCTACATCATAGC-1	CM
GGAGGATTCGGGAATG-1	CM
TCAGGGCCACTCAGCG-1	CM
ACGTGGCGTCAACTAC-1	CM
TTAACGGGTCATAGCT-1	CM
GAAATGAGTGATGCTT-1	CM
GGTGTCGCAAGCGAAC-1	CM
TAAGCCAAGTAATCAG-1	CM
GAAACAACACGCTAAT-1	CM
GCAGATTGTATGTTCG-1	CM
CTCAGCTCATTGTTCT-1	CM
GTGCTGGGTCCCTTTG-1	CM
AAATGCCTCCGTTAGA-1	CM
TGAGCCGGTTGGCTTA-1	CM
TTAACGGCAGTTGCAT-1	CM
TCAGGGCGTGATCAGG-1	CM
TGGGTTAGTGAGTAAT-1	CM
GAAGTCTTCCAAGAGG-1	CM
GCCAGCACAGTAACCT-1	CM
CGCGCAACAAAGCTTC-1	CM
CCCTGATGTATGGGTG-1	CM
TAGGAGGGTAAGTGCG-1	CM
CACAACATCTCTTCTC-1	CM
TGTTAGGAGTAATCAG-1	CM
GCTTGCTAGCATTGGG-1	CM
GTTCAAGGTTAGGAAT-1	CM
ACTCGGGCACAGAAGC-1	CM
CAGGGCTGTCCCTAAA-1	CM
CGCTGGAAGGCCTCTG-1	CM
TGGTCCTTCGTCGCAG-1	CM
ACTACCCAGCACACCC-1	CM
AGCCAGCTCAAATGGA-1	CM
TTGCAGAGTCTCTAAG-1	CM
GTGGCGTTCACTAGGT-1	CM
TTCATTGGTATGGATA-1	CM
GGGTCTGTCGTTGTTT-1	CM
CAGGGCTAGTTGTCCA-1	CM
GCGGTGTTCCCTATTA-1	CM
TTACGGATCACTACCC-1	CM
CCCTGATTCCGAGAGA-1	CM
ATAGTCGAGGACTTTC-1	CM
TGTAGCAGTGGATTTC-1	CM
TAGGAGGGTTCCAATG-1	CM
GCTTTCGTCCATTGTT-1	CM
CGTTCCACAGATACAA-1	CM
ATGTCTTCATTTGGTG-1	CM
CATGTTTAGTGCTCGC-1	CM
TACATGGTCCGGAAAG-1	CM
ACAGCGCGTGCGTCCA-1	Fib
GGAGTAGTCGTCAACA-1	CM
GTGGCGTGTACTTGAC-1	CM
CTGCGTTAGCACACCC-1	CM
TTACCCGTCGATGCAT-1	CM
GTGATCATCGGATAGG-1	CM
CAGCTAACAGTCAGAG-1	CM
TGACAACCACATTCTT-1	CM
TGGACATTCGGTCAGC-1	CM
ATTGTGGGTGAATGGC-1	CM
AGACAAATCTCTCAAT-1	CM
TAAGCCATCCAATCCC-1	Pericyte
ACTAACGAGGAAGACA-1	CM
TGGCAATCACCATTCC-1	CM
GCATGATCAAACTACC-1	CM
TCACAGATCTGGGCGT-1	CM
ACAGACTCATCCCGGA-1	CM
CCCGTTACACGTTACA-1	CM
CAAAGCTCACATAAAG-1	CM
TGCTTCGTCTTTGCAT-1	CM
TAGGTCAAGCTTCAAC-1	CM
TGGAAGGTCCATGTTT-1	CM
TCAGGGCAGGCAATTA-1	CM
TGACTCCTCGCTGATA-1	CM
ACGTTAGCAAGGGTAC-1	CM
CAGGATTGTGTGACCC-1	CM
TACCTATAGCTTCAAC-1	CM
TGCATGAAGTGCTAGG-1	CM
GCCCAGACAAGCCTTA-1	CM
ATGTCTTTCGCTATTT-1	CM
ACTGTCCGTTCCATCC-1	CM
CATTCCGGTGGAAGCT-1	CM
GGGTGTCGTCAACGGA-1	CM
GGAACTTAGAAATCTG-1	CM
TACATTCGTAGCCATT-1	CM
TTGCAGATCCGAATTG-1	CM
GGATAGGTCGGCATAT-1	CM
CCATACCCATGCGCTG-1	CM
GCAGCTGTCATGTTCT-1	CM
ATGTCTTAGGCTTAAA-1	CM
GCCTACTTCTATTTCG-1	CM
GATCATGAGTATACCC-1	CM
TGACAACTCCATCGAA-1	CM
TCAGCTCTCGTCAACA-1	CM
TTTGGTTCAAAGAAGG-1	CM
ACTACGAAGTCCAGAG-1	CM
CCCTCTCCAAGCGACA-1	CM
GAGAACGTCTAGCTGA-1	CM
GTGCTGGTCTCTGCAC-1	CM
ACAAAGAGTTCCCGGA-1	Endo
AATGCCATCAATTGGC-1	CM
GCGGTGTTCCAGGTCG-1	CM
GTGGATTGTTCTTTGT-1	CM
TTAACGGGTCGCTACG-1	CM
ACCGCAGTCGCCCTTA-1	CM
TACGGATCAAGTCCTA-1	CM
CCCAGAGCAAGCAACG-1	CM
AGTCCGGAGAAGCCGT-1	CM
CCTGCTACATACTGCA-1	CM
TTATGTCGTAGCTGTT-1	CM
CATTCCGCAATGCACT-1	CM
TACGGATGTATGTTCG-1	CM
TGATGCATCACTAGCA-1	CM
TGCCTGTAGAATACTG-1	CM
GCTCCTACACAGTTAC-1	CM
CTCTCAGTCGTTACAG-1	CM
TTCGTTATCGGATGTT-1	CM
CAGTATGCAAGTTGCT-1	CM
TAGCACATCGTTCAGA-1	CM
ACCAAACCACGATTAC-1	CM
AGGCCCAAGACGAAAG-1	CM
GACTAGTCAATTCTCT-1	CM
TCACCACAGGGTAATT-1	CM
TGTGGCGTCGCATACA-1	CM
TGAGCCGGTGTCCAGC-1	CM
TTGCGGGTCCTGGAAT-1	CM
GTCACCTCAAGTCTGT-1	CM
CTGCGTTTCAGGTTTG-1	CM
GGATGAGGTCTGCACG-1	CM
TTCAACTGTTCTTAGG-1	CM
GGTGAAGTCGGTCTCT-1	Myeloid
GCCCAGATCCACACCT-1	CM
GGTGCTGGTTGTGACT-1	CM
AGCTGATTCCATCTAT-1	CM
TAAGTGCGTATGGATA-1	CM
GAAGTGGAGTTAGAGT-1	CM
AAACTGCGTCACAGTT-1	CM
ATCCTGCGTACCCACG-1	CM
TGCGTAATCGTTACAG-1	CM
GCCCAGAGTATTCTCT-1	CM
TGATGCACAGTTGCAT-1	CM
TTACCGCAGTGTCCCG-1	CM
ACCTGCTTCAAGAGAT-1	CM
CCCTGATTCCTAGAGT-1	CM
TTGCCCAGTAGCGAGT-1	CM
AACCGATCAAGCCTTA-1	CM
CACATGATCGCTAGTA-1	CM
GGCGTTGTCTGGCTAA-1	CM
TTGCACCCATGTAGAA-1	CM
CAATCCCCAACGCACC-1	CM
TGGACATTCCCTACGT-1	CM
CAACGGCCAGGTGGTA-1	CM
GCGAGAAGTGCACTTA-1	CM
CCTTAATGTATTCTCT-1	CM
AGCCCGAGTCGAGGTA-1	CM
CTTTGCGAGCCTGTAT-1	CM
TGATTTCGTCTCTGCT-1	CM
CTTGTCGTCAAGGCAG-1	CM
GTTACGATCGGTACTA-1	CM
TCAATTCAGTTCTCCC-1	CM
TGACTCCAGGCGTAGT-1	CM
GATCATGCATCTCACC-1	CM
AACATCGTCTTCCACG-1	CM
GAATCTGCATCCTGGG-1	CM
GCGTAGCGTTCAGAAA-1	CM
GGAACTTTCTCATATC-1	CM
ACTACGAGTACGCCCA-1	Fib
TGGTCAAAGCAGGACT-1	CM
GTCCATCTCCATAGGT-1	CM
ATCCAGACAGCAGGTA-1	CM
CGCTATCAGGTAAGTT-1	CM
CAAGAAACAACGAGGT-1	CM
TTCAACTAGTGCAACG-1	CM
GCATTGATCGGGTCCA-1	CM
CTCTCAGCATAGACGG-1	CM
TACGCCTTCATACTTC-1	Pericyte
TGGAAGGGTGCATCAT-1	CM
TGGAAGGCACTCAAGT-1	CM
GATTGACAGGATGTAT-1	CM
AAGATAGGTAAGTCTC-1	CM
AGTCCGGTCACGTGTA-1	CM
ATTGTGGTCCATTGTT-1	CM
TCGGGACAGTATACCC-1	CM
TAATCGGAGGAAGACA-1	CM
TTGTTGTTCATCGCAA-1	CM
TAGCTTTAGTAGTCGG-1	CM
TGATTTCGTGCTTGAT-1	CM
CCCTGATGTCCTTCAC-1	CM
ACAAACCGTCAGAGTG-1	CM
AACAAAGCAAGACACG-1	CM
AGGCCCAGTTAGTAGA-1	CM
TTCGTTACACCCTTAC-1	CM
GTCACAACACTTTGGA-1	CM
TGGACATGTGGCATAG-1	CM
AAAGATGCAGGATGTG-1	CM
TTTGCGCAGATCGAGC-1	CM
AGACAAACAGGGTAAC-1	CM
CACAGATAGTTGAATG-1	CM
GCACGGTGTAGCATGG-1	CM
ACCTGCTCAAGACTTC-1	CM
CTGGCAGAGGGAAGCG-1	CM
GCGAGAACAGTCAGCC-1	CM
GGGTGTCTCGATAGGG-1	CM
GCGATCGAGCGCACAA-1	CM
TTTACGTTCCAATAGC-1	CM
TTGCCCATCGGGCTCA-1	CM
ACTGCAACAAACCCTA-1	CM
TGTAAGCTCGATTACG-1	CM
GCTCACTCAACGTACT-1	CM
GTGTGATGTAGCGAGT-1	CM
TTTGAGGCACCAAGGA-1	CM
CACCACTTCGTTGTAG-1	CM
GCCTACTCAGCCACGT-1	CM
CTTAATCCATGCGTTA-1	CM
CTCCCAACACGACGAA-1	CM
GGGTGTCTCCCGAAGC-1	CM
TTGACGAGTCCGTAGC-1	CM
GCGTTGGAGTTCAAGA-1	CM
GCCTAGGTCGCAAACT-1	CM
CCAGATACAAGCCTTA-1	CM
TGACTCCTCGCTACCT-1	CM
TTAGCGATCGTCTTAT-1	CM
ACTGTCCAGTATACCC-1	CM
AGTTTGGGTAGTCTGT-1	CM
ACAAAGAAGTCCCTCT-1	CM
GAGATTCTCCGAGAGA-1	CM
ACAAACCCACTACACA-1	CM
AAGGTTCTCTCTGTTA-1	CM
AGCCAGCCAAGAGATT-1	CM
TCCAGAATCCGTCAAA-1	CM
CAACGGCTCAGTGTGT-1	CM
TACGCAATCGTGATAC-1	CM
CCGTACTTCGGGAAAC-1	CM
TGACAACTCACCCGGA-1	CM
ATCCTCGTCGGATAGG-1	CM
CAGCTAACAGGTGGTA-1	CM
GCTTAAGCAGCTGATT-1	CM
CCCTGATAGAGGCAGG-1	Fib
ATCCAGATCGCCTTAC-1	CM
TCGAGCGAGTCATACC-1	CM
AGCCTTCCATAGACGG-1	CM
ATTACTCGTTTCGACA-1	CM
TGTAAGCTCGGTACTA-1	Endo
TAGGTGTCACTAGCCG-1	CM
TGGTCAAGTCTGTCCT-1	CM
GTAGGAGAGCGAGAAA-1	CM
ACCGCAGGTAACTCCA-1	CM
TGAGTCATCCGGCTGA-1	CM
CTCAACCTCCTAGAGT-1	CM
GAGATTCAGTAGACCG-1	Myeloid
AGTTTGGAGAGGTGGG-1	CM
AATGGAAGTACATGGG-1	CM
ACTTCCGCACAGGTAG-1	CM
ACGGATTTCCTGTGGG-1	CM
CCTTAATCATGGGAAC-1	CM
AGCCTGGCACTGCTCT-1	CM
GTCACTCCAAGCACTT-1	CM
CTTAATCGTGGCGCTT-1	CM
GCGATCGGTTCTGAGT-1	CM
TACTGCCTCTATATCC-1	CM
GGATAGGCAGGTAACG-1	CM
ACTCGGGGTCAACTAC-1	CM
GGCATTAAGGAAGGTA-1	CM
CTCTAGCTCCACCTAC-1	CM
ATGTCGATCCCACGGA-1	CM
CTGGCAGGTTGAATAG-1	CM
TAGGTGTAGACACTTC-1	CM
GCGTTGGAGGCGTCCT-1	CM
TTCTAACTCTGTTGCC-1	CM
ATCCTCGTCCCGTAGG-1	Fib
AGTCAACCAGGTAACG-1	CM
TAGGTCAAGGGACGTT-1	CM
GGAGAACGTCTGGTCG-1	CM
CTTGCCATCCAATCCC-1	CM
TTTGGTTTCGAGAAGC-1	Pericyte
TTCGTTACATGGAGGT-1	CM
ACATGGTTCGTGAACT-1	CM
CTCTACGGTCACAGTT-1	CM
CCTGCTAGTTACTACG-1	CM
GGCGAAAGTCTCAAAC-1	CM
TTACGTTGTTTCGTTT-1	CM
AAGATAGCAACGAGGT-1	CM
CTCTAGCTCGTATAGC-1	CM
CTAGCGGGTGGCGCTT-1	CM
GCACCTTGTCCGTCGA-1	CM
TGTAAGCAGTCGGGAT-1	CM
CTTCTAACATTACTCT-1	CM
CGTAAACGTCTGGATT-1	CM
GGGAACAAGACGTCAG-1	CM
TTAGCTTCAGAGCCAA-1	CM
GGTGCTGCATGGGAAC-1	CM
TAGCCGGGTATGTTCG-1	CM
CATAACGGTTAGGAGC-1	CM
AGCCTTCTCGATGAAA-1	Endo
ATGTACGGTCATTGCA-1	CM
CTTAATCAGTCGAGCA-1	CM
ACAAAGATCAAGGCCC-1	CM
CACTGAAAGTAACATG-1	CM
TTTGCGCGTGCGTAGA-1	CM
GTGTGATTCCGTGCAG-1	CM
TTCGTTACACAGCCAC-1	CM
CACCTTGGTCTGCGCA-1	CM
GCCAGCACATTCACCC-1	CM
TTGCTTAGTCTGCACG-1	CM
AACTTGGCAACTCGTA-1	CM
CCGTACTGTCAAACAA-1	CM
CCCTCTCGTAAACGAT-1	CM
CGCAGGTTCTAGCAGT-1	CM
CTGTTCGAGTGTCGGA-1	CM
TGAGTCAAGAGGTACC-1	Endo
GTCTACCGTCTGGATT-1	CM
TACATTCGTAGCGAGT-1	CM
TTCTAACGTCAACTAC-1	CM
GCACGCAAGCAGAGCT-1	CM
AAAGGATTCTGTGTGA-1	CM
GCTTGCTAGAAATCTG-1	CM
TGCTTCGTCGCTGATA-1	CM
TCCCACAAGTAGACCG-1	CM
AAACTGCGTGTTGGTT-1	Endo
CTTGCTGTCTTAGTGG-1	CM
CCTAAAGAGTGCAACG-1	CM
ATTCGTTGTCTCGGGT-1	CM
CCCTAACCAGGCATCC-1	CM
TAAGCCATCGTTACAG-1	Myeloid
TGGCCTTAGTAGTCGG-1	CM
CATTGGACACGTTACA-1	CM
CTCTCAGTCGGAAAGC-1	CM
GCGCATGTCGGGTCCA-1	Fib
AACGGGAAGTAGTGTA-1	CM
AAACTGCTCGAGCGCT-1	CM
AGCGTATAGGTCGTTT-1	Endo
AGTGCGCTCTGATCTT-1	CM
GTGGATTTCTCATCCG-1	CM
GTCACGGCAAAGGCCA-1	CM
AAAGATGGTAAAGGCC-1	CM
TGCTATTGTTACACTG-1	CM
CGTACAAGTTACCACA-1	CM
ATTGTCTTCTCTCAAT-1	CM
TTCGATTTCCGAATTG-1	CM
GTTGGGCAGTCTTAGC-1	CM
TCGCAGGGTTATGCAC-1	CM
TTACCCGTCACTCGGG-1	CM
ACTCGGGCACGCTCAG-1	CM
TACATTCGTCCTTATT-1	CM
GTGATCAGTAGACACG-1	CM
TCAAGGTTCACCCGGA-1	CM
TCTCAGCAGGTTCGTT-1	CM
AGATAGAGTAGATTAG-1	CM
CCTATTACAATGCACT-1	Pericyte
TTACTCAGTGGCCTCA-1	CM
TGGCAATAGGCTCCTG-1	CM
ACAGCGCTCGCGCCAA-1	CM
AGGCGAAGTCATCGTA-1	Fib
ATTTGTCGTGAAACAT-1	CM
TAAGCCACAGTCCTGG-1	CM
GCGAGAACATCGTACA-1	CM
CACAACAAGGTCTTGT-1	CM
AAAGGATAGTTACACC-1	CM
TGTGTCCTCCCACGGA-1	CM
AAATGAGCATCCCAAA-1	CM
AGTGTACGTGATAGAT-1	CM
GGTAGGAAGGATTGAT-1	CM
GTAGTACGTACCCATA-1	Fib
GCTTTCGAGGTCGGTA-1	CM
ATTGTCTCACGCGACT-1	CM
GCCAGCAGTGCAAGCA-1	CM
GCACGCAAGACTTCCA-1	CM
TTAACGGAGAGTAAGG-1	CM
CTGCTCACAATGGTAA-1	CM
TGGACATAGGATTGCG-1	CM
CACATGAAGAAATTCG-1	CM
CGGACCAGTGATCAGG-1	CM
CATAACGCAAGATGCG-1	Endo
TGCTCACTCTTAATCC-1	CM
GGCGTTGTCCACACCT-1	CM
TACATGGTCCCGAAGC-1	CM
AGGCCCAGTTAGGCTT-1	CM
TTACCGCCAGAACAGC-1	CM
TTCAACTCAGCGTACC-1	CM
AACTTGGGTACTAGAA-1	CM
CCTAAAGGTCTGTTGA-1	CM
CCAGATACATGATCGT-1	CM
AGCTGGCAGTGGACGT-1	CM
ACTTTCAAGAAGACTT-1	CM
GAAAGTAAGAGCTCCC-1	CM
TTCGCGTCAACAACTC-1	CM
CAGCTGGTCGGTCAGC-1	CM
GCAACCGGTACGACCC-1	CM
GTTCAAGCAAAGCTTC-1	CM
CCCTCTCTCCTGTGGG-1	CM
TCAGGTATCCATGACA-1	CM
GAGTGAGCAAGTGGCA-1	CM
GAAAGTAAGGAAGGTA-1	Fib
TCTATTGGTGTTGGTT-1	CM
GATGGCCTCCTTCGAC-1	CM
GCATTCCGTGCATTGT-1	CM
GGATAGGGTTTCCGGG-1	CM
AAACGAATCAATTGGC-1	CM
TAAGCCAAGTAGTTCC-1	CM
ACCTGCTTCTGTAGAC-1	CM
CTGCTCATCCGGCTGA-1	CM
ATCCAGAGTAGTAACA-1	CM
GGGTCTGTCTACATCT-1	CM
GCTTTCGAGTGCACAG-1	CM
TACCCTGAGTGCACAG-1	CM
CTTGAAGTCCATATCT-1	CM
TCAGCTCTCGATGTAC-1	CM
ATTGTGGCAGACTAAA-1	CM
AAAGGATGTTCCCAAA-1	Fib
TTCATTGCATCCCAAA-1	CM
TCACCTGGTTTCTACT-1	CM
AGCGTGCCAAGGAGGG-1	CM
GAACGTTTCCCAATGA-1	CM
GCGATTACACAAACAA-1	CM
GGACACCGTGTCCAGC-1	CM
TACCTATGTTGTATCG-1	CM
TGCTTTAAGTAGGAAG-1	CM
CTAGGATTCGAACCGC-1	CM
CATTCCGTCTACATCT-1	CM
GGCGTTGGTAACGGAC-1	CM
CGCTATCTCAGCACTA-1	CM
ATGTCTTTCAGATACC-1	CM
CAAGGCCAGTCACGCC-1	CM
GCTCACTAGGCCTCTG-1	CM
CGGACCATCCGTCAAA-1	CM
ACAGCGCCATTACTCT-1	CM
AACGTACAGTGCCCTG-1	CM
AGACAAATCGTTACAG-1	CM
CATGTTTCAGGTGTGA-1	CM
TCAGTCCAGTATGGGC-1	CM
GAGGATGTCAGTGTGT-1	CM
AGATAGAAGCTTTCCC-1	CM
GGAACTTAGAGTGGAA-1	vSMCs
GAGAACGCATCACAGT-1	CM
ATCCTGCTCATTCGGA-1	CM
TTGCGAAAGTGTCCCG-1	CM
TTAGCTTCACAGGTAG-1	Fib
GGGACCTTCAAGGCCC-1	CM
AACAGTCCATGGGTGA-1	CM
GCGTAGCTCAGGTCTA-1	Endo
GAAAGTAAGTATGCTC-1	CM
CCCGTTACACTCGGAC-1	CM
TCAGGTACACCACCAG-1	CM
CAATCCCCAACAACTC-1	CM
CGTAAACCAGCAATGG-1	Fib
TAGGTCACATCGCTAA-1	CM
GCCCGAAGTACGGATG-1	CM
TGCCTCAAGTAATCAG-1	CM
AGACAAAAGATTACGA-1	CM
TTACTTGCAGCAACCC-1	CM
AAATGCCGTTACGCTA-1	CM
TACATTCAGTAGACCG-1	CM
CTTGAAGCATGACTGT-1	CM
CAACCAAGTAACACTC-1	CM
AGCTGATAGCGTTAGG-1	CM
TCGATTTCATACCCGG-1	CM
CTGTTCGGTGCACCCA-1	Fib
GCGTAGCCACTTGCGG-1	CM
TGGACATGTGCTTGAT-1	CM
TTGCAGATCGTGGAAG-1	Endo
AACCTGATCCTCCAGT-1	CM
TCGATTTCAATGCCAT-1	CM
GCAACCGGTTTCACCC-1	CM
TATCGAGGTGCGTTTA-1	CM
GTTATGGAGCCTATAC-1	CM
GTCTACCCAGCTATAC-1	CM
AAACTCGTCGTCCCTA-1	Pericyte
CCTATTATCGTGCTGG-1	CM
TGGGTTAGTATATGGA-1	CM
CTGGCAGTCGTTCTAT-1	CM
ACCAAACTCATCGCAA-1	CM
GCTCACTGTCGCGCTA-1	CM
AGCGATTTCCGAGAGA-1	CM
AGCCTCTGTAAGTGCG-1	CM
GCTGTTCTCCATTGAG-1	CM
AGCTGTACACCGTTGG-1	CM
CTAACTTCAGTTACAC-1	CM
CCGTGAGAGGTGATGC-1	CM
GCGGAAATCGAAGCCC-1	CM
TTACGTTTCCGTTTCG-1	Fib
ATGGATCGTAACGGAC-1	CM
ACAGACTTCGGATAGG-1	CM
CTGGGACTCACAGGGA-1	Fib
TTGTTCAGTTTAGAAG-1	CM
AAACGAAAGGGAGATA-1	CM
GTGCACGTCTATCCTA-1	CM
TCGAGCGTCTCTGAGA-1	CM
TGTAGCAAGACCAATA-1	CM
GCCCAGAAGGTACACG-1	CM
GCTCGAGAGTGTGTAA-1	CM
TAGGTGTCACACATGT-1	Fib
GAGGTCCTCGCCCTTA-1	CM
TGGCAATGTTACTACG-1	CM
GACTAACAGGTCACTT-1	CM
TCAAGACCAATACTGC-1	Endo
GGAACCCTCTATGAGC-1	CM
TAATTCCAGGACTAGC-1	Fib
CAGTATGTCCGTGCGA-1	CM
AGCTGGCTCCGTGCGA-1	Pericyte
TGCACCTCACGTACAT-1	CM
TCAGCTCAGAGTGGAA-1	CM
CCGTACTAGGATTGCG-1	CM
GCGAGTCTCGAGAAGC-1	CM
TACATTCTCCGGGCAT-1	CM
TCACTCGTCGAGTTAC-1	CM
GTTCAAGCAAAGGCCA-1	CM
ACTAGGTTCAAGAGAT-1	Fib
ATATTCCCAGGCATCC-1	Fib
TTGAGCATCCCAGCAG-1	CM
CGCTAGGGTGCTGTCG-1	CM
CCAATGAAGAGTTCGG-1	CM
CATAACGGTAACACTC-1	CM
CACCTTGGTACTAGAA-1	CM
ATCCTCGTCCTCCTGA-1	CM
GTACTTTGTCAGAGTG-1	CM
TCAAAGCCACGCTAAT-1	CM
TTCTAACGTGCTGGCT-1	CM
TCGCAGGGTTCTGAAC-1	CM
GTTATGGAGCTGAAAT-1	Endo
TGGACATTCCTCCAGT-1	CM
ACAATCGCATTGCCTC-1	CM
TAACTTCCACCTCGTT-1	CM
GTGATCACACCGTTGG-1	CM
TGTGTCCGTATTGTCG-1	CM
ATGTCTTGTCCGTAGC-1	CM
TATCTGTAGGAGACTC-1	CM
GGGAACACACTTATGG-1	CM
CAACGGCTCTTTGCAT-1	Fib
GTGTCCTTCCCAGCGA-1	CM
ATGGATCAGAGCGAAA-1	CM
TGCATGAGTCGTAATC-1	CM
GCCAGCACATCTGCAA-1	Myeloid
CATTGGACAAGAAACT-1	CM
CCTATTATCAAAGTAG-1	CM
TAGGAGGAGACGACTG-1	CM
CCTGGGAAGTACAGAT-1	CM
TGCATGATCTTGTGCC-1	CM
TGGCGCAAGTACAACA-1	CM
GCGGAAAGTACCTATG-1	Pericyte
CCCACATGTGGCATAG-1	Endo
ATTGTGGCAGGTCCTG-1	CM
GCTGTTCTCGGAAAGC-1	CM
TACTGCCCATGCGTTA-1	CM
ACCGCAGTCAAACCAC-1	Myeloid
GTGTGATGTGGACGAT-1	CM
GCTGAGCAGTCTTAGC-1	CM
AGCTGGCCATGCTATG-1	CM
GAGACTTGTAGGTCTT-1	CM
ATGTCTTAGGGCATTG-1	CM
ACCGCAGTCCTCCAGT-1	CM
CAAGAAAGTTTCTCTA-1	Endo
TTAGGTGGTCAACTGT-1	Pericyte
AGTTTGGCACATAAAG-1	CM
CCGTGAGCATATTGGC-1	CM
CTCATGCAGGGTAATT-1	CM
GTTGGTACATTCTTTG-1	CM
TTGAGCAAGGATTGAT-1	Endo
ACAATCGCAAAGGTCG-1	CM
GCCCGAAGTTCCTATT-1	CM
GCGGGTTAGGAACCGT-1	Fib
GTCACCTAGCTGCTCG-1	CM
CTCAACCTCCTTACGC-1	CM
GTCACGGGTATTGTGC-1	CM
TCAAAGCCACAGCTTA-1	CM
CTACTTACACGCTAAT-1	CM
TGATCAGGTAGTAACA-1	CM
AGTGCGCTCCAAGAGG-1	CM
GGCGAAACACTCCACT-1	CM
AGACAAAAGACTAGCG-1	Myeloid
GGAGAACGTTTCGACA-1	Endo
ATTACCTCAACTCCCT-1	CM
TTACCCGCAACTTGGT-1	CM
ATGGATCTCCTCCAGT-1	Pericyte
AGTTTGGCATCATCGA-1	CM
ATGTTTCTCCGAGAGA-1	CM
ACTATTCCATCAACTG-1	CM
GAACCTATCCACACCT-1	CM
CAAGGCCGTTTGGATC-1	CM
TCGATTTCAACGTACT-1	CM
CCTTGCACATGCGCTG-1	vSMCs
TTACCCGTCCAGAATC-1	CM
CCGAAGCAGTGTCCCG-1	CM
GGCACGTAGAACGACC-1	CM
GTAGACTAGTGAACCG-1	Endo
TTCTAACGTATTCGAC-1	Fib
GCCCGAAGTATTCGAC-1	CM
AACCTGACAAGAAACT-1	Fib
CGCTAGGAGAGCCACA-1	Endo
TGCTATTCACTGATTG-1	Fib
TAAGTGCCAAGTTCGT-1	CM
CGATGATAGACACTTC-1	CM
ACAAAGATCCTATCAT-1	CM
TCAGTCCTCAGAACGG-1	CM
TGAGTCATCCTCTCTT-1	CM
CATTGGAGTCTGGATT-1	CM
TCGAGCGCATCACAAC-1	Fib
CCTCCCTAGGTTCGTT-1	CM
CCACGTTCAGGCACAA-1	CM
TATCTGTAGAGCGAAA-1	CM
TTTGAGGGTACGTAAA-1	CM
GAGCATTCAGTAACTC-1	CM
TTTGTGTCAAGCGACA-1	CM
TTCGTTAGTCCGCTTT-1	Fib
AAAGGGCCACTGAAGG-1	CM
AGTTACGGTGCCAAGA-1	CM
GCACGCAAGTCACACT-1	vSMCs
TAGACTGTCATACTTC-1	CM
CACAACATCGTTACAG-1	CM
TTCGGTCCACTCGTGG-1	CM
GGATAGGCAATCCATG-1	CM
TAGGTCAAGAACTAAC-1	Myeloid
TACATGGAGTACTCTG-1	Pericyte
TACCTATCATGATTGC-1	CM
GTGCCAGCACCCTTTG-1	CM
CAGGGCTCATCCCTCA-1	CM
AGGACGAGTTCCCAAA-1	Myeloid
TATCTGTCAGAACGAC-1	CM
TCTAGTTCAAGGAACC-1	CM
TAACAGCTCGACTTAG-1	Myeloid
TTTGGCCTCTTAGTGG-1	Endo
TCAAGCAAGCTCGGCT-1	CM
GCGTTGGAGGTAGGCT-1	CM
GTTACTTCAAGAGATT-1	Myeloid
CCCTCTCGTGACGCAA-1	CM
GTAGACTTCCCATAGA-1	CM
TTATGTCAGAACGTTA-1	CM
CGTGGCACATGCACTA-1	CM
CACTAAGTCGCGTTCT-1	CM
TACTCGCGTGCTTCCT-1	CM
TGCTCACCATGCTATG-1	CM
TGCTCGTGTACGGTTT-1	CM
GCGAGAAGTGCTGTGC-1	CM
ACAATCGCACAAGGGT-1	Fib
TTGCGAAAGTGCCCTG-1	Neuronal
CGTTCCAGTAGAATAC-1	CM
TTACTCACAGGTAACG-1	Fib
TAAGCCATCTCGACAA-1	CM
TGCGTAATCCTTTGCG-1	Fib
GCGTAGCCAACCTCTC-1	CM
CGCACAGGTTCTTTGT-1	Fib
TGTACAGCAATTGGCT-1	CM
CCCAGAGAGTACCCAT-1	CM
TCGATTTCATAGCCAT-1	vSMCs
GGCATTAAGCAGAGCT-1	Endo
CAACGGCTCTCGTGAA-1	Endo
TCACCACCACCTACCT-1	CM
GCAGCCAAGACACTTC-1	CM
AACTGTGCACATATCG-1	CM
ATTGTGGAGCAGTAGC-1	CM
CGCTATCAGCTGAATA-1	CM
CTTTGCGAGTGATTAG-1	Pericyte
CCCTGATGTACCCACG-1	CM
TAGCCCTTCCTTCGAC-1	CM
GGAATCTTCCTCCATG-1	CM
TTTACGTAGGATGTCG-1	CM
AACAAAGGTGGCCTTG-1	Fib
TAATTCCTCTAGTCGA-1	CM
GCATTGATCTGCTACC-1	CM
CATGTTTCATTACTCT-1	Myeloid
TGCTATTCACATTGCA-1	CM
CACTGAAAGCTATCGT-1	CM
CGTAAACAGACAGCTG-1	CM
TGAGTCAGTGCTTACA-1	Endo
ATTTGTCTCATGAACC-1	CM
GCCTACTGTAATGCAA-1	CM
AGCTATGTCGAGTTAC-1	CM
AGCTGGCCACTCGGAC-1	CM
ACTTTCAGTTTCAGCA-1	CM
TTTGAGGCAGCAAACG-1	CM
GGCGTTGGTAAGGTCG-1	CM
CTAACTTGTAAAGGCC-1	CM
GCGAGAAGTAGGTGAC-1	CM
GAACCGCGTTCTGAGT-1	vSMCs
ACCAAACCAAGGATGC-1	CM
AACTGGTGTGATAACA-1	Fib
TGAGCCGTCCCGGGTA-1	Fib
CTGAATGGTTGGTAAA-1	CM
GCACCTTTCCCAATAG-1	Fib
AAGGAGCTCCGTTTCG-1	Endo
GTAGGAGTCTATCTAC-1	CM
TGAGTCATCTCTGAGA-1	CM
CAATCCCTCACTGGTA-1	CM
TCGCCTATCCTGAAAC-1	CM
GACTAACCAACCTCTC-1	CM
TGCTCACCATGCACTA-1	CM
AGCCAGCGTAAACCCT-1	Endo
GCAAAGGGTTGCCGCA-1	CM
CGGACCATCCTTGACC-1	CM
GGATAGGCATCTCTCG-1	Lymphoid
GCTGAGCCACATAAAG-1	Fib
AAACGAAGTACAACGG-1	CM
AGATTCGGTTACGGAG-1	Pericyte
CTGAATGAGAACTAAC-1	CM
CGCTGGATCGCGATGC-1	CM
TTCAACTAGGTGTCGA-1	CM
TTGCTTAGTTACCACA-1	CM
ACTAGGTGTATGAAGT-1	CM
AACATCGAGTACTCTG-1	Endo
TAACGGTCAGATTAAG-1	CM
AACGAGGCAACTACTG-1	Fib
GTGTGATCACATGATC-1	CM
TCAAGGTTCGAGCGCT-1	Myeloid
ACTGCAAAGGTAGGCT-1	CM
GGAATCTGTAGAAGCC-1	CM
AAGATAGTCTTTATCG-1	Myeloid
CACGTTCGTGGACTGA-1	Fib
TTCGCGTCATGGTATC-1	CM
GCAGATTCACAATAAG-1	CM
ACGGATTAGCGTTGCC-1	CM
CTAGGATCACGTGAAG-1	Endo
GAACCGCAGTGTCGCC-1	CM
GAAGAGCCATGCGCTG-1	Endo
TTGCGAAGTATGGGTG-1	CM
GGGAACATCGACCCGA-1	CM
GGGTGTCAGAAATGGG-1	Fib
TAGCATGTCTGACTTT-1	Fib
TGAGTCACACCGAAAG-1	CM
CTCCCAAAGATTCCGT-1	CM
TACGCAATCTTCTTCC-1	CM
ACTATTCGTGATTCCA-1	CM
GCGGTGTGTCGCTACG-1	Fib
TGGCGCAGTGAATGTA-1	Fib
GTTATGGGTCAGAAAT-1	Endo
TCACTCGTCGTAGCGC-1	Myeloid
CACAACAGTTTGATCG-1	Pericyte
CGGACCACATGGTAAA-1	vSMCs
TAAGCCAGTAAGCCTT-1	CM
GATTGACCACAAGTGG-1	CM
CGCTGGATCAATTCCT-1	Endo
TCGCCTAAGGAGGCGA-1	Fib
ATTCGTTCAGTTCGGC-1	CM
CTCATGCCAAATTGAG-1	CM
TCACAGACATTTGTTC-1	CM
TTGAGCAAGTCAGGAC-1	Fib
TTACGGAAGTCTGGGA-1	CM
ACTGCGGAGCGAGCTA-1	CM
TAACTTCCACAAACGG-1	Endo
CTGTTCGTCGTTGTTT-1	Fib
CGCAATAGTTAGGCTT-1	Myeloid
GTGATCACAGGCAGAT-1	CM
ATATTCCCAATGGCAG-1	Myeloid
GCCTAGGTCAAACCCA-1	CM
AAACTGCGTGCTAGTT-1	CM
TGTACGAGTAGCGAGT-1	Fib
ATGTCGAAGGAGTAGA-1	Myeloid
TTCATCATCGATGTAC-1	Pericyte
TCAGGGCGTAAGCCTT-1	CM
CGGACTGAGATCGCCC-1	CM
ATTACCTAGTTTGGAA-1	CM
ACTACGAAGTCGCCTG-1	Fib
GGCGAAACACTCCTCA-1	CM
TCACAGAAGACTAGGC-1	CM
TTACGGATCAGGAATA-1	CM
AGGCCTGTCGTGCTGG-1	CM
GTGCCAGAGGTAGGAA-1	CM
TTGCCCAAGGCAAGGG-1	CM
TGGCGCACAGCGTCGT-1	CM
TCACAGAGTAGACGCA-1	Fib
ATTGTGGTCTATATCC-1	Myeloid
AAAGGGCTCAGGCGCT-1	CM
GCACGGTCATCTCACC-1	CM
TGCACCTCATAGCCGC-1	CM
TGCTATTCATTACACG-1	CM
ACTTCCGGTCCAACCG-1	Pericyte
AATGCCACACAGGAAC-1	CM
TGCTATTTCTTCACTA-1	Pericyte
GAAGTGGAGTCATACC-1	Fib
TTAGGTGTCAAGAGGC-1	CM
AACGTACAGTCGTACT-1	Fib
AATGCCATCGGTCCGA-1	Pericyte
ACATGGTCACCTGAAT-1	Endo
AAGGTTCGTTTCCGGG-1	CM
CAGCCTTAGTAGTCGG-1	CM
GTCTACCTCCTGGAAT-1	CM
TGGCAATTCAAGGCAG-1	Myeloid
TAGGTCACATGCGTTA-1	Myeloid
CAGCCTTCACCGTTGG-1	Fib
GGAACCCAGTCTGCTA-1	CM
TAATTCCTCTGAGTCA-1	CM
CTTAATCCACACTAGT-1	CM
CAGTGCGGTGGCGCTT-1	Endo
AAACTCGTCCAGTTAG-1	Fib
GTCGTAATCACTAGGT-1	CM
TTGCAGAGTCCTTATT-1	CM
GCGGTGTAGTGAACCG-1	CM
CTGAATGCAAAGCTGG-1	Fib
ATTTGTCTCAAGGCAG-1	Pericyte
CGCTATCTCGAACCGC-1	CM
ATGTCGAAGAGTGGAA-1	Endo
CGGTGCATCCGAGAGA-1	Fib
GCCATAAGTGCCAAGA-1	CM
CAAGGCCCAACTACTG-1	CM
ACATGGTAGCAGAAAG-1	Fib
AAAGGGCAGGATGTCG-1	CM
GAGGCTCTCGTTGTTT-1	CM
GCAACCGGTAGTCTGT-1	Fib
CTCCCAAAGATGGGAA-1	Pericyte
CCAGAATCACTCGGAC-1	Pericyte
GGGTCTGTCTGTGTCC-1	CM
TTACTTGGTGCTGTCG-1	CM
TGACTCCAGTATAGTG-1	CM
CAGTGCGTCTGGAAGG-1	CM
ATTGTCTCAAATTGAG-1	Pericyte
ATGGATCGTTATAGAG-1	Pericyte
TCGCCTACAGTGCGAA-1	CM
GTAGTACAGGTTCTCA-1	Endo
AAATGAGGTTAGGAAT-1	Myeloid
AGGCGTCTCCCATAGA-1	CM
GCCTACTGTTGAAGCG-1	Pericyte
GCTTAAGCACCTATTT-1	CM
GCAACCGTCCATATCT-1	CM
AGTGTACCAGAACGAC-1	Fib
TCTCAGCGTCGCTAGC-1	Fib
CAAAGCTAGTAACTCC-1	CM
TGGGTTAAGACAGCTG-1	CM
CAAGCTATCAGTGTGT-1	CM
CCACGTTTCAAGAGGC-1	Myeloid
GAAATGACATGCGACC-1	Fib
CCTTGCACAAGCGGTA-1	CM
CAGTGTAAGTGTCACT-1	Fib
GGTCATAGTGCTTCCT-1	Endo
TTTACGTTCGGGTCCA-1	CM
GCACGGTTCCACCTAC-1	Endo
GGAGAACCACACATTG-1	CM
TCGTTCGTCCCGAAGC-1	CM
GAAAGTACATGACTGT-1	Pericyte
TGGCGCATCATTCTTG-1	CM
CCAGATATCTTAACGG-1	Fib
GTTGGGCGTGAGTAAT-1	Pericyte
GCTTTCGTCTTACTCA-1	CM
ACTATTCTCCCAGCGA-1	CM
GATGGCCTCCTCATTA-1	Endo
GCGAGTCGTGCTGTGC-1	Fib
TAGCCCTTCTGATCCC-1	CM
ACGTGGCCAGAACTTC-1	CM
AAAGATGTCTCTGTTA-1	Fib
GAGGCTCCATTTAGGC-1	Fib
TGCTTCGCAATGGTCT-1	CM
GGAACCCAGGCCAATG-1	Endo
GCTGAGCTCAGTCAAC-1	Endo
TCCATCGCATGCCTTC-1	CM
AAACTCGGTGCGTTTA-1	Myeloid
AGTCCGGAGTAGAAGG-1	CM
CGGTGCAGTAGCTGTT-1	Pericyte
TTGTTGTCAGGTAGGT-1	Pericyte
CAAGCTACAGGGTACA-1	Endo
TAGTCCCGTTCAGTTG-1	Fib
AAGGAGCAGCGGACTA-1	CM
TTCGCGTTCGGGAATG-1	Fib
ACGGATTCAGAGCCAA-1	Endo
TCAAGGTCAAGTCTGT-1	Myeloid
AATGGAACAATTAGGA-1	CM
AAGGTTCTCTTGTGCC-1	CM
GGGAACAGTGGAAGCT-1	Endo
CCTAAAGAGTGTCGGA-1	CM
CTCTACGCACGTTACA-1	Fib
CTCTCGAGTGCACCCA-1	Endo
GCATGATTCCAAGTCA-1	CM
TCAGTTTAGGGAGATA-1	Endo
CATGTTTCACTGTCAA-1	CM
TCAAGACAGCGTATCT-1	Fib
GCCCAGATCCCTATTA-1	CM
AGGCGAACATTAGCAC-1	CM
CTGTATTGTCGCGCTA-1	Endo
ATATTCCAGAGGTGGG-1	CM
ATTGTGGAGGACTAGC-1	CM
TAGCTTTAGATGTTGA-1	CM
AGCGTGCGTAAACCCT-1	Pericyte
GCTTGCTGTATTCTTC-1	CM
CTGTTCGTCAAACCAC-1	Myeloid
TCAGGTACAGTAGTTC-1	CM
GCGTTGGAGCAACGGT-1	Pericyte
CATGTTTTCCAATCCC-1	Endo
GCGGGTTTCAGTGTGT-1	CM
CTGAATGTCAGGAATA-1	Myeloid
ACGGATTCAGAAAGAG-1	Myeloid
CAGTGCGAGGTTCGAG-1	Endo
TGGGTTAGTAGAAAGG-1	Endo
AAAGGATGTATGAAGT-1	Neuronal
GGGTGTCTCAAGGCCC-1	Endo
CCGCATTTCAGGTTTG-1	Fib
TTAGGTGTCGCACCTT-1	Myeloid
AAAGGATAGAAAGGGT-1	Endo
TTTGGCCCAGAACAGC-1	Pericyte
ACGTTAGAGGTTGACG-1	Myeloid
CATTCATAGCTCGGCT-1	CM
GTTGGGCGTCTAAAGA-1	Pericyte
CTCAGAATCGGTTGTA-1	Myeloid
CAGTATGGTGGTAGAC-1	CM
GGTTGCGGTGCAAAGC-1	Pericyte
CAGTGCGGTGATGCTT-1	Pericyte
AGGACGACACGCTGTG-1	CM
AATGCCAAGAAAGCAG-1	Pericyte
CAGTATGTCGGTCTCT-1	Fib
GGTACCGGTTCCAGTA-1	Pericyte
CCGTACTAGAGCCACA-1	CM
ACAGGCCTCGTGGTAT-1	Lymphoid
AGCTGGCGTAACGGAC-1	Endo
CAGCTGGTCTATGAGC-1	Fib
CCCGTTAAGAAGAGTG-1	Fib
CATTCATAGGCAAGGG-1	Endo
CGGACCACAACTCCCT-1	CM
CCCTAGTGTAGCGAGT-1	CM
TCAAGGTCAGTCAGCC-1	CM
CTCTCGATCGGTCTCT-1	CM
TAATTCCCATACTGCA-1	Myeloid
AGCGTATTCATGTTCT-1	Myeloid
AGCGATTAGAGGTACC-1	Fib
ACTTTCAAGCCTATAC-1	Lymphoid
AATGCCACATACCCGG-1	Fib
TGAGTCAAGGCAAGGG-1	Endo
GCTTTCGGTAGTCTGT-1	CM
GTCACGGTCTCCAACC-1	Endo
TATCTGTCAGTATCTG-1	Fib
TCCATCGAGAGTTCGG-1	Endo
AACAAAGAGACTCGGA-1	Endo
TGCTCACTCGATGTGT-1	Lymphoid
GAGGATGAGAGTTCGG-1	Fib
TCAAGGTCAACATAAG-1	Endo
TCACAGAAGGTTGTTC-1	CM
AGTTTGGTCCTATCAT-1	CM
TAGCATGGTCTGCACG-1	CM
CAAGCTAAGATCACCT-1	Endo
AGCTGGCCAACGTCGC-1	CM
GTCACGGAGCATACCT-1	Fib
GCCCGAAGTAATGCCT-1	vSMCs
CTAGCGGAGCCTTTGA-1	Pericyte
TAATCGGAGCCTCGCA-1	CM
CTAGGGCAGAAGCCGT-1	Pericyte
GCTGCGATCTTCACTA-1	CM
CATTGGATCTTAGTGG-1	CM
GACCAATTCGTTCTAT-1	Fib
TAATTCCGTAGAATAC-1	CM
TACTAGGAGGTTCGAG-1	Pericyte
CCGTACTAGTCGAGCA-1	Myeloid
GCAGCTGTCCTGTGGG-1	Lymphoid
TAATTCCCAATGAAAC-1	vSMCs
TCACAAGCATTGAACC-1	Endo
AGCCTCTCAAAGCTGG-1	Fib
ACCGGGTTCATCATGG-1	Fib
CAACGGCAGTCCGGAA-1	Pericyte
TTGACGATCTCTCAAT-1	Pericyte
CACCACTCAGATACAA-1	Pericyte
GGAGGATTCTGTTGCC-1	CM
TGTACAGGTCGCTACG-1	Endo
GCTTAAGGTGGAAAGA-1	CM
ATGGATCTCGATTACG-1	Pericyte
GATTAGCTCTTCTTCC-1	CM
GTCACCTCAAGAAACT-1	Endo
ACATGCACATTGCACA-1	CM
CGCTGGAGTATTCACG-1	Myeloid
TAATCGGCATATACGC-1	CM
TACGCCTGTTCACGTA-1	Pericyte
TTGCGGGGTCATCGTA-1	Endo
AACAAAGCACATCATG-1	Neuronal
ACAAGCTCAGAAAGAG-1	Endo
CGTAAACTCGAGTGTT-1	Fib
TTGAGCAGTAATGCCT-1	Pericyte
GCCATAACAATTCTCT-1	Pericyte
AACTGGTAGATGCGAC-1	CM
AATACGCCATGGATGG-1	Endo
GATTAGCCATGCCTTC-1	CM
GTCACGGTCTATCTTG-1	Endo
GAATCTGGTCCGGTAC-1	CM
GAAAGTAAGGCAATTA-1	Myeloid
AACCTTTAGTAGGAAG-1	Myeloid
TCCCACATCAAAGTAG-1	Endo
TGACTCCTCGATAGGG-1	Endo
GCAGCTGGTCCAAGTT-1	Myeloid
GGGAACAAGTACTCTG-1	Neuronal
TCAAGCAGTGATCAGG-1	Lymphoid
GGGTGTCTCCACGGCA-1	Endo
TGTGACAAGGTTTCTG-1	Pericyte
CCAGATAGTTTCTTAC-1	Endo
TGGTCCTCACCATTCC-1	Myeloid
AGTGCCGGTTGCCTGG-1	Pericyte
GCTCACTAGCGTGTTT-1	Fib
TAGCATGTCCCTACCA-1	CM
GCCTAGGAGCGTATCT-1	Endo
GGTAGGACAGGTTATC-1	CM
TACCCTGCACTTATGG-1	Pericyte
ACTACGACATCAGCTA-1	CM
GAGGATGCATTTCTTG-1	Myeloid
TTGAGTGTCACGTGTA-1	CM
TCGGGACCACATCATG-1	CM
TGGAAGGTCCTGGAAT-1	CM
GCCATAAGTGTGCTTA-1	Fib
GCGATCGTCCACACCT-1	Myeloid
AGCGATTAGGTAAGCC-1	CM
CACCTTGTCGATAGCT-1	Endo
GGAGGATGTTTCGTTT-1	Pericyte
CTCAGCTAGTATACGA-1	CM
GTCACAAGTCACATTG-1	Myeloid
GGTCATATCGCTACCT-1	CM
GAAACAAAGACTTCCA-1	Endo
CCAGATAGTATTCGCA-1	Endo
TAGCCGGGTCGCTACG-1	Myeloid
TATTGCTAGACGACTG-1	CM
TTGGTCCCATATACGC-1	CM
ATTTGTCCATTGCACA-1	Fib
TGTACGACACAGTAGG-1	Fib
GTGCACGGTATCCCTC-1	CM
TAGGTGTGTCTCTAAG-1	Pericyte
GGACACCGTAAAGCTA-1	CM
TATCGAGTCGTGGTAT-1	Endo
TACGCAACAAGGATGC-1	Pericyte
TTCTAACGTGAGGGTT-1	Endo
CATTCCGTCTCTCAAT-1	Endo
GCTCCTAGTACTTCGA-1	Fib
TGTACAGCACTGATTG-1	Endo
TGACAACTCCCGATTC-1	Endo
CTTGAAGGTCTCAAAC-1	CM
GAAATGATCTGGTACA-1	Pericyte
CACTAAGGTCATAAGA-1	Fib
GCAAAGGCAGTCCTGG-1	Fib
TGATCAGTCCCGTAGG-1	Fib
GCTGAGCCAGATTAAG-1	Pericyte
ACTAGGTGTAGAATAC-1	Myeloid
GCAGATTGTTGGCTAT-1	CM
CCACAGGGTCTGATTG-1	Fib
AACCTGAAGGACTAGC-1	Fib
GCACGCACAAAGCTTC-1	Fib
GAGTGAGCATTAACGC-1	Fib
AACTTGGTCTTTGCAT-1	Fib
GCTTGCTTCAGGAAGC-1	Endo
GACCGACCACAGATGG-1	CM
ACAGCGCGTTTGATCG-1	Myeloid
ATTACTCAGGGACGTT-1	Myeloid
GTTACTTTCGGGATCC-1	Endo
TCAAGCAAGTGTCGGA-1	Endo
AACCTGATCCCGAAGC-1	Endo
TGGCAATTCCTCCCAA-1	Myeloid
CACAGATAGCGTCAAG-1	Pericyte
GTGGCGTCACTAGCCG-1	Endo
ACATGGTGTGCGCTCA-1	Fib
CAAGAAATCCGTGCAG-1	Pericyte
CAGGGCTTCGTCTAGA-1	Endo
AGCCTGGCATGGCCGT-1	Endo
TAGGTGTAGGCAGTAC-1	CM
CAAGGCCAGTGATTAG-1	Myeloid
CTGTATTCAGGGTACA-1	Fib
TAATCGGTCACGATTG-1	CM
GCAAAGGAGTGAGTTA-1	CM
TTACGTTTCATTCGGA-1	CM
GGTGCTGAGTCCGATT-1	CM
TTGGTCCCAAGGTCGA-1	Lymphoid
GGAGGATCAAGGAACC-1	Myeloid
TGCTCACTCAATTGGC-1	CM
ATGTCTTCATGGCCGT-1	Fib
AAGATAGAGTTCAACC-1	Fib
CTGAATGGTCCAAGAG-1	Myeloid
TGGCAATTCACTGATG-1	CM
AACATCGCAACAAACA-1	Pericyte
GATTAGCAGTCACGCC-1	CM
GAATCTGAGAAATTCG-1	CM
TAAGCCATCTGACTTT-1	Endo
CCCTCTCCAGTGCTCG-1	CM
GCTCAGGTCTTTATCG-1	Endo
CTAGCGGAGACTTCCA-1	vSMCs
TTCGATTGTCATCGTA-1	Pericyte
GGCACGTGTTAGCTCA-1	Endo
ACAAGCTGTTTGTAGC-1	CM
GTCACGGGTCAATACC-1	Pericyte
AAGGTTCCAAGGATGC-1	vSMCs
ATTTGTCCAGCGTACC-1	vSMCs
AGTGCCGCATGGCCGT-1	Pericyte
TACGGATCAGTTGCAT-1	Endo
CCTGGGAAGCAATAAC-1	Pericyte
TCAGGGCTCTTAACGG-1	Fib
GCGTAGCTCGCATAAC-1	Endo
AGGCCTGAGTAGAAGG-1	Pericyte
CAGCTGGGTAGTCCAT-1	Pericyte
CGTTCCACACGTTAGT-1	Pericyte
ACGTTAGAGTTCGCGC-1	CM
GCTCCTACACTTGCGG-1	Endo
TAGTCCCTCAGGAATA-1	Neuronal
TGGTCAACATAGCCAT-1	Endo
TAAGTGCTCGCGCCAA-1	Endo
GACCGACTCCCGTAGG-1	CM
TCAAAGCTCTGAAAGA-1	Lymphoid
CCCGTTATCCTGTGGG-1	Fib
ATCCCTGGTCAAGACG-1	Myeloid
AGGCGTCGTCAATACC-1	Pericyte
TCAGCTCCACAGATGG-1	vSMCs
TGGTCCTTCCGCCTAT-1	Fib
CGCTGGAAGCCTGTAT-1	Endo
TTGAGCAAGACCAATA-1	Endo
CCGTAGGAGGCCTAAG-1	vSMCs
AACGGGATCGTCCCAT-1	Endo
ACCAAACGTCAGTGTT-1	CM
TTCATTGGTGCCCGAT-1	Pericyte
GAACCGCTCGAGAAGC-1	Pericyte
GAAATGAAGACACGGT-1	Endo
GAAATGATCCGTGCGA-1	Myeloid
AGCCTTCGTCTAAGAA-1	Fib
TACTAGGTCGGCAATT-1	Myeloid
TAGCTTTAGTGATTAG-1	Endo
ACCATCCAGTTGCTTG-1	Endo
CCGTGAGCACTTACAG-1	Endo
AGGCCTGCAAGAAACT-1	Pericyte
ACATGCAGTCCTTATT-1	vSMCs
ACAGCGCCACCCTTTG-1	CM
AAACTGCTCTCCTTAA-1	Endo
AAAGATGGTATCCTTT-1	Endo
TAGCGGCTCTGCTACC-1	Pericyte
AGCCTTCTCTCTGAGA-1	CM
TCAGTCCCACGATTAC-1	CM
GACCCAGTCTCTGACC-1	Pericyte
ATCCAGATCGTTGTAG-1	Pericyte
CATTCATTCTTCTCTC-1	CM
TGGAAGGAGTTCCAGT-1	Endo
GAAGAGCTCCATAACG-1	Endo
CACGTTCAGAAGACTT-1	Lymphoid
GTCCATCAGAGATTAC-1	Endo
ATGTCTTAGCTAGTTC-1	CM
TACCTATGTCATGAGG-1	Fib
CCTGCTAGTAGGGTCA-1	Fib
GGTCATACACGATATC-1	CM
GCGCCAACATTAGCAC-1	Pericyte
TTGAGTGTCGGTCTAA-1	Endo
TGAATCGCAAATGCTC-1	Endo
CATGCCTTCACTGGTA-1	CM
ATATTCCCAGGTAGGT-1	Endo
TAAGCCAAGAGGAACA-1	Neuronal
GTGGCGTAGGGTAATT-1	Pericyte
GGCGAAATCAGCCGAC-1	CM
ACTTCCGGTCGACTGC-1	CM
GCGCATGTCTGCGTCT-1	Fib
AACGGGACAAGTAACA-1	Myeloid
TGACAACAGAAATCTG-1	vSMCs
GGTACCGCATAGCCAT-1	Endo
GACCGACTCTACATCT-1	Fib
TGCTCACCAACGCAAG-1	Pericyte
CCGAAGCGTGGTGGTA-1	Neuronal
CTGTTCGAGATTCCGT-1	Myeloid
TAGCGGCGTGACAAGC-1	vSMCs
AAAGATGTCGCAACTA-1	Endo
TCACAGACAACTCAAC-1	Fib
AATGGCTAGCTTACCA-1	CM
CAACGTACAGCCGAAA-1	CM
GGTGCTGAGCTGCCAC-1	CM
TTAACGGCAGAACAGC-1	Fib
TAGCCCTCAAGGAACC-1	Fib
AATGGCTAGGAGTACC-1	Endo
TCCAGAAGTTCCTATT-1	Fib
AATGCCATCGATAGGG-1	Pericyte
AAACGAAGTCAGGCTC-1	Pericyte
ATGTCGATCCCAATGA-1	Endo
CACATGATCGATCGCG-1	Endo
CGGACCATCTCTTAAC-1	Fib
CTTGCTGGTACGCAAG-1	Endo
TTCTAACAGGTAGGCT-1	CM
CAGTGCGAGTGAGTGC-1	CM
GGATGAGTCAGGATCT-1	CM
AGTTACGTCTGGCGCA-1	Myeloid
TTCATCAAGTTGGAAT-1	Pericyte
ATGTCGACATGGTATC-1	CM
ACGGATTCACAGGAAC-1	Pericyte
GAACTTGAGCTATCGT-1	Fib
TAGGTGTCAAGTCTCA-1	Myeloid
GCAGCCAGTTTAGAAG-1	Pericyte
GAAGAGCTCACTAGCA-1	Endo
TAACGGTTCTCCCTTT-1	Pericyte
TGCGTAAGTAAACGGC-1	CM
CTCTACGCATGCTATG-1	Endo
AAATGAGTCCCAATGA-1	Endo
TCGCAGGCACTCGTGG-1	CM
AGTGCGCGTGCATTGT-1	Endo
ATGTCTTCACCCTTTG-1	Pericyte
CCACAGGCAAATAGTG-1	Pericyte
TGACTCCAGTAGGTCG-1	Pericyte
AGATTCGTCGCCGAAC-1	Endo
CCGTAGGTCGTGAACT-1	Endo
ATGTACGTCCGATTGA-1	Myeloid
TAATTCCGTATTGTCG-1	Endo
TTGAGCAGTATGCTAC-1	Myeloid
ATGTACGGTATGTTCG-1	Endo
CTACTTACAAATAGTG-1	Myeloid
AGCTGGCAGCTGATTC-1	CM
TTGCTTAAGGCCTAAG-1	Myeloid
CCCTCTCAGCCAGAAC-1	Fib
TAACTTCTCTTAACGG-1	Fib
AACAGTCAGAGATTAC-1	Endo
ATGTACGTCCGAGAGA-1	Endo
ACCTGCTTCGTATAGC-1	CM
GCGTTGGTCCCTACCA-1	Endo
GGAGTAGTCCAGGTAT-1	Endo
GAGACTTGTATGTTCG-1	Endo
CACCTGTCAATAGCGG-1	CM
TCTAGTTAGGACCGAT-1	CM
TTAACGGAGAGTCCGA-1	Myeloid
TAGACTGAGTCCGGAA-1	Endo
GCAGATTTCGCCACTT-1	Myeloid
ACCGCAGAGTTGGAAT-1	Endo
TCAATTCTCCGAGGAA-1	Pericyte
CACCACTTCAGTACAC-1	Pericyte
GCAGATTGTCACTCTC-1	CM
GTCACTCTCGTGCTGG-1	Fib
TCGCCTAAGGGATCCA-1	Fib
AGCCAGCAGCTCCGGT-1	Endo
TGCATGACAAGAAACT-1	CM
CTCTACGCAGGCACAA-1	Fib
CTGCGTTTCTGCCGAG-1	CM
GCACGGTAGACACGGT-1	Endo
AGCTGTACATAAAGTG-1	Pericyte
GAAAGTAGTTTAAGCC-1	Endo
TAGGTCACACCGAAAG-1	Endo
AACCTTTGTGTTGTTG-1	vSMCs
GGAATCTGTGCTGAAG-1	Endo
TTGGTCCAGGATGTAT-1	Myeloid
GAAAGTACACTGTTAG-1	Pericyte
CCTTGCACAAGGAAGA-1	Fib
ATAGTCGTCTATCCTA-1	Pericyte
CTTGAAGTCGACTGGC-1	Endo
CCAATGAGTAGGGTTG-1	Myeloid
GAGGCTCTCGCTTGAA-1	Pericyte
GCCAGACAGCTAGTTC-1	vSMCs
TGTAAGCAGTCATCTG-1	Lymphoid
GGTACCGTCCAGGGAA-1	Endo
TAGGTGTAGGAAGAAC-1	CM
TTTACGTCACCGAATT-1	Pericyte
CATTCATTCAAGGCAG-1	Pericyte
CCAGAATTCCTCAAGA-1	Fib
CGCGCAAAGTGAGCAC-1	Endo
GCGTAGCTCTCATATC-1	CM
TGCACCTGTCTAACCA-1	Pericyte
GATCATGGTCTCAAAC-1	Endo
ACGTGGCAGCCTATAC-1	Endo
TCGCAGGAGGACCGAT-1	Fib
AGTGTACCACCCTTTG-1	Fib
TTCAACTAGGTAGGCT-1	Myeloid
TTGTTCATCAGCCGAC-1	CM
GCCCGAAAGTGCTAGG-1	Endo
CTTCTAAAGAACGCCA-1	Endo
ATGGATCGTGGTCGAA-1	CM
AGCCGCAAGTAGTGTA-1	Pericyte
ACAAAGACATGGTATC-1	CM
TCGCCTACAACTAGAA-1	Fib
CTCTACGCAAATTGAG-1	Endo
TACTAGGGTGTTAGAA-1	Endo
TAAACCGTCTTATCAC-1	Endo
GATCATGCACCACAGC-1	Endo
CTACTTAAGGAGGCGA-1	Myeloid
AGCCGCATCCAGGTCG-1	Endo
TTACCCGCAGCAAACG-1	Endo
GCCAGCATCAACACGT-1	Pericyte
CTGTATTCATAGCCAT-1	Pericyte
ACCGGGTAGACAGTGC-1	CM
ACCTGCTCAGCAATGG-1	Pericyte
TGGTCAACAAACTACC-1	Myeloid
CCACAGGCATTTGGCA-1	Pericyte
AAGATAGGTTAGGCTT-1	Pericyte
AGCCGCACATGTCCCT-1	Endo
CTCAGCTAGAACGTCG-1	Endo
ACAGCGCAGCCTATAC-1	Pericyte
CTCGCTAAGGTTACAA-1	CM
CCCACATGTATGTTCG-1	Pericyte
ATGGATCTCCCGTAGG-1	Pericyte
TGGCCTTGTAGTCCAT-1	Endo
AACTGTGCAGAAGTGC-1	vSMCs
ATCCCTGTCGCTTCAC-1	Myeloid
GTCACAATCCATCATT-1	Endo
GACCCAGAGACGAAAG-1	Pericyte
GTGCCAGTCTGGAAGG-1	Pericyte
ACTATTCAGAGTCCGA-1	Myeloid
TTACCGCTCACCACAA-1	Endo
CTTGCTGGTATGAAGT-1	Endo
GTCCATCGTTCCAGTA-1	Pericyte
AGGCGAATCCCACTTG-1	Pericyte
TACCCTGTCTCTTAAC-1	Myeloid
GCACGCATCCATACCC-1	Pericyte
ATTGTCTGTCATCAAC-1	Endo
AGCGTATGTGCACATT-1	Fib
CTACTTAAGGCTCAGA-1	CM
TAACGGTTCCAACGCG-1	Pericyte
AGTGCGCTCACCGCGA-1	Endo
TGATTTCTCTGGTACA-1	Fib
AAGATAGTCTTACCTA-1	Myeloid
GTGTGATGTGATTCCA-1	Pericyte
TCACCACTCCGCTCTA-1	Myeloid
CTAGGGCTCTTAACGG-1	CM
TCGGGACTCTCTTCCT-1	vSMCs
CCCGTTAGTACCAAGG-1	Myeloid
GAGGCTCCATTGATGC-1	Endo
TGTGGCGCACCTGTGG-1	CM
TTCGTTACAGGAGCAT-1	Endo
GTTGGTATCGTTACAG-1	Endo
TGCACCTCAAACCCTA-1	Myeloid
TGCCTGTCAGCGCGTT-1	CM
TGGCAATCAGCGCGTT-1	Endo
TTGCCCACATTAGCCA-1	Myeloid
TAGGTCAAGGCTAAAT-1	Myeloid
ACTGCAAAGCATACCT-1	Pericyte
CCAGAATCATGCTATG-1	Myeloid
TGAGTCAGTATTCTCT-1	Pericyte
CAGCCTTCAAGCCCTG-1	Pericyte
ACAAGCTGTTGCCGCA-1	Neuronal
ATATTCCAGCGTCTGC-1	Endo
AAATGCCGTGCCCAGT-1	Pericyte
GAACGTTCATTCACCC-1	Myeloid
CCCTGATTCTATAGGC-1	Pericyte
CCAGAATGTCAACGGA-1	Pericyte
TCTCTGGAGGTTTCTG-1	Pericyte
CAAGGCCAGTCAACTC-1	Pericyte
GAGTGAGCACGTACAT-1	vSMCs
ACTTCCGGTAGCAGCA-1	Myeloid
GAACCTATCGTGCTTC-1	Endo
TTCTAACTCGGCAATT-1	Endo
TCAGGTATCTTTCGAT-1	Endo
GTGTCCTGTAGGTAAT-1	Fib
GCCCAGAGTATGTCCA-1	Pericyte
TGTTAGGGTATTCTTC-1	Endo
GAGCATTCACCTGAAT-1	Pericyte
ACAGACTAGACGCCAA-1	Endo
TTTGCGCGTAACCGAG-1	Endo
GGTGCTGCATCCCTCA-1	Myeloid
GGGTGTCCACACTAGT-1	Pericyte
TACATGGGTGTTGGTT-1	Pericyte
CTCTAGCAGGGTTCTT-1	Endo
ACGTGGCGTTGGCGAA-1	CM
GCCAGCAGTAGTCCAT-1	Endo
ACGTGGCCAATGTGCT-1	Pericyte
AACTGGTAGGTTCGTT-1	CM
CGCACAGCAATGAAAC-1	Pericyte
TTCGATTTCCATCATT-1	Endo
ACTACCCTCGCTATAG-1	Endo
GATCGTAAGTTGACAA-1	Pericyte
TCAAGGTTCTCCTTAA-1	Pericyte
TTATGTCCACCTATTT-1	vSMCs
GTTGGTAGTACCTATG-1	Pericyte
CTTCTAATCTGCGTCT-1	Fib
AGTGCGCTCGGTTGTA-1	Pericyte
GGGACCTCATTAGCAC-1	Endo
GCATGATAGTCTCCAA-1	Pericyte
ACTTCCGCAATGATGA-1	Pericyte
TCGAGCGGTGCGACCT-1	Pericyte
AGATAGAGTCTGTTGA-1	Myeloid
ACTGTCCAGAGCTGTG-1	Endo
TCCAGAACATCAGCTA-1	Endo
CCTTAATGTCTCTGCT-1	Fib
CGTACAAGTCTCTGCT-1	Endo
CACGTTCCAAGCACTT-1	Endo
CTGCGTTCAGTAAGCG-1	Endo
CCCGTTACAACGGGTA-1	CM
CAGTGCGTCGCGTGAC-1	CM
CAGTATGTCAACACGT-1	Pericyte
ATTACCTAGGCCTAAG-1	Myeloid
GCATTCCTCACCCGGA-1	vSMCs
TGCATTTGTCAGGCTC-1	Endo
TCTAGTTAGGACTTTC-1	Pericyte
CCGCATTAGCGTGTTT-1	Fib
TAGCCCTTCCGCTATC-1	CM
AGGCGTCCACATTGCA-1	Endo
GTTATGGGTCATTGCA-1	Pericyte
GAGTGAGGTTCATTTC-1	Pericyte
ATGTACGGTCATAGAA-1	Pericyte
AGGCCTGCAACGCAAG-1	CM
CTTGCCAGTGCTGTGC-1	CM
TCAGTTTAGTAGCAAT-1	Pericyte
ATCCCTGGTCTCTGGG-1	Fib
TTAACGGGTGTGTGTT-1	Endo
TATTGCTTCCAGAGAG-1	Pericyte
TTAACGGAGATACCAA-1	Endo
CGTGGCACATTTAGGC-1	CM
GCTCCTATCCCACTAC-1	Endo
AGCGTATTCAGTCACA-1	Fib
GATGATCAGACTAGGC-1	Endo
CTAGCGGTCTCTCAAT-1	Endo
TCCCACACACATTGCA-1	Endo
TGAGCCGAGACCAATA-1	Fib
CTCAGCTCAACGTCCG-1	Endo
TCCATCGCACACACCG-1	Pericyte
AATGCCAAGAGGTCCA-1	Myeloid
TGACTCCAGCATACCT-1	Pericyte
CACCACTGTAAACCCT-1	Pericyte
CCTCCCTTCTCGGCGA-1	Endo
TGTAAGCAGAATACTG-1	Myeloid
TAGCCGGAGTGTGTAA-1	CM
TGTTAGGCAGGCAGAT-1	Pericyte
GCGATTAGTCTGATTG-1	Pericyte
TAGCCCTCAGCAACAG-1	Pericyte
TGTAAGCAGAACAGGA-1	Endo
GCACCTTAGCCCATGC-1	Lymphoid
GCGGAAAAGGGTATCG-1	Pericyte
GACCCAGCAACGTACT-1	Endo
TATGTTCGTTTCCGGG-1	Endo
TTGCAGAGTCAACAGG-1	Endo
ATTACCTGTCATCGTA-1	Pericyte
GATGATCCAATGATGA-1	Pericyte
CTCTCGACAGGTCTGC-1	Endo
TATGTGGCAGTAACGG-1	Myeloid
TTCATCATCTTAACGG-1	Pericyte
TACCCTGCATAGACGG-1	Fib
CAGTGCGGTCATAGAA-1	Pericyte
TTAGCGATCAGGAATA-1	Pericyte
TTCATCAGTGGTACTT-1	Fib
GCGCCAAAGGTTCGAG-1	vSMCs
AAACTCGGTTTCCTAT-1	Endo
GTACTTTAGTCGGGAT-1	Myeloid
TAAGTGCGTGAGTAAT-1	Pericyte
GCCTACTCATTATGGC-1	Endo
GCATTGAAGACGCCCT-1	Endo
CTTGCTGAGGTTACAA-1	Pericyte
TTCGATTAGAGAGTAG-1	Pericyte
TTGAGTGAGCTAACAA-1	Pericyte
AGTCCGGCACAGTTAC-1	Endo
GCGCCAAGTTCCCTTG-1	Pericyte
TTGTTCACAACGCAAG-1	Endo
AAACTCGCATTCACGA-1	Endo
TGTGGCGGTTAGAGAT-1	Pericyte
TAAACCGCATCCTGGG-1	Myeloid
TAGACTGGTAACGGAC-1	Endo
CTCAGAATCAGTTGAC-1	Pericyte
TCCAGAACAATGGTCT-1	CM
GTCCATCAGTAATGTG-1	Pericyte
GCGGGTTTCGGTCTAA-1	Pericyte
CGGACCAAGTTCCCGG-1	Lymphoid
AGGCCCATCTCGTAGA-1	Endo
GCCAGACAGGGCTTCC-1	Endo
TAAGTGCGTGACAAGC-1	CM
GGGACCTGTGGAGTGT-1	Myeloid
TGAGCCGGTGCGCATC-1	CM
CAGTGTAAGTGATCTC-1	Pericyte
TGTAGCAGTGCAGACA-1	Pericyte
CAGGGCTGTAGCGAGT-1	Pericyte
TGGTCAATCCTCCAGT-1	Endo
TACCTCGAGAGCGAAA-1	Fib
GGATAGGAGCATTCCA-1	Endo
AAAGATGCACTCAAGT-1	Pericyte
ACCATCCCATTTGGCA-1	Lymphoid
AATACGCCACGTTAGT-1	vSMCs
TTACCCGTCGAGAACG-1	Endo
TTCGCGTCACTCAAGT-1	Endo
TCAGGTATCGGAAAGC-1	Pericyte
GTCGTAAAGAGAATTC-1	Fib
TCCGACTAGCTTTCCC-1	Neuronal
GTCCATCGTAACGGCA-1	Pericyte
TAATTCCAGCAACTGG-1	Lymphoid
GACCGACCATTAGCCA-1	Pericyte
TAGCCGGGTCCTATTT-1	Neuronal
TGTAGCATCACATTCT-1	Endo
ATGTACGCATCGTGAT-1	Pericyte
CCTCCCTCAACGGACA-1	Endo
CTTGTCGAGTCTGCTA-1	Pericyte
ACGTTAGCAGCCACGT-1	Pericyte
CGCTATCTCAAACCCA-1	Endo
AACCAACTCGAGAACG-1	Pericyte
CATTGGAGTCCCTAAA-1	Endo
GTTACTTGTCATCAAC-1	Endo
GCAGATTAGAGGAATG-1	Myeloid
CATGCCTCAATCCATG-1	Endo
CTCAGAATCGCGGCAT-1	Endo
CCGTAGGAGTCTAGAA-1	Endo
TGTAAGCGTGCGTAGA-1	Endo
GCGCCAAAGAGGAAGT-1	Myeloid
AAACTCGTCACTACCC-1	Endo
GAACCTATCGTGAACT-1	Endo
TCAGTCCAGATCACCT-1	Myeloid
TTCGGTCAGGGATCCA-1	Endo
AGCCTCTAGAGGAATG-1	Endo
CTTCCAGTCACTCCCA-1	vSMCs
ATTACTCGTAGCGAGT-1	Endo
TTGAGTGCATCCCAAA-1	Pericyte
CGTTCCATCGGCAATT-1	Endo
AGCGATTCAGCACATT-1	Endo
GATGATCTCTACCCGT-1	Endo
GCTTAAGAGGTAGGCT-1	Pericyte
ATTTGTCGTCCAAGTT-1	Neuronal
GTGACATAGTAGCAAT-1	vSMCs
TCGCAGGAGGTTTCTG-1	Endo
CAACCAAAGCAGAAAG-1	Neuronal
GAACCTATCCCACTAC-1	Pericyte
ATGTTTCAGTTAGCAA-1	Endo
TACTGCCTCCATGTTT-1	Myeloid
CCTTGCAGTCTCTGCT-1	Pericyte
GAAACAACAAGGAGGG-1	Endo
GTGTCCTCAAGGAAGA-1	Myeloid
AACCTGAGTTCCCAAA-1	Myeloid
TAATCGGTCCTATCAT-1	Pericyte
AGTTACGCATGGTAAA-1	Endo
TCTAGTTAGAGCAGCT-1	Endo
CAAGGCCGTTCCCAAA-1	Endo
TCAGGGCCATATTGGC-1	Pericyte
ATAGTCGGTGTACGCC-1	Endo
GAAGTCTGTCATTGCA-1	Endo
CTAGCGGGTATGCTAC-1	Myeloid
ACTACCCAGGCAGTAC-1	Endo
TTCATCAAGCCGCAAA-1	Endo
GTGCCAGTCGAGCGCT-1	CM
TCACAAGAGGTACACG-1	Endo
TTACCGCAGAGATTAC-1	Endo
ACTAACGCATGTGAGG-1	Endo
ACCTGCTGTACTATGC-1	Endo
CTTCTAAGTTCTGAAC-1	Endo
TGCGTAAAGACTAGCG-1	Pericyte
GAACGTTTCGCTACCT-1	Endo
TGGAAGGCATGATTGC-1	Pericyte
CGGACTGCAGTAACGG-1	CM
TGCACCTAGGTGTCGA-1	Endo
TTCGCGTGTAGACACG-1	vSMCs
CGGACTGTCGGATAAA-1	CM
TGCGTAAAGACCGCAA-1	Endo
GATCGTACACTGATAC-1	Pericyte
TTAGCTTAGGCAGTGT-1	Endo
ATCCTGCCAACTTGGT-1	Fib
ACCGGGTTCCGGCGAT-1	Endo
CAACGGCGTGGACGAT-1	Endo
TAAGTGCGTCGATTAC-1	Pericyte
TGGCCTTGTCACAGGA-1	Endo
CGAGTTATCCCTACGT-1	CM
ACTTCCGGTGCGCATC-1	CM
CCGCATTTCCAGTACA-1	Pericyte
CTAACTTGTCAACAGG-1	Endo
CTAACTTAGTTGGAAT-1	Endo
GTAGGAGTCCGTGCAG-1	Endo
CTGTTCGGTGACGCAA-1	Myeloid
TAACTTCTCCGGACTG-1	Endo
TTGCTTATCCATATCT-1	Endo
CGCACAGTCGGTTAGT-1	Pericyte
GCAGCCACAAGTCCTA-1	Endo
GAACCTAGTACCGGCT-1	Endo
CTTAATCTCTGAGTAC-1	Myeloid
TAGCACACATTTAGGC-1	Pericyte
TCACCACTCCGAATTG-1	Pericyte
TCACAAGAGAGGAATG-1	Endo
CTAGCGGGTACGCAAG-1	Endo
TTGCAGAGTCAGGTGA-1	Fib
ACTACCCCACCGAATT-1	Myeloid
TAGACTGAGTTACACC-1	Myeloid
CTCGCTAGTAGAAGCC-1	Myeloid
TGGCCTTCATGTATCG-1	Pericyte
GTGTCAAAGATCGAGC-1	Endo
ACGGATTGTGGGTAGT-1	Fib
AGTTACGGTTTAGGAA-1	Endo
TAGCGGCAGCGTTAGG-1	Pericyte
TCAGCTCAGAGGAAGT-1	Endo
TTCGCGTAGCATGTGG-1	CM
AGGCGTCCAGCGTAGA-1	Endo
ACTAACGTCGTTCAGA-1	CM
GCCATAATCTTACTCA-1	vSMCs
ACTAACGGTCCTTATT-1	Endo
GACCGACGTACGGTTT-1	Pericyte
ACAGGCCCATTCTCGC-1	vSMCs
TTTACGTCACACACCG-1	Fib
ACAGAAACACCCTTTG-1	Endo
GTTATGGAGTGTCACT-1	Pericyte
TCAGTTTTCTGACATG-1	Endo
TCACCACCATGCCTTC-1	Pericyte
AGATTCGAGCGCACAA-1	Myeloid
AGCTGTAAGCATACCT-1	Endo
CGCTATCTCGAACACT-1	Fib
GTCGTAACACAGAAGC-1	Endo
GTAGTACAGTACTCTG-1	Endo
TATGTGGAGAGCCTGA-1	Pericyte
CACCTGTGTGCATTCA-1	Pericyte
CTTAATCTCCGGCTGA-1	Myeloid
CGAGTTATCGGGATCC-1	Endo
ATCCTGCGTGATAGAT-1	Pericyte
CCTGCTACACTGTCAA-1	Myeloid
CCAGAATAGAACGCCA-1	Myeloid
CCATACCAGAGATTAC-1	Endo
GAAGTCTTCTCGTGAA-1	Endo
GTGACATCACATTCTT-1	Myeloid
TGCATTTGTGGACGAT-1	Myeloid
CGCACAGCACCTGAAT-1	Pericyte
GGATGAGCATTTGTTC-1	Myeloid
CTACAGACAACATAAG-1	Pericyte
AACAGTCGTTCGGGAA-1	Endo
TCTCTGGAGGTGAACC-1	Myeloid
CTTGTCGCAGAGAGAA-1	Endo
AGTCCGGCACTCAAGT-1	Myeloid
CCCTGATAGGGAAATG-1	Endo
TTGTCTAAGGGTTCCC-1	Myeloid
GGAACTTGTATTCTGG-1	Pericyte
TGGACATTCCGTGCGA-1	Endo
ACGTGGCAGTTTACGC-1	CM
GCTCACTTCGCTGATA-1	Endo
CCTAAAGTCCAACGCG-1	Pericyte
GCTGAGCGTGGCGCTT-1	Fib
AGCCTGGAGGAACCGT-1	Pericyte
GTGTCCTTCTCCTTGG-1	Endo
GAGGATGTCTCTTCTC-1	Endo
CGCTAGGTCCAATAGC-1	Pericyte
TCACCACAGAAATGGG-1	Endo
ACAGAAACAAGAAACT-1	Endo
CCCTCTCAGTGAATAC-1	Myeloid
TACTAGGGTGCTTACA-1	vSMCs
TCAGTTTAGGAGTACC-1	CM
AGGCGAAAGCGTATCT-1	CM
GCTTAAGCAAGCCTTA-1	Endo
TGATGCATCAGAACGG-1	Pericyte
GTTACTTAGAATCAGT-1	Endo
CTAGGATTCCAGGTCG-1	Endo
GATTGACTCTCATATC-1	Fib
ATTGTGGCACATTCTT-1	Pericyte
TGTGTCCCAGGGTAAC-1	Endo
ACAGCGCCACCGTCTT-1	Endo
ACTGCAACACAGATGG-1	Pericyte
GAGCATTAGTCCAGAG-1	Endo
GACTAACTCTTGTACT-1	Endo
GTTACGATCGGTCTAA-1	Endo
CTTGTCGAGGGCTCTC-1	Myeloid
GCGAGAAGTTCATTTC-1	Endo
TAGTCCCCATCTCACC-1	Lymphoid
GCGCCAAGTAGCTGTT-1	Endo
GGTAGGACATCCCTCA-1	Myeloid
CACTAAGTCGATGTAC-1	Myeloid
TGTAGCATCGATGTGT-1	vSMCs
TATCGAGTCTCGACAA-1	Endo
GAAGAGCTCTCTGACC-1	Neuronal
TGACAACTCGGGCTCA-1	Pericyte
AAACGAATCCATGACA-1	Endo
TCCATCGGTCCGTGCA-1	Neuronal
GCCAGACTCGGCTATA-1	Pericyte
GGTGTCGGTATCTAGC-1	Pericyte
GCCCAGATCCATCTAT-1	Pericyte
GACCAATAGTTCAACC-1	Endo
AACTTGGCATCCGTAA-1	Endo
CCGTGAGCAACGCAAG-1	Endo
GCTTTCGAGTCTGGGA-1	Endo
GACCCAGCAACGTCCG-1	Pericyte
TCTCAGCGTGTCCCAG-1	Endo
CACCACTCAGCGTACC-1	Endo
ACAGACTCAGAGCCAA-1	Pericyte
TGGCCTTCAGGTAACG-1	Endo
TATCGAGGTCTGTGTA-1	Endo
ACTCGGGGTAGAAGCC-1	Pericyte
TTAGGTGCATTACTCT-1	Pericyte
GACCTTCAGCGTTAGG-1	Lymphoid
GACCCAGCATTCGTCC-1	Pericyte
GTCACCTTCTCTTCTC-1	Pericyte
TAAGTGCCATGCCCTT-1	Endo
CAACGGCCATCATCGA-1	Myeloid
TAGGAGGTCGCACAAT-1	Endo
CCTAAAGCAATAGTGA-1	vSMCs
AGTCAACAGGAAGGTA-1	Myeloid
TCGCCTAGTGGTAAGC-1	Endo
GCATTCCCACCTATTT-1	Endo
GAAATGAGTGCCCTAG-1	Pericyte
ACTCGGGCAGAAAGAG-1	Endo
CCCTCTCCACACACCG-1	vSMCs
ATGTTTCAGTGTCCCG-1	Endo
GAGCATTTCACACGTA-1	Myeloid
GCATTGATCTCGTGAA-1	Endo
TAAGCCACATTGTTCT-1	Myeloid
AAAGATGGTCTGGATT-1	Endo
GCCTAGGCACATTGCA-1	Pericyte
GAACGTTAGTCTGGGA-1	Pericyte
ACTACGATCGTCCCTA-1	Endo
TTGAGTGCAGGTGTGA-1	Endo
CTCTCGATCAATTGGC-1	Endo
GCACGCATCCGAATTG-1	Pericyte
TGGCAATGTAGCAGCA-1	Endo
TAGCACAAGTACAGAT-1	Endo
TGTAAGCCATGCGACC-1	Myeloid
AGTGCGCCAACGTCGC-1	Pericyte
CCTTGCAAGTTCCAGT-1	Myeloid
TTACCCGCAAAGGTCG-1	Myeloid
GAACGTTAGGTGATGC-1	Myeloid
CATGTTTGTAGTTTGC-1	Endo
TAGTCCCTCCATTGTT-1	Endo
ACAATCGCACTCAGCG-1	Pericyte
ACGTTAGGTTTGCGAT-1	Pericyte
GCGCATGTCATTCTTG-1	Pericyte
CCACAGGGTGGTGGTA-1	Endo
TGCGTAAGTCCTCAGG-1	Endo
GGACACCAGTCTAGAA-1	Endo
AGTCAACAGATTGACA-1	Myeloid
TGATGCATCCAGTTAG-1	Endo
GAAATGAGTAGGTCTT-1	Endo
CGTTCCAAGCCGCTGT-1	Fib
ATTGTGGAGACAACGC-1	Pericyte
ATGTACGGTGCAAGAC-1	Endo
AGGCCCACATCAGAAA-1	Endo
TTATGTCCAGCGTGAA-1	Endo
CGCACAGGTTTCAGCA-1	Endo
CAAGCTAAGAACGTCG-1	Endo
TGTAGCAGTACTATGC-1	Endo
ACTTTCATCTTGCGCT-1	Lymphoid
TACGCCTCACGCGACT-1	Endo
GTCGTAATCCTCCTGA-1	Endo
CTCAGCTTCAAGGCCC-1	Endo
CCCTGATCAATCATCG-1	Endo
GAACCTAGTGTGTGCC-1	Fib
TAGCACATCAAGGCCC-1	Pericyte
CCGAAGCTCATTCATC-1	Endo
GTAGACTCAATGGTCT-1	Pericyte
CTTAATCAGGCTGGAT-1	Endo
GCCAGACGTTGCTTGA-1	Endo
GCGAGAAGTAGTCTGT-1	Endo
TCAGCTCAGCTCGTTA-1	Lymphoid
GAGAACGTCGTTCAGA-1	Pericyte
GTCACCTCATGGAGGT-1	Pericyte
CGCGCAAGTTATCGAC-1	Endo
ACGGATTTCTCCCTTT-1	Endo
ATTGTCTCACAAACAA-1	Endo
ACCGCAGTCGCATAAC-1	Endo
TTTGGCCAGTCGAGCA-1	Endo
TATCGAGAGGGTATCG-1	Pericyte
CCCACATAGTACGCGA-1	Pericyte
CTAACTTTCTTCTTCC-1	Myeloid
TTTACGTTCCGGCGAT-1	Myeloid
CTTGAAGAGCCATTCA-1	Endo
GCTTTCGCAAGGAACC-1	CM
GGAGTAGCATTAGCCA-1	Myeloid
AATACGCTCCTTACGC-1	CM
TTGAGCAGTAACCGAG-1	Pericyte
GAATCTGAGGTTGTTC-1	Fib
GGTAGGATCAAACCCA-1	Endo
AGCCTGGTCTTCTTCC-1	Endo
TATGTGGAGTAGGAAG-1	Myeloid
TCACCACGTTAAGGGC-1	Endo
TTCTAACCAGGGTAAC-1	Pericyte
CTCATGCAGGCCTAAG-1	Pericyte
TTGCGAATCTGAACGT-1	Endo
TGTGACAAGCTGCTCG-1	Endo
CACCTTGCACGCTAAT-1	Endo
GTGCCAGAGTCTCGAT-1	Lymphoid
ACCCAAAGTTTCGACA-1	Pericyte
CAGCCTTTCTAAACGC-1	Endo
GCGATCGAGTCGTACT-1	Pericyte
TTTGTGTCATCCCTCA-1	Myeloid
TGTAAGCTCATACTTC-1	Myeloid
CAGTGTAGTAATGCAA-1	Endo
TATGTGGCATACAACC-1	Fib
TTGCACCGTGTCCCAG-1	Endo
AATGGCTTCCTTTGCG-1	Endo
GGAGAACGTTTCGTTT-1	Fib
CTCACCAAGTCCGGAA-1	Pericyte
CAGCTAATCGGCTATA-1	Endo
TCGCAGGAGTGCTAGG-1	Pericyte
TCAGTCCAGTCGACCC-1	Fib
GAACCTACATAGGCGA-1	Lymphoid
GCAAAGGAGTCCCGCA-1	Endo
GTTGGTAGTGCAGACA-1	Myeloid
TACTAGGAGTTCGCGC-1	CM
AGCCAGCAGTCTAGAA-1	Fib
TTACGTTCATCGTGAT-1	Endo
CAGGATTAGGCTCAGA-1	vSMCs
AGATTCGCATTGAACC-1	Pericyte
TAACTTCCAGACCTGC-1	Endo
TGTTAGGGTCCGGTAC-1	CM
GCCAGACAGTTGCTTG-1	Endo
CTGCTCAAGGCGCTTC-1	Fib
CGTGGCACACACATTG-1	Endo
CAATCCCCATAGCCGC-1	CM
TTTGGTTAGCTTCAAC-1	Lymphoid
GACCTTCCAAGACACG-1	Endo
ACTAGGTTCGATATGC-1	Pericyte
TTACGGAAGTGCCCTG-1	Endo
TTCATTGTCCAAACCA-1	Endo
GAGCATTGTTCCGCGA-1	Endo
TCCATCGTCCAGGCCA-1	Pericyte
GTTATTCTCACTACCC-1	Pericyte
CACCACTCAGCTTACA-1	Endo
TTCATTGAGGACTTTC-1	Endo
AATGCCAAGTCGTATC-1	Endo
TCGTTCGAGTGTCCCG-1	Endo
GCAGCTGTCCTCAAGA-1	Endo
ACAATCGGTGTTTCTT-1	Endo
ACGTTAGTCTATATCC-1	Pericyte
ATCCTGCCACGCGATC-1	Myeloid
AGCTGGCCAGGAGCAT-1	Pericyte
CTAGCGGGTCTCAAAC-1	Endo
GCACCTTTCTACATCT-1	Pericyte
AACAGTCAGTAGACCG-1	CM
GAGATTCGTGAATCAA-1	Lymphoid
GGGTTATGTCCGAGCT-1	Fib
TCACCTGCACACACCG-1	Pericyte
GTTACGAAGCACGTAG-1	Pericyte
ACCGAATCAAGCAGGT-1	Endo
GAACCGCAGTACAGTA-1	Pericyte
GACCTTCGTATGGATA-1	Endo
GTCACGGCAAAGCTTC-1	Fib
TTCAACTAGGGCTTCC-1	Endo
AACGTACTCCGGACTG-1	Endo
TGCTTTACAACCTCTC-1	Pericyte
GAACTTGAGAATACTG-1	CM
CACTAAGAGAGATTAC-1	Endo
GTCACTCTCTCGACCT-1	Endo
TACAGCATCAGTACAC-1	Endo
TACTAGGAGAGCGGTT-1	Pericyte
GGGAACATCGAGTTAC-1	Endo
GCAGCTGTCCAACAAC-1	Endo
TCTAGTTAGCTATCGT-1	Pericyte
TGTGACACAACTGCGC-1	Pericyte
TTTGTGTGTAGAACGC-1	Endo
GACCTTCCATAGATAG-1	Endo
AGCGATTAGAGGCGGA-1	Fib
TGCTTCGGTGTGTGCC-1	Endo
TAACTTCCATCGGCCA-1	Endo
CTGTATTAGATTGACA-1	Pericyte
GTGTCAAGTGATGCTT-1	Pericyte
TTCTGTAGTTCTACCC-1	Pericyte
CAGTATGGTACGTATC-1	Fib
TCGTTCGTCTTCGTTA-1	Pericyte
CCACGTTTCTCGTGAA-1	Pericyte
TAAGCCACAGTATCTG-1	Endo
TAACTTCAGGCTTAAA-1	Endo
TATCTGTGTCCGTAGC-1	Endo
CACAACAGTCCGTGCA-1	Pericyte
CTCATGCCACTGCTCT-1	Myeloid
TATCTGTCAAACCCTA-1	Pericyte
AGCGTATCACTGTCAA-1	Endo
GGTTGCGGTCCCGAGT-1	Pericyte
TAGCTTTTCCGATTGA-1	Myeloid
CCACGTTCACGCGACT-1	Myeloid
TACATTCTCCTGTGGG-1	Pericyte
TTACTTGGTTTCGATG-1	Endo
GTGTCCTAGTCGTATC-1	Endo
ATCCTGCCAAGTAACA-1	Myeloid
AAATGCCCAGGCTACC-1	Endo
CTCTACGGTATGAAGT-1	Pericyte
TGGCCTTAGGCGTAGT-1	Endo
CGCACAGGTGCTTGAT-1	Endo
TTCGATTGTGAGTTGG-1	Pericyte
ACAGAAATCCATGACA-1	Endo
TCGAGCGTCCATCGAA-1	Myeloid
TGCACCTAGTGATTAG-1	Endo
CCCTAGTGTGGCGCTT-1	Pericyte
GGGTTATTCCCGATTC-1	Endo
TTTGAGGCACTAAACC-1	Endo
ATAGTCGAGCCTGTAT-1	Endo
CCTGGGAGTATCCCTC-1	Endo
CAAGGCCAGTCGACCC-1	Endo
CGCTAGGAGAGCTACG-1	Pericyte
TACTCGCCACAGGTAG-1	Pericyte
CCTGGGAGTAAACCCT-1	CM
CTTGCTGAGAACCATA-1	Pericyte
CGATGATAGATTGACA-1	Endo
CCAGAATCAGGTGGTA-1	vSMCs
TCACAAGAGATTCCGT-1	Endo
CTCTACGGTACGTATC-1	Neuronal
TCAGCTCTCGGAAAGC-1	Pericyte
CCTTGGTGTGATAAGT-1	Pericyte
TCCGACTTCTCCACTG-1	Pericyte
CTACAGATCGCTATTT-1	Myeloid
TTCTAACGTACTAGAA-1	vSMCs
TTGTTGTCAACGACAG-1	Endo
GCACGCATCGTATAGC-1	Lymphoid
TATCTGTGTTGTCGGC-1	Endo
TGTGACACACAGGAAC-1	Endo
GAATCTGGTTCCTATT-1	Endo
ACGGATTGTCTGCACG-1	Endo
GCAGCTGTCGAGAACG-1	Pericyte
TGCATGAAGATGTTGA-1	Endo
AGCTGATCATCGTACA-1	Myeloid
TAACGGTCACTGTCGG-1	Pericyte
CGCAGGTGTTAAGTCC-1	Pericyte
TGGTCCTCAAGGACCA-1	Pericyte
TTTACGTAGTGAAACT-1	Endo
ATAGGCTTCGTCCCTA-1	Endo
CCCTAGTAGTCGAAAT-1	Fib
TCAGGGCAGACCCTAT-1	Endo
GCTCGAGTCGTGCTTC-1	Pericyte
CTTGCCATCGCTGATA-1	Myeloid
TATGTGGGTGCTGAAG-1	Pericyte
CAAGGCCTCGTATAGC-1	Fib
CTCAACCTCGTCTAGA-1	Endo
CATTCCGAGAACTCCT-1	Endo
CAGTGTACAATTAGGA-1	Endo
ATTACCTGTCGTAATC-1	Endo
TGAGTCAGTTAGGAAT-1	Lymphoid
GCCAGCACAGACCTGC-1	Pericyte
TTACCGCTCCCATAGA-1	Endo
GCTGAGCAGGCTCAGA-1	Endo
ACAAGCTAGCTGCTCG-1	Endo
GTTCAAGCAACGGGTA-1	Pericyte
AGATTCGCAAGTTCGT-1	Pericyte
ATATTCCTCAATGCAC-1	Endo
GGCATTACATGGCCCA-1	Endo
GCAGCTGAGAACGTTA-1	vSMCs
CACCTGTTCTTACCTA-1	Endo
GTGTCCTCACTGGGCT-1	CM
CAGCTAATCTGTTTAC-1	Endo
TTGTTCAGTAGGGTTG-1	Lymphoid
CATTCCGCATTAGCAC-1	Endo
CGTACAAGTCTGCGCA-1	Endo
CCTGGGAAGCCTCGCA-1	Pericyte
GAAGAGCCATCCCAAA-1	Lymphoid
GACTAGTTCTTACTCA-1	Pericyte
GCGGGTTGTGTCCTTC-1	Pericyte
TAGACTGTCCAAGAGG-1	Endo
GTACTTTGTTAAGTCC-1	CM
CCATACCCAAGTTCGT-1	Pericyte
CCCTAGTGTTAAGGGC-1	Endo
ATGTCTTCATGGTAAA-1	vSMCs
GCAGCTGTCTGACATG-1	Endo
AGTCAACAGCGTAGCA-1	Endo
GCTCCTAGTACGTAGG-1	Pericyte
TGTTAGGGTGACGCAA-1	Endo
TAAGCCAAGGCAGTGT-1	Endo
TACATGGCAAGCGAAC-1	Endo
CAAAGCTAGGATGCCA-1	Endo
CGCTATCTCGCTTACC-1	Endo
CAGTATGAGGATTAAC-1	Pericyte
GTTACTTCAGTTCGGC-1	Fib
GAGAACGGTCGACTGC-1	Endo
CCACGTTGTCTCTGCT-1	Endo
GTCTACCGTGTGAGGT-1	Pericyte
CCCTCTCCAGCGTAGA-1	Fib
CAGGGCTAGCCATTCA-1	Endo
GTGCCAGAGTAGTCGG-1	vSMCs
AGACAAACAAACCGAG-1	vSMCs
GCGCCAACATGGAGGT-1	Endo
TGTAGCACAATACTGC-1	Endo
AACGAGGTCTGGCGCA-1	Fib
CATAACGGTGTCCAGC-1	Neuronal
GATCATGTCAAACCAC-1	Pericyte
CGTTCCACAACTCGTA-1	Endo
GCTCACTAGCAGGACT-1	Endo
ATTACCTGTACAAATG-1	Endo
AATGTCGGTTTGCGAT-1	Endo
CTACTTATCTCTGACC-1	Lymphoid
CTGAATGAGTCGAAAT-1	Endo
CAGTATGCAGAGATGC-1	Myeloid
ATATTCCAGCTAGTTC-1	Pericyte
CGATGATCAGGTCCTG-1	Endo
TGTGGCGTCTGTAGAC-1	Endo
TAGTCCCAGTCGATAA-1	Endo
TGCCTGTCAGTCAGCC-1	Pericyte
GTGTCAACATCCCGGA-1	Pericyte
AGGCGAACAACTTGGT-1	Neuronal
GTCTACCGTCCTATTT-1	Myeloid
TGGCAATGTTTCAGCA-1	Lymphoid
TTCGGTCAGTGATTAG-1	Lymphoid
GGAACCCAGATGGCAC-1	Endo
ATAGGCTCATCGTACA-1	Endo
TTACCCGAGCTAACAA-1	Lymphoid
AGTCCGGTCCCTACCA-1	Pericyte
AGTGCCGCATGGAGGT-1	Endo
CAACGTACACGCGCAT-1	Lymphoid
ACTAGGTGTCTGTCCT-1	Neuronal
CTAGGGCAGACCAATA-1	Pericyte
TTCGATTCAGAGAGAA-1	Endo
CACCACTGTGCTGTGC-1	Pericyte
TGGCCTTGTGATAAGT-1	Endo
ATCCCTGCAGAACAGC-1	Endo
CACGTTCCAGTAAGAT-1	Endo
CACTGAATCCTCCAGT-1	Lymphoid
GTCACCTGTTCTGAAC-1	vSMCs
CGGACCAAGGGTTCTT-1	Endo
TATTGCTAGGCTTTAC-1	Endo
TGGCGCACAATGCCAT-1	Endo
CACCTGTAGGCAGTAC-1	Endo
TTGACGAAGATCTCAC-1	Endo
ACCTGCTAGTTCAAGA-1	Endo
TACCTCGAGCGTATCT-1	Pericyte
TCACAAGAGGATTAAC-1	Pericyte
CGCTGGAGTCACTCTC-1	Endo
AGCCTTCTCTGAAAGA-1	vSMCs
TACTCGCGTGAGTTGG-1	Myeloid
ACGTTAGAGTCGTATC-1	Endo
GGGCCATTCGATGAAA-1	Endo
TCACCTGAGCGCACAA-1	Endo
AACCGATTCGGTCGAC-1	Endo
CGATGATGTTGAATAG-1	Neuronal
TTCTGTACACAAGTGG-1	Pericyte
CCGTGAGTCACGGGTC-1	CM
TGCTATTGTCCAGACC-1	Fib
GAAGAGCAGAAACGCC-1	Endo
ATTACTCCACCTGTGG-1	Pericyte
GGAATCTCAAGCGTCC-1	Fib
TCAAGGTTCGGTACTA-1	Pericyte
GCGGTGTCACATTCTT-1	Endo
ACTAGGTAGTCCCTCT-1	Myeloid
CCTCCCTTCTCTATTG-1	Myeloid
AGACAAAAGGGCTTCC-1	Lymphoid
GGAACCCAGGGTCCCT-1	Endo
CTGAATGTCCTCAAGA-1	Endo
TCACCACAGTAGTTCC-1	Endo
TAAGTGCAGTCACGCC-1	Fib
ATTGTCTTCGTTCTAT-1	Endo
CGGACTGAGGCAATTA-1	Lymphoid
CAAGAAAGTTAGTAGA-1	Endo
TAGCCCTGTGCTAGTT-1	Endo
GCAAAGGCAGTTCGGC-1	Pericyte
TTTACGTGTTTAGGAA-1	Pericyte
TCACTCGGTATTGTCG-1	vSMCs
AGCTATGAGGCCTAAG-1	Endo
TTGAGCAAGTCCGATT-1	Endo
GCGTTGGCATTATGGC-1	Endo
TGCTTTACATTAAGGA-1	Pericyte
CGAGTTAGTCCGTAGC-1	Endo
TTACCCGGTTCCTATT-1	Endo
TAGGAGGGTTAACTCG-1	Endo
CACTAAGTCTGTAGAC-1	Endo
GCTTGCTAGTTATGAG-1	Myeloid
AGTGCCGGTGCTGGCT-1	CM
ACTATTCAGATATGTG-1	Pericyte
GAGTGAGGTAAGTCTC-1	vSMCs
TACCTATAGCTCCGGT-1	Lymphoid
TCACTCGAGTGTCGCC-1	Myeloid
TGGTCAAGTGACCAGA-1	Endo
GCAGCCAAGGCAAGGG-1	Endo
CGCTGGATCCACTAGA-1	Endo
ACATGGTGTAAAGGCC-1	Endo
GCTGTTCGTGCGCATC-1	CM
CTGGCAGAGTGTAATG-1	Fib
TAGCGGCGTACGGAGT-1	Endo
AACAGTCAGTGATCTC-1	Endo
TTCATTGGTAGGGTCA-1	Pericyte
CTAGGATCACTGATAC-1	Endo
TACAGCAGTAAGTCTC-1	Fib
CGGACTGCATGCACTA-1	Endo
TAACGGTCATTGCCTC-1	Pericyte
TCAAGGTAGAATATCG-1	Pericyte
CTGAATGCATGGATGG-1	Endo
CAAAGCTCATGGTATC-1	Endo
CTCAGAAGTACCGGCT-1	Endo
GCCATAATCTGTTGCC-1	Pericyte
GGAGAACTCCACTAGA-1	Endo
CATGTTTCAGGTTATC-1	Endo
ACGTGGCCATCGACGC-1	Endo
GCGGGTTGTCATCAAC-1	Endo
ACTACGAGTTGCAGCC-1	Pericyte
GCCAGCATCCCGATTC-1	Endo
TAAACCGCATGGCCGT-1	Lymphoid
CAACGGCGTTGAAGCG-1	Endo
ACGTTAGCAGGACTGA-1	Pericyte
CGCACAGGTAGACACG-1	Endo
CGTAAACAGGCAGATC-1	Endo
GCTGCGAAGGGTTCTT-1	vSMCs
CAGCTGGCAATTCGTG-1	Endo
TGGCCTTCAACGACAG-1	Neuronal
GCGCATGCATCGCCTT-1	Endo
GTTATTCGTGCCAAGA-1	Pericyte
TGGTCAATCGATCGCG-1	Endo
GCTGCGATCCTCTCTT-1	Endo
TGTAGCATCCATCATT-1	Endo
GCATTCCCACTGTCGG-1	Endo
CACATGAGTCTCTAAG-1	Pericyte
AACCTTTCAGGTAACG-1	Endo
CACCTGTGTGTCCCAG-1	Endo
TTTGGTTAGGCTTCGC-1	Endo
ACAGCGCTCCTCCATG-1	Endo
TCTCTGGTCCTCCATG-1	Endo
TCAAAGCCAACTGCGC-1	Endo
GGAGGATGTCGCGCTA-1	Endo
AAAGGATGTGGTAAGC-1	Pericyte
TTCTAACAGAGAGTTT-1	Endo
CTCTACGGTGAGTAAT-1	Pericyte
GATCGTATCTTGTCGC-1	Endo
TTGTCTAGTAATGCAA-1	Myeloid
GCGATCGGTGAATCGG-1	Pericyte
GCCAGCAAGTGAATAC-1	Pericyte
ACAGAAAGTGCCAAGA-1	Myeloid
GGGCCATGTATTCTGG-1	Endo
AGCGATTAGGCAGATC-1	Endo
GCCATAAGTCCTATTT-1	Endo
TAGTCCCGTCTGGGCT-1	Endo
GCCTAGGGTAATGCCT-1	vSMCs
TCCCACAGTGTCCAGC-1	Lymphoid
CCACAGGGTTGCTTGA-1	Pericyte
ACTATTCGTAGAATAC-1	Myeloid
GTGCACGCAAACAGTA-1	Lymphoid
CCTGGGATCTGTTGCC-1	Pericyte
CCTTGGTAGTGTCGCC-1	Pericyte
CATTCATTCGGATAAA-1	Myeloid
GACTAACCAGGCATCC-1	Endo
GGTCATAGTCGTAATC-1	Lymphoid
TAGACTGAGTATGCTC-1	Myeloid
AGATAGATCATTCATC-1	Neuronal
CCAGATACAATGGTCT-1	Endo
TCAGTTTAGGCTTTAC-1	Endo
TATCTGTCAGCGTAGA-1	Endo
AGCGTATAGTCACGCC-1	Pericyte
TCGGGACAGGTTGTGG-1	CM
TTTGTGTGTAGATGAT-1	Endo
GAAAGTAAGTCGGGAT-1	Pericyte
GCCAGCACACTTGCGG-1	Pericyte
GTGATCAGTGAATACA-1	Myeloid
CTGTATTAGACTAATG-1	Endo
CTCAGCTCAGTTAAAG-1	Endo
TAGCATGGTGCTGGCT-1	vSMCs
GGACACCAGGACTAGC-1	Pericyte
TTGCTTAGTGGTCGAA-1	Endo
CTCTCGAAGCTGCTCG-1	Fib
CCCGTTAGTTCCCAAA-1	Endo
GTTGGTACATAGCCGC-1	Pericyte
GTCACGGCACATGATC-1	Endo
GAGTGAGGTGATAACA-1	Endo
TACTGCCCATAAAGTG-1	CM
TCTATTGAGACTAGGC-1	Pericyte
GGCACGTAGACGTCAG-1	Endo
CGATGATGTTTCGACA-1	Myeloid
CCTCCCTCATCCTCGT-1	Neuronal
TGTTAGGTCGTGCTTC-1	Myeloid
TTCATTGTCTCCCTTT-1	Endo
TTATGTCGTGCTGTGC-1	Myeloid
TTCTAACGTAACGGCA-1	Endo
GTTGGTACAAATGCTC-1	Pericyte
GCAGCCACACATGATC-1	Endo
CCCACATTCATTCATC-1	Endo
TGTGACAAGCTACGCC-1	Myeloid
GCTCGAGAGGAAGAAC-1	Endo
TTCTGTAGTTTAAGCC-1	Pericyte
GCGGTGTGTGCAGACA-1	Myeloid
AATGGCTGTGTACGCC-1	Pericyte
GGTGTCGGTCACAGGA-1	CM
AAAGATGTCGCGTTCT-1	Pericyte
CATGCCTTCTCGTGAA-1	Endo
CCAATGAAGAAATACC-1	Fib
ACTGCGGAGACTAGCG-1	Fib
ACTGTCCCACATTGCA-1	Endo
TGCTATTCAAGCGGTA-1	Endo
CAGTGTATCCTTCGAC-1	Endo
CATGCCTAGCTAGCAG-1	Endo
AGCGTATTCGCTCTAC-1	Endo
TCGCCTAGTGTACGCC-1	Endo
TGATGCACAAGCGTCC-1	Pericyte
TTGCAGATCTTACGGA-1	Endo
GTGTCCTCAAAGACGC-1	Pericyte
GGCATTAGTTTCGTTT-1	Lymphoid
GCTGCGAGTGCACTTA-1	Endo
CACATGACACAAGTGG-1	Endo
GCGTAGCAGACGACTG-1	CM
CCGAAGCTCTCATCCG-1	CM
GAGACTTAGACCTATC-1	Endo
TGGAAGGCAATGGTCT-1	Endo
TCAAAGCCATCGACCG-1	Myeloid
TCAGTTTCACTGGGCT-1	vSMCs
TCCGACTGTTCAGTTG-1	Fib
TTCGTTAGTTTAAGCC-1	Endo
CGATGATCACCGTTGG-1	Endo
AACCTGATCGATGTAC-1	Endo
GCGTTGGGTTGCCTGG-1	Lymphoid
AGTCCGGAGGGAGTTC-1	Endo
CCAATGACATGTAGAA-1	Endo
GCGAGTCCATCAGCTA-1	Endo
CGCACAGAGCACGTAG-1	Endo
ACGTGGCTCTGATCCC-1	Lymphoid
CACAACAAGCTAGTTC-1	Endo
GCCTAGGCACGCGATC-1	Endo
TCGCAGGGTTGCCGCA-1	Pericyte
GTGTCCTGTGGACGAT-1	Endo
GCTGCGACAACACGGA-1	CM
TGGTCAAGTGCCGGTT-1	Endo
TCAATTCGTGTCGTCG-1	Myeloid
AAACTCGCATGCGCTG-1	Pericyte
CTCTAGCTCTGCTACC-1	Myeloid
GGATAGGAGTGAGTGC-1	Myeloid
TCACCTGCATTCTCGC-1	Lymphoid
CAAGGCCGTGAGCTAG-1	Endo
CAGTGCGTCCGCCTAT-1	CM
TGGGTTAAGTTGCGCC-1	Fib
TTGAGCAAGTAATCAG-1	Lymphoid
GCGGAAACACTCGTGG-1	Endo
TTAGCTTCATTTGGCA-1	CM
GTTGGGCTCGGAGTTT-1	Lymphoid
AGCTGGCGTTGCTTGA-1	Pericyte
CCGAAGCCAGCGTGAA-1	Endo
TCGATTTCAAGCGTCC-1	vSMCs
CTCAGCTAGAGAATTC-1	Pericyte
GCTTGCTTCAGTGTGT-1	Endo
CGGACTGTCGAGGCTC-1	Endo
GGGTCTGAGGTAAGCC-1	vSMCs
TAGCGGCAGACGCCAA-1	Endo
GCTTGCTAGGGCATTG-1	CM
ACCGAATCATAGCAGG-1	Endo
GAATCTGTCTGAGTCA-1	Pericyte
CTTGTCGTCTGCCGAG-1	Fib
TGCTCACAGTACCACT-1	Endo
ACAGACTTCCGAGGAA-1	Endo
GCTGCGAGTCCGTCGA-1	Endo
GGAGAACCAGACCTGC-1	Endo
TTTGGCCTCCGTGCAG-1	CM
CAAGAAATCTCGGCGA-1	Endo
CAGTGCGGTGTAGGAC-1	Endo
TAACAGCTCGATAGTC-1	CM
GCACGCACATCCTGGG-1	Endo
GCGCCAACAGCGCGTT-1	Myeloid
TCGCAGGCACGCGATC-1	CM
TACATGGTCTGATCCC-1	Lymphoid
ACTGCGGAGGCTGGAT-1	Neuronal
ACCGAATGTTGTATCG-1	Endo
TCCGACTAGTAGAAGG-1	Endo
GACCGACCATGGTATC-1	Endo
TGTTAGGCAAAGAAGG-1	Endo
CGGTGCAGTGCGCATC-1	Pericyte
AACTGGTCACAAGGGT-1	CM
TACCCTGAGGAAGGTA-1	CM
GACCGACAGAGAGTTT-1	Endo
GTGTCAACACTCCCAT-1	CM
GCTTTCGAGTGTGTAA-1	CM
ACAAGCTGTGAGTAAT-1	CM
CTTCCAGAGTTGCGCC-1	Fib
GGTACCGTCGTGGCGT-1	Myeloid
