Barcode	cell_type
GCAACCGAGTCCGTGC-1	CM
GCACCTTAGCATGTGG-1	CM
CTGTTCGGTGAGCTAG-1	CM
AGATAGACAGAGCCAA-1	CM
GCAGATTTCGATAGCT-1	CM
GGTGAAGAGTCCGGAA-1	CM
GCATGATCAACGGGTA-1	CM
CCGTGAGCAAAGAGAG-1	CM
GCAGCCAGTTTCTACT-1	CM
TCGGGACTCCAAGAGG-1	Pericyte
TGCTCACTCGTGAACT-1	CM
GATTGACAGACCCTAT-1	CM
GGGCCATCAGTTAAAG-1	CM
TAGCCCTGTAAGGTCG-1	CM
ATTACTCCACGTACAT-1	CM
GGAGGATCACTAGGAG-1	CM
TAGCTTTCACGCGTTG-1	CM
GGGCCATTCAGGCCGT-1	CM
TGATGCACAATAGTGA-1	CM
CTTTGCGTCGCCGAAC-1	CM
CAGTATGAGTGTCCCG-1	CM
AGCGTGCTCGGCTATA-1	CM
GCGATCGTCCCAGCGA-1	CM
TGGGTTAGTTGTGAGG-1	CM
CCCTCTCGTGCTAGTT-1	CM
GCACGCAGTAGCCATT-1	CM
CCAGAATTCACATTCT-1	CM
GATCGTAAGGCACTAG-1	CM
GGGACCTCACCATTCC-1	CM
ATTACTCTCGATGCAT-1	CM
TGGGTGCGTACGGATG-1	CM
GAGCGCTAGTATACCC-1	CM
TAAGTGCGTTACGAAA-1	CM
TCAGGGCTCGTGGAAG-1	CM
AAACTCGTCGGTGATT-1	CM
CTGTTCGAGATTACGA-1	CM
GTGTCAAAGTTAGCAA-1	CM
GCTCGAGAGAGCGGTT-1	CM
GCGGAAAGTCATCAAC-1	CM
CAGTGTAAGAAAGCAG-1	CM
CACATGATCAAAGTAG-1	CM
GCGGTGTTCGCTTACC-1	CM
ACGTTAGCATCACAGT-1	CM
CTTGCTGCACCTGAAT-1	CM
AACCTTTGTCAGAAGC-1	CM
GTTACGAAGCCCATTA-1	CM
GTCCATCTCGCGTGAC-1	Myeloid
CAGTGTATCCCAGCGA-1	CM
CAAGCTACATTGCGAT-1	CM
ATTACTCAGGTGTCGA-1	CM
TTAACGGCAACATAAG-1	CM
GCCAGACTCGTTTGAG-1	CM
CCGAAGCGTACGAGAC-1	CM
GCCATAAAGAACGACC-1	CM
GTAGGAGGTAGGGTTG-1	CM
CCAGATAAGTTGGAAT-1	CM
GATTAGCGTCGTAATC-1	CM
TGCATTTAGACTTGAA-1	CM
CTGGGACTCTTCGTTA-1	CM
CACAGATCATAGCAGG-1	CM
TTCTAACTCGGTCCGA-1	CM
AGATAGAGTCAGACGA-1	CM
TTGAGTGAGTAACATG-1	CM
GCAACCGTCCTTTGCG-1	CM
GATGATCCAGCTTACA-1	CM
GTGGCGTGTGCCCAGT-1	CM
GTCACGGGTGAGTCGA-1	CM
TGAGCCGCATTACACG-1	CM
CCACGTTTCCATACGA-1	CM
TAGCCGGTCCCACTAC-1	CM
CGCAATAAGGCAAGGG-1	CM
CAAAGCTGTCTTAGCA-1	CM
CTGCTCAGTTTGCCAA-1	CM
GTCTACCTCTGGTACA-1	CM
TTTGCGCCAGACTAAA-1	CM
ACAATCGAGAGGCGGA-1	CM
GCTGAGCCAGCAACGA-1	CM
ATTTGTCTCCTGAAAC-1	CM
TTGCTTATCTCTTAAC-1	CM
TGCTTCGAGAATCAGT-1	CM
CTCTCAGGTGGACTGA-1	CM
CCGTAGGTCTTGCGCT-1	CM
GCCAGCAGTAACGGTG-1	CM
AACCGATCATGTCCCT-1	CM
GCAGCTGTCACTTACT-1	CM
TCGCAGGTCCTGGAAT-1	CM
GCGAGTCCAATTCGTG-1	CM
GCGAGAAAGTAGGTCG-1	CM
TGGCCTTAGCGCCTAC-1	CM
CATAACGCAGATACAA-1	CM
ACTCGGGTCATGTTCT-1	CM
CCAGATAGTAGGGTTG-1	CM
GCCAGCAAGGGCTCTC-1	CM
GCAGATTCAGAAAGAG-1	CM
CGCAATAGTTAGAGAT-1	CM
TGGACATAGACTCGGA-1	CM
AAGGTTCCAAGTCCTA-1	CM
GCGCCAATCGCATAAC-1	CM
TTATGTCAGTAGTGTA-1	CM
CACAGATTCAGGGTTT-1	CM
CTCATGCTCTCCACTG-1	CM
GGTGCTGTCTGAACGT-1	CM
TAGCACAGTTCTTAGG-1	CM
ATGTCGAGTAGGTGAC-1	CM
ACATGGTGTCTGATTG-1	CM
AGTGTACGTGAAACAT-1	CM
CTTGCTGTCCATTGTT-1	CM
ACAATCGGTAGGTGAC-1	CM
TGAGCCGGTGAATCGG-1	CM
TCCAGAACATTTGGCA-1	CM
CCGTAGGCAGGGTAAC-1	CM
AGGCCCAGTTTCGACA-1	Pericyte
GCTCACTAGTACAGTA-1	CM
CTTCTAAAGCTGGAGT-1	CM
GCCCAGAAGCAGGAGG-1	CM
AAACTGCGTAACCCAT-1	CM
TTGCTTACAGGCAAGT-1	CM
GTGTCAAGTAACGGTG-1	CM
CACATGATCGTCAACA-1	CM
AGTTACGAGTAGGTCG-1	CM
TAGCATGAGAAGGGCG-1	CM
TGGTCCTGTGGACTGA-1	CM
CACAACACAGGTGGTA-1	CM
GTTGGTAGTTAACCGT-1	CM
TTGCAGATCGTGCTGG-1	CM
ATTGTCTCACTCGCAG-1	CM
TGCTCACCAATTCGTG-1	CM
CTAGCGGCACTAGCCG-1	CM
GAAACAAGTATCACAC-1	CM
TTCGGTCCAGAACAGC-1	CM
ACTCGGGAGTGCTGAG-1	CM
CTTGCTGAGGTTACAA-1	CM
AAGATAGAGATGAGGA-1	CM
TACGCCTTCCAATCCC-1	Fib
TGGCCTTAGGAGTACC-1	CM
GCTCGAGAGGTTAGTA-1	CM
GTCACTCGTATGTTCG-1	CM
TTTGGTTCAAACCGAG-1	CM
GAAACAACACTGATTG-1	CM
GGCGTTGTCCATAGGT-1	CM
GGGTGTCGTCTGGGCT-1	CM
TACTAGGTCTCTGCAC-1	CM
GGTGAAGCAGATAAGT-1	CM
TCAGGTAAGTGAGCAC-1	CM
GGGTTATAGGTACTCT-1	CM
TTCAACTAGTAACATG-1	CM
CCATACCAGCTCCATA-1	CM
CCGTACTCAGCGTCGT-1	CM
GATGGCCCATAGAATG-1	CM
GATTAGCCAGGTAGCA-1	CM
GCCCAGAAGGCAAGCT-1	CM
CCGTGAGGTACCTATG-1	CM
GTGGATTCATCGCTAA-1	CM
TCCATCGAGTGGGACT-1	CM
GATCATGTCAGCCGGT-1	CM
AGATTCGAGATACCAA-1	CM
ACAGAAAGTGGATTTC-1	CM
AGGCCCAAGCCATGGA-1	CM
CGCTGGATCTTCTTCC-1	CM
ATTGTGGAGTTCAAGA-1	Pericyte
AAAGGGCGTGGAAGCT-1	CM
GCAGCCACAAGGCGTA-1	CM
AACAGTCGTATTCTCT-1	CM
CCAATGAGTCCTTATT-1	CM
GTCACTCAGAGGAACA-1	CM
CTCGCTAGTTAACCAC-1	CM
TGTACGATCCATTGAG-1	CM
GGGTTATCATTTGGTG-1	Myeloid
TGGGTGCCATCAGAAA-1	CM
ATCGAGTCAATGATGA-1	CM
CAATCCCTCCGATGCG-1	CM
GTGCTGGCATTTGGTG-1	CM
GGTGTCGCAAGTAATG-1	CM
TATCTGTGTTAGGAGC-1	CM
GTGATCAAGAACAGGA-1	CM
TCGATTTCATGGATGG-1	CM
CCGTAGGAGCTGAGGT-1	CM
GATCATGTCTGTTGCC-1	CM
AAAGGGCAGAGCGGTT-1	Fib
GATTAGCAGAGGTACC-1	CM
AAGGTTCCATCGGCCA-1	CM
CAGTATGAGGAATGGA-1	CM
GTAGGAGTCCTAAAGC-1	CM
ACCGCAGTCCTCCCAA-1	CM
GCGAGTCTCCATTGAG-1	CM
TACCCTGGTAGGTCTT-1	CM
CGTGGCATCCAGGCCA-1	CM
TACCTATAGTCCGATT-1	CM
ATCCTGCGTATCATGC-1	CM
CCACAGGTCCGGACTG-1	CM
GGGACCTGTCCCGTGA-1	CM
CTACTTAGTACGGTTT-1	CM
TTGCTATTCGTGGAAG-1	CM
ATTACTCTCTGAAAGA-1	CM
GCTGTTCGTGATAAGT-1	CM
CAATCCCGTTGCAGAG-1	CM
AGCCTCTCACGCGCAT-1	CM
ACTAGGTGTTACACTG-1	CM
AAACTGCAGATATGTG-1	CM
TTGCGGGTCTGGAAGG-1	Fib
CAGCTAAGTTCCCTTG-1	CM
TGTAGCAAGAAGCCTG-1	CM
GCGCATGTCAAGAGGC-1	CM
TTCGTTACATAGCAGG-1	CM
TAACGGTTCCTTTGCG-1	CM
CAACGTATCCCGTAGG-1	CM
ATTCGTTGTCTCGGGT-1	CM
GTGTCAATCGCTTACC-1	CM
CTCAGCTCAAATTCCG-1	CM
ATTGTCTGTTTCGACA-1	CM
TTTGGTTGTCTGTGTA-1	CM
GCGAGAATCCGGCGAT-1	CM
GCCCGAAGTACCCATA-1	CM
GGGCCATTCCAGGTAT-1	CM
GCCAGACAGGTTACAA-1	CM
GTGGCGTCACTCGGAC-1	CM
GGAGAACCATGTGAGG-1	CM
AAACTGCCATAGCCAT-1	CM
ACCGGGTCATCGCCTT-1	CM
TACCCTGGTAGTACAA-1	CM
GACTAACAGTCGATAA-1	CM
GCGTTGGAGGTACTCT-1	CM
GCGCCAATCACAGGGA-1	CM
CGCTATCAGAATACTG-1	CM
AATACGCAGAACGTTA-1	CM
TGGCCTTGTCGTCGCA-1	CM
GTTCAAGTCTCCAACC-1	CM
TGCATGAGTCTGCGCA-1	CM
GGGTTATAGGGCATTG-1	CM
GCATTGAGTTCCGGCA-1	CM
TCCATCGGTAGACGCA-1	CM
TAACTTCTCCGGCTGA-1	CM
GGTGCTGGTCCCGTGA-1	CM
ATGTTTCCATGGATGG-1	CM
TACATTCTCGATGCAT-1	CM
ATTGTGGGTAGTAACA-1	CM
TACATTCGTGAATCAA-1	CM
TCAGGGCGTCGTCGCA-1	CM
TGCCTGTTCCAATAGC-1	CM
TAAGCCAGTCAGAGTG-1	CM
GCATTGACAAGTAATG-1	CM
AGCTGTAGTGCTTACA-1	CM
CTAGGATGTCAGCAAG-1	CM
ATTACCTGTCTCAAAC-1	CM
CATGCCTAGAGTTTGA-1	CM
GTGCCAGGTTAGCTCA-1	CM
TCGGGACGTTTCGTTT-1	CM
AGCCGCATCGTCTTAT-1	CM
TGGGTGCGTTTGTAGC-1	CM
GCAACCGCAGGTGTGA-1	CM
TAATTCCTCCGTGCAG-1	CM
GGAATCTGTTAGGCTT-1	CM
GCGCATGGTAACCATC-1	CM
TCTAGTTAGCTGAGGT-1	CM
TTTGAGGCACCTGGTG-1	CM
TGCTTTAGTCAAGACG-1	CM
GTACTTTAGATATGTG-1	CM
TAGCCGGCATCGGCCA-1	CM
CACGTTCCAAGGAGGG-1	CM
CGCAATAAGCGAATAT-1	CM
GGAACCCCAAATTGAG-1	CM
ACTGCAAAGTTGAATG-1	CM
CCCGTTATCGCTAGTA-1	CM
AGCCTGGGTAGACACG-1	CM
CGCACAGCAGCAACAG-1	CM
AGCTGTAGTCAAGACG-1	CM
AATGCCACACCTATTT-1	CM
TAAGCCACACGATATC-1	CM
TGGTCCTGTCAACGGA-1	CM
ACTAGGTTCCGGCTGA-1	CM
GACTAGTCATAGGCGA-1	CM
TGGGTGCAGGATGTAT-1	CM
ACAGCGCCACTAAACC-1	CM
AGGCCCAAGTTGTCCA-1	CM
TTGACGATCTTCACTA-1	CM
ACTGCGGCAAGCGTCC-1	CM
CCCTAGTGTGTTGTTG-1	CM
TAGCCCTGTACGCAAG-1	CM
CCCTAGTTCCCAGCGA-1	CM
GGGTTATCAATGGCAG-1	CM
GGCGTTGAGTGTTCCA-1	CM
GAGGATGGTTTGCGAT-1	Endo
TTGCTTAAGTCCGGAA-1	CM
GGTGTCGGTCAACTAC-1	CM
GCTTAAGGTGAAACAT-1	CM
GCTCACTCATTCTTTG-1	CM
TTGCTTATCATTCGGA-1	CM
ATGTACGCAAGCTTTG-1	CM
GCCTAGGCAGTTACAC-1	CM
ACCATCCGTATTCTTC-1	CM
TGCTTCGTCTGGGCGT-1	CM
GACTAACGTGCACATT-1	CM
TTGCGAAAGGCAGATC-1	CM
TAGCACATCGCGGCAT-1	CM
TTGGTCCTCGTGAACT-1	CM
ACTACGAAGGTGTCGA-1	CM
CAAGAAACATTATGGC-1	CM
AGCGTGCAGGCAATTA-1	CM
CCCTAACCAAGCTTTG-1	CM
GCTCCTACACAGATGG-1	CM
TCAAGACCACTACACA-1	CM
TACGCAACAAGTGGCA-1	CM
TCAAGCACAATTGCCA-1	CM
CCATACCGTTCCGGCA-1	CM
CTGAATGCATTACCTT-1	CM
TTTGAGGAGTACCACT-1	CM
TGATGCACAGGGTAAC-1	CM
TAGCATGAGTCTGGGA-1	CM
ACTGCGGCAAACTACC-1	CM
TAAGCCAGTCTAAGAA-1	CM
TAACTTCGTCCGTCGA-1	CM
CTCAGCTGTCTGTGTA-1	CM
GCGCATGCAACGTAGG-1	CM
GCGCCAAGTGCGCTCA-1	CM
GAAATGAGTCTGGTTA-1	CM
TAATCGGTCGTGATAC-1	CM
GTTGGTACACGTTACA-1	CM
TACGCCTTCCCACTTG-1	CM
TCTCTGGCAAATTCCG-1	CM
TGCATTTAGTCGCCTG-1	CM
CACCACTGTACGCCCA-1	CM
CCCGTTATCTAGTCGA-1	CM
ACTTCCGAGAAATGGG-1	CM
CAGCTAACATGGCCCA-1	CM
CAACCAAGTCCACCAG-1	CM
CAGGGCTCATTAGCCA-1	CM
CTGTATTCAAGCTTTG-1	CM
GGTTGCGAGAGGCGGA-1	Myeloid
GCTCCTACATGCACTA-1	CM
TTCTAACGTGAGTCGA-1	CM
CGAGTTACATACAACC-1	CM
TCCCACATCATACTTC-1	CM
CACAACATCCTTACGC-1	CM
TTGCGAAAGATGGCAC-1	CM
GGTGTCGTCTTCCAGC-1	CM
TTACGTTAGTCTGCTA-1	CM
CTGGGACTCGCAAACT-1	CM
ACAATCGAGCGAGAAA-1	CM
AAACGAACACTCCACT-1	CM
GTAATCGAGACCAATA-1	CM
CACCTGTGTTCTACCC-1	CM
GTCACGGTCATACTTC-1	CM
GCGAGTCCACCCTTAC-1	CM
AACGGGATCATCATGG-1	CM
GCTTAAGAGTTCCAGT-1	CM
TGCTATTAGTCTCCAA-1	CM
TGCTTTATCGAGCGCT-1	CM
GCACGGTGTCTGTTGA-1	CM
GCCATAACATTCTTTG-1	CM
GCAGATTTCGCATACA-1	CM
GCTCAGGGTTTCACCC-1	CM
CTGTATTCATGCACTA-1	CM
GATTGACAGTAGGAAG-1	CM
TTGGTCCGTAACTGAA-1	CM
CACTGAAAGAGAAGCA-1	Fib
CTTCCAGCATAGCCAT-1	CM
TGGCGCATCACCACAA-1	CM
AGTGCGCTCTGAGTCA-1	Myeloid
GTAGGAGTCCATAACG-1	CM
CCCGTTAGTCAATCCA-1	CM
CAGCTAATCCACTAGA-1	CM
TTGTTCAAGGTGTCGA-1	CM
CACGTTCCATGGTTTG-1	CM
TTACTTGGTAGCGAGT-1	CM
GGAGAACGTCGTAGTT-1	CM
TTTGGTTTCTCGTAGA-1	CM
GCCTAGGCAGGATAGC-1	CM
AACTGGTTCGCGCCAA-1	Pericyte
AAAGGATTCAAGGCCC-1	CM
AGGACGACATAGTCCA-1	Myeloid
GAGATTCGTGGAAAGA-1	CM
CCCACATCACCCATCT-1	Endo
GATGGCCAGCCGCTGT-1	CM
CAGTATGTCTCTGAGA-1	CM
CTCAGAATCGGTCAGC-1	CM
GACTAGTCACTGTCAA-1	CM
CGCTATCTCCAAGTCA-1	CM
CACTAAGTCGATCGCG-1	CM
GTTATGGAGAGTAAGG-1	CM
ACCTGCTTCGCTCGGA-1	CM
TAATTCCGTGCGTAGA-1	CM
TTCGATTGTCAGACGA-1	CM
ATCGAGTGTATCTCAG-1	Myeloid
CAGTGTATCGTGGCGT-1	CM
CCTTGCAAGATGCGCA-1	CM
GCGATTACAGGAGCAT-1	Fib
AAAGGGCTCCTGTAGA-1	CM
GTGGCGTAGCGTCTGC-1	CM
TTCTAACGTACTATGC-1	CM
AGACAAACAAGCCAGA-1	CM
GCACCTTCATTTGGCA-1	CM
AGCGTGCTCGCTTACC-1	CM
GCGATCGGTTTGTGAC-1	CM
CTCAGAACAATTGCCA-1	CM
CAAGCTAAGGTGTTGG-1	CM
CTCTCGAGTCCTTCAC-1	CM
ACAAACCTCCCTACCA-1	CM
TAGCACAGTAAGCCTT-1	CM
TACGGATAGTGCTGAG-1	CM
GTCACCTAGAACGTTA-1	CM
TTTACGTTCTCTATCA-1	CM
TGCACCTAGCGTATCT-1	CM
TGGTCCTCAATCCATG-1	CM
GCGAGTCCACGAACGA-1	CM
TGCTCACTCAACGTGT-1	CM
GAGCGCTGTAAAGCTA-1	CM
GCCAGCAGTGGTACTT-1	CM
TCGGGACGTCGAGGAT-1	CM
TTCGCGTAGGTACTCT-1	CM
GTGTGATCACCTACCT-1	CM
CGCAATAAGAGTCCGA-1	CM
GTGCCAGGTATTGTGC-1	CM
ATGTCGAAGACTAGGC-1	CM
TAATCGGGTACAAGCG-1	Fib
TTGAGCATCTTTCGAT-1	Myeloid
TCAAGCACATTACACG-1	CM
GACCCAGGTTACTACG-1	CM
GGTACCGCATGGTAAA-1	CM
GCGGTGTGTCTAAGAA-1	CM
CATGTTTGTTTGGATC-1	CM
ATAGGCTCATTTGGCA-1	CM
TCCCACAAGGATATCA-1	CM
TGTACGAGTCCGTAGC-1	CM
AACTGGTAGGGCTCTC-1	CM
GCGGGTTAGGCGCTTC-1	CM
TGCATGATCCAAGTCA-1	CM
CCTAAAGCAAGCCTTA-1	Fib
ATTGTCTGTCACTCTC-1	Pericyte
TCACAAGCATCCCTTG-1	CM
TTTGGCCCAAACGACG-1	CM
TTTGTGTAGACACGGT-1	CM
ACAAACCCATTCGTCC-1	CM
TACGCCTTCCATCGAA-1	CM
TACTGCCAGGTACACG-1	CM
GCAACCGAGATCGAGC-1	CM
ATGTCGAGTTGAAGCG-1	CM
CTTAATCGTACAAATG-1	CM
GCGATTACATCGACCG-1	CM
ACTCGGGCATTACTCT-1	CM
GCTCGAGGTGGGTAGT-1	Endo
TTACTTGAGGAGTACC-1	CM
CTCTCGATCCCATAGA-1	CM
GGACACCGTGCTGGCT-1	CM
GGCGAAAGTCTTAGCA-1	CM
AGGCGAACAACTTGGT-1	CM
TGCTTTAGTTGGCGAA-1	CM
TGAGCCGGTATGCTAC-1	CM
GAGCGCTGTTGTGAGG-1	CM
GCACGCACATCATCGA-1	Myeloid
CTAGGATTCGTGAACT-1	Fib
AGCCGCAGTGCTTTGA-1	CM
CAGCTAAGTAGATTAG-1	CM
AAACTGCAGGATTGCG-1	Endo
AATGGCTAGAGGTGGG-1	CM
CACCTTGGTACAACGG-1	CM
GCTCGAGTCCTCAAGA-1	CM
TCCGACTTCTGGCCAG-1	CM
TGCACCTGTCCTATTT-1	Myeloid
ACAATCGCAAGGGAGG-1	Fib
GTGTGATTCGGTTCCT-1	CM
GCCAGACTCGTCTTAT-1	CM
GATCATGAGAAATTCG-1	Fib
ATGTACGGTGAATCAA-1	Fib
TCACAAGAGAGCCACA-1	CM
TCAAGACTCCAAGAGG-1	Myeloid
TAACAGCTCGGATCGC-1	Fib
TACTGCCTCATTCATC-1	CM
ACCGCAGTCACTGGTA-1	CM
CTAGCGGGTAAGTCTC-1	CM
CCCGTTAGTGACCAGA-1	CM
TTACGGATCGCCAGAC-1	CM
CTTGTCGCACGCGACT-1	CM
GGGCCATGTTCTACGA-1	CM
CAGCTGGGTGAATCAA-1	Fib
GCACCTTGTAACCCAT-1	CM
CTCCCAATCGATAGCT-1	Fib
GACCAATTCGACTATG-1	CM
ATCGAGTCACACTAGT-1	Lymphoid
ACCGCAGTCTCTGAGA-1	CM
TGCTCGTGTAAACCCT-1	CM
GTGGCGTGTATCGCGC-1	CM
GAAATGATCCTCATTA-1	CM
TTGTTCATCAGGTCTA-1	Pericyte
TACCTCGTCTGTCGGG-1	CM
GCGATCGTCGAACCGC-1	Myeloid
TGTTAGGGTCAGAAAT-1	CM
TCTAGTTGTAGGTCTT-1	CM
AGCTGATCAGGTAGGT-1	Myeloid
TCTCTGGAGAAATTCG-1	Myeloid
GACCGACCAGTAAGAT-1	CM
CCCGTTATCTGTCGGG-1	CM
GCCCAGAAGTAGGTCG-1	CM
CTTCTAACAGAACTTC-1	CM
TCTCAGCAGTCTCTAG-1	CM
AGTGCCGGTTGGCTTA-1	CM
TGACTCCGTACCCACG-1	CM
AACCTGACACCGATCG-1	CM
GCATTGAAGGTGTCGA-1	CM
ACATGCAGTGGACAGT-1	CM
TGATGCAAGAGGCGGA-1	CM
AGCTGATCAACGCAAG-1	CM
GTGTGATAGTGAGTGC-1	CM
TACGCCTCAATAGCGG-1	Myeloid
GGCACGTTCCAGGGAA-1	vSMCs
TTGCAGACACACACCG-1	CM
GACTAGTCAGTCAGAG-1	CM
ACCGCAGGTCAACTAC-1	CM
TGACTCCAGCTCCGGT-1	Pericyte
TCGCAGGGTAGGTGAC-1	Fib
CGCACAGCAGCCACGT-1	vSMCs
CGCTATCCACGATATC-1	CM
CCACAGGAGAAGCCGT-1	Myeloid
TTGCTTATCCCTACCA-1	CM
AATACGCAGGCCAATG-1	Fib
GGAGTAGCAACGACAG-1	CM
GGTGCTGTCACCACAA-1	Myeloid
TTACCCGAGGCGCTTC-1	Fib
AACCTTTAGGTGTTGG-1	CM
TTGCTTAGTAGGTAAT-1	CM
TTCTAACCACAGTTCA-1	Fib
CAATCCCGTCATAAGA-1	CM
GCGTTGGCAGTGCTCG-1	CM
AAAGATGAGATTCCGT-1	Fib
CTCTCGACATCGCTAA-1	CM
ACTCGGGGTAAACGTA-1	CM
ATTGTGGGTACAAGCG-1	Fib
ATGTACGGTGTCCCAG-1	Myeloid
TTACTCAAGCTACGTT-1	Myeloid
CTCAACCTCTATCCTA-1	CM
TTACGTTAGCGTAGCA-1	CM
TTGAGTGCAGGTGTCC-1	CM
ATGTTTCGTGCGACCT-1	CM
CAGCTGGAGTAGTTCC-1	CM
TCAGCTCTCCATCTAT-1	Myeloid
GACCTTCTCAGGCCGT-1	CM
CTTGAAGGTACAAATG-1	Myeloid
GCACCTTCAGGCATTT-1	CM
ACATGGTGTCAATACC-1	CM
TTGTCTATCCATAGGT-1	CM
GTGCTGGGTGTCGTGC-1	CM
TTGTTCACATCCCTTG-1	CM
ATGTTTCTCCCACGGA-1	CM
TGACAACAGGAAGAAC-1	Endo
AGCCCGATCGCAACTA-1	Myeloid
CACATGAGTAGTGATA-1	Fib
ACAGCGCGTTGCTTGA-1	CM
TGCCTGTGTCACATTG-1	Myeloid
GTCACTCCATACAACC-1	Pericyte
TTAGGTGTCAGTGTGT-1	Pericyte
CAACGGCAGGCAAGCT-1	Myeloid
AATGGCTAGCGAATAT-1	CM
TGTGACACATTTCACT-1	CM
CCCAGAGGTCAGCTTA-1	Pericyte
TTCAACTCACAAGTGG-1	CM
TCAATTCAGAGAGGTA-1	Endo
CAAGCTACAAGATGCG-1	Lymphoid
ACAGCGCTCCCAGTAA-1	Endo
GAACGTTAGTATAGTG-1	Fib
CTCTAGCAGTGCTCGC-1	CM
TCAAAGCTCTTAAGCG-1	Fib
CTCTCAGCAAACAGTA-1	Endo
TGTTAGGAGATGAGGA-1	Endo
GCCATAACACAAGTGG-1	Myeloid
AACAGTCAGCCCATGC-1	Pericyte
TAATCGGTCTCGCGGA-1	CM
AAAGGATTCCCTACGT-1	Fib
AATGCCATCGAGAACG-1	Fib
CTCGCTATCCGTACGG-1	Lymphoid
ACCCAAATCGTCCCTA-1	Fib
GAGGTCCGTCACAGGA-1	Endo
GATTGACAGAGGTGGG-1	CM
CGCTGGACAGTTACAC-1	Pericyte
GCGTTGGGTCATGAGG-1	Myeloid
TGGTCCTGTATACGCT-1	Myeloid
GTGCTGGTCTTCCAGC-1	CM
ACTGCAAGTCGCTACG-1	Myeloid
GCGAGTCTCCCGATTC-1	Fib
ACTACCCGTCAGAAAT-1	Pericyte
TGGCAATCACCACCAG-1	Myeloid
GATGATCAGCAGAAAG-1	Myeloid
AGCCTGGGTGCATTCA-1	Fib
CGCGCAACATGATTGC-1	Endo
CCCTAACGTACCCACG-1	Endo
AAGATAGTCCAGAGAG-1	Endo
GGTACCGCAAAGAAGG-1	Fib
ACATGCACAACCTCTC-1	CM
CTAGGATCATGATCGT-1	Pericyte
GATTGACAGAGAATTC-1	CM
TTTGGCCCAGAATGCG-1	Fib
ACGTTAGAGTGAGTTA-1	Myeloid
CTCTACGTCTCTATCA-1	Pericyte
GAAATGATCACATCCC-1	CM
AACTTGGAGGCAGTAC-1	Fib
TGGACATAGGCTTTAC-1	vSMCs
ACTACCCGTTAACCGT-1	Endo
GTGGATTAGACGCCAA-1	Endo
GACTAACGTCAACGGA-1	CM
TAAGTGCAGAACGTCG-1	Myeloid
GTCACAATCTGTAGAC-1	CM
CACCTGTCATCCATAG-1	Pericyte
CAACCAAGTAGATTAG-1	Fib
CTAGCGGCATGCCCTT-1	Myeloid
CTGTTCGGTAATGTGA-1	CM
TGCTATTTCGACCCGA-1	CM
GAGACTTAGAAATGGG-1	Myeloid
GTCGTAAGTCCCTAAA-1	Pericyte
ACCATCCGTGGTCGAA-1	Myeloid
GCAAAGGCATGGAGGT-1	Myeloid
CCCGTTAAGCAATAAC-1	vSMCs
CCGTGAGGTAGCGGTA-1	Pericyte
AAGGTTCTCTTACGGA-1	Pericyte
CATTGGAGTATCAGCT-1	Lymphoid
CTACTTAAGTCACACT-1	Fib
AGATAGAGTCTTAGCA-1	Fib
GACCTTCGTGATAACA-1	Fib
CGGACCAAGACTAGGC-1	CM
CTTCTAACATTCTCGC-1	Endo
CCTTGGTGTCTAACCA-1	Fib
TCAGTCCCAGTATCTG-1	CM
CAAAGCTGTATTGTGC-1	CM
TTTACGTCAGTAACTC-1	CM
ACAAACCAGACTCTTG-1	Fib
TTCATCAAGGACTAGC-1	Fib
GCATGATTCTTGTACT-1	Fib
CCTGGGACAGTAGGCA-1	Fib
TCAGGGCGTATCAGCT-1	Pericyte
CTTAATCAGAACGCCA-1	Neuronal
ACAAAGACATTGCACA-1	Fib
AAACTCGCAAGACACG-1	Endo
CTCTCGAAGAGCGAAA-1	CM
TCTCAGCCAGTAGTTC-1	Pericyte
AGCCCGACAGTAGTTC-1	CM
TGTACGAGTTGGAGGT-1	Pericyte
CAGGATTAGCATTGGG-1	Fib
GCTCAGGAGGCAGATC-1	CM
ATGTCGAGTATTGTGC-1	Fib
AACCAACGTCCGGTAC-1	Pericyte
GACCAATCATAAAGTG-1	Endo
AGCTGGCTCTTCACTA-1	Pericyte
AAAGGATCACAAGTGG-1	Fib
GGACACCAGGTTCTCA-1	Endo
ACAAAGAAGCAGAATT-1	Endo
GTTCAAGGTCCTATTT-1	CM
ACATGCATCCATAGGT-1	Myeloid
GATGGCCGTGCTTACA-1	Pericyte
ACCGGGTTCGTCAACA-1	Myeloid
GCTCCTAGTATTCACG-1	Pericyte
AGCGTATTCGCACCTT-1	Myeloid
AGTTTGGCAACGACAG-1	CM
ACTAACGGTCAACTAC-1	Endo
GCGAGAACAAGACTTC-1	Neuronal
TAAGTGCAGATATGTG-1	Endo
GTTACTTGTAGACACG-1	Endo
GAATCTGCAGATTAAG-1	Myeloid
GCTCACTCATCCGTAA-1	Myeloid
CAAAGCTGTGGAAGCT-1	Pericyte
AACGAGGAGTTGCGCC-1	Myeloid
GCGGAAATCCACGAGC-1	Lymphoid
TAGCTTTAGGGTTCCC-1	Myeloid
CCGTACTTCCCTATTA-1	Fib
TTAGGTGGTATGTCCA-1	Endo
TTCGATTGTGCATCAT-1	Fib
AGCGTATTCTAGCTGA-1	Fib
TTGCGAATCCCAGCAG-1	Endo
GTCACTCTCGCTATTT-1	Myeloid
GATGATCCATAGCCGC-1	CM
AACCTTTAGTAACATG-1	Fib
CCTAAAGTCCTATCAT-1	CM
TTCATCAAGGCCTCTG-1	Pericyte
CATTCCGTCGCAGATT-1	Endo
AAACTGCAGTGATAAC-1	Fib
TAGCATGAGAAATCTG-1	Endo
GCATTCCTCCACACCT-1	Pericyte
ACTTCCGTCAATCGTG-1	Pericyte
TGGACATTCTGTGTGA-1	Endo
ACTCGGGAGAGGTCCA-1	Myeloid
TTACGGATCACGTCAA-1	Myeloid
TACATTCTCGTCTAGA-1	Fib
AACAGTCGTGCGTCCA-1	Lymphoid
ACAATCGAGAGCAGCT-1	CM
CACATGACACCACGAC-1	Pericyte
AGTGTACAGCTAGTTC-1	Fib
AACGTACAGATGAGGA-1	Pericyte
GACTAGTGTCAACAGG-1	Myeloid
ATTTGTCCATTCTCGC-1	CM
ATCCTCGAGATGCGCA-1	Fib
TTTGTGTGTAGGGTCA-1	Pericyte
CAAGCTAGTGGTTCTA-1	Pericyte
TTCGCGTAGTAGACCG-1	Endo
TCAGTTTTCGATATGC-1	Endo
GAGGATGAGTAGGAAG-1	Endo
ACAGACTTCGCTATAG-1	Pericyte
TAGGAGGCATCCCTTG-1	Endo
TTATGTCTCATGAACC-1	Endo
CGCTGGACAAGGTCGA-1	Pericyte
TGAATCGTCTGTGTGA-1	Myeloid
TGGACATGTATCCTTT-1	Endo
TACGCCTCACGCCGAT-1	CM
AGGCCTGCATTCACGA-1	Lymphoid
GGTGAAGCAGGTGTGA-1	Endo
CCCTGATCATCTGCAA-1	CM
AAGGAGCGTGCGTCCA-1	Endo
CCACAGGTCAGTCACA-1	Myeloid
ATAGTCGGTGGTCGAA-1	vSMCs
CAAGAAACACTTATGG-1	Fib
GAGGATGAGTATAGTG-1	Endo
TGTTAGGTCGTCGCAG-1	Fib
AACCTGATCAAACCAC-1	Endo
ACATGGTGTGCACATT-1	Lymphoid
GCATGATTCAATGCAC-1	Fib
GACTAGTTCGCGTGAC-1	Fib
ACCGCAGAGCGCAATG-1	Fib
CGTAAACGTTGCTTGA-1	Endo
CCGTGAGGTCCCTTTG-1	Pericyte
TCAAGCATCCCAGTAA-1	Pericyte
AAACTGCTCAAACCAC-1	Endo
GGAGTAGTCAGTTGAC-1	Pericyte
GGGAACACAGATACAA-1	CM
AGCGTGCCACCGATCG-1	Pericyte
TAAGTGCTCACCGCGA-1	Fib
TGGACATAGGATGCCA-1	Pericyte
ACTGTCCTCAGTGGTT-1	vSMCs
GAGTGAGGTGTTGGTT-1	Pericyte
TGCCTCAAGAGCACTG-1	Neuronal
ACAGAAACAAACCTAC-1	Endo
CCGCATTCAAGTAACA-1	Endo
GACCAATCACCTGGTG-1	Fib
CTTCTAATCATTCTTG-1	Endo
CTGCGTTTCAGGAAGC-1	Endo
GGGACCTAGTCGCCTG-1	Lymphoid
CCTAAAGTCACGTGTA-1	Pericyte
TAAACCGAGGCAAGCT-1	CM
GCAGATTCACCCTTTG-1	Pericyte
CTGCTCATCTGGCCAG-1	Pericyte
TTCATCACATCGCCTT-1	CM
GTGGATTCAACTCAAC-1	Fib
GTGCTGGGTTCCATCC-1	CM
TCAGCTCCATCCCAAA-1	Pericyte
CTCAACCGTGTTAGAA-1	Pericyte
TGCCTCATCGCGCTGA-1	Endo
GCAAAGGGTGCAGACA-1	CM
GCGAGTCTCGTGGCGT-1	CM
ATGTTTCTCGCTGATA-1	Myeloid
CCACGTTTCGCTAGTA-1	Fib
CAATCCCGTAACCATC-1	CM
TTGTTCAAGGGTATCG-1	Endo
TATGTGGCAAAGGAAG-1	Pericyte
CAACGTAGTTACCACA-1	Endo
AAACTGCGTTCAGTAC-1	Myeloid
TTAGCTTAGGATATCA-1	Myeloid
CCATACCAGCCATGGA-1	Fib
TCTATTGCATTGTGAC-1	Pericyte
ATGTCGAAGATGGCAC-1	Neuronal
ACCGCAGCACCTCGTT-1	Endo
TCGCAGGGTGACAAGC-1	Myeloid
CCAGAATAGGTACACG-1	Myeloid
CCTAAAGGTCTGTCCT-1	Pericyte
GATCATGCACGTTGTA-1	Pericyte
AACAAAGAGCACGTAG-1	Endo
TCGTTCGTCATGTTCT-1	Endo
CGCGCAAAGACCATAA-1	Myeloid
AGCTGTATCCTAAAGC-1	Endo
CCTTGCAGTCTTAGCA-1	Fib
CTCAGCTTCGACGGAA-1	Endo
GTTGGGCCAACGTAGG-1	Lymphoid
ACCGCAGCACAAGTGG-1	CM
AGGACGATCGGTACTA-1	Endo
TGTAGCAGTTTGGATC-1	CM
CGGACTGGTTCCAATG-1	Endo
TTCTGTAGTACGGTTT-1	vSMCs
CCGTAGGTCCATAGGT-1	Pericyte
TCTCAGCTCCAGAGAG-1	Endo
CCGTGAGAGGGTCCCT-1	Endo
TGCTATTTCCAGCACG-1	Pericyte
ACCAAACTCGATAGGG-1	Endo
CCCACATCAAGTCCTA-1	Endo
CGCAATAGTGGTACTT-1	Pericyte
CTCCCAATCTATCCTA-1	Endo
AGCGTGCTCCAGCACG-1	Pericyte
GAACCTATCTGTTGCC-1	CM
TACATGGTCCAACCTC-1	Myeloid
CAGCCTTAGATGTTGA-1	Fib
TTGTCTAAGTACGCGA-1	Myeloid
TTGCAGAAGATTGACA-1	Endo
ATGGATCTCGATCGCG-1	Fib
CCTGGGACAATTAGGA-1	Pericyte
CTCATGCGTTACTTTC-1	Pericyte
ACGGATTAGGAAACTT-1	Fib
AGTTACGCAGTAACTC-1	CM
TTCATCAGTGTCTACA-1	Fib
ATTACCTTCCTAAGTG-1	Neuronal
GAACTTGGTATTCTTC-1	Pericyte
CACCTTGGTCCCTAAA-1	Pericyte
GCGTAGCCAGGTCCTG-1	Pericyte
GCAAAGGGTATTCGCA-1	Fib
CTGTATTGTAGAACGC-1	Fib
TTACGGAGTACCGGCT-1	CM
CTGTATTGTTGGCTTA-1	Myeloid
GTCACTCTCGTTGTAG-1	Pericyte
CATGTTTGTGATGTGG-1	Fib
TTTGCGCAGTGTCGCC-1	Myeloid
GGTGCTGCATTAAGGA-1	vSMCs
CAACCAATCTTTATCG-1	Myeloid
TGGCGCAAGAGCCTGA-1	Pericyte
TTTGAGGTCTGCGTCT-1	Fib
CTGTTCGTCGTGGCGT-1	Myeloid
AGTGCGCAGCGTATCT-1	Endo
AGGACGATCCTTGACC-1	CM
TTACCGCAGACTTGAA-1	Fib
ACCAAACGTGTAGGAC-1	Endo
GATTGACGTTAACCAC-1	Pericyte
GACTAGTTCTCTGCGT-1	Endo
CCGTAGGGTACGAGAC-1	Pericyte
ATAGTCGTCGTCGCAG-1	Endo
CTGCGTTAGGCCAATG-1	Pericyte
ATAGTCGGTCATAGAA-1	Pericyte
GCCAGCAGTGGTCGAA-1	Neuronal
AGGCGTCTCTTGGCCT-1	Endo
TAACTTCGTGAGCTAG-1	Myeloid
TACCTATTCTCTATCA-1	Endo
TATGTGGGTTTGCCAA-1	Pericyte
ATTACCTCAATAGTGA-1	Fib
CATTCCGCATCAACTG-1	Endo
AACTTGGAGGAATGGA-1	Pericyte
GTCGTAATCTCTTCTC-1	Myeloid
CTTGCTGGTATTTGCG-1	Fib
CCTTGGTAGATATGAC-1	Endo
GACCTTCAGGCGACTA-1	Pericyte
CGGACCACAATTCAGC-1	Lymphoid
CTAGCGGCATCATCGA-1	Endo
AGCCTCTTCCTGAAAC-1	Lymphoid
AAATGAGAGGTGAACC-1	Endo
ACTTCCGAGTCACACT-1	Endo
GACCTTCAGGGACGTT-1	Endo
GAGAACGTCACATTCT-1	Endo
TTACCGCCACGCTCAG-1	CM
TTCAACTGTATTCTCT-1	Endo
ACCCAAAGTTCTACCC-1	Myeloid
TTCATTGTCATTCTTG-1	Endo
CGTTCCATCCCTACGT-1	Endo
TGCTCACTCCAACCTC-1	Pericyte
TCACAAGTCAGCCGGT-1	vSMCs
TCGCCTAGTGCGTTTA-1	Pericyte
GAAGAGCGTCAGGCTC-1	Endo
TGCTCACAGCGTAGCA-1	Pericyte
GACTAACCAGTGCTCG-1	Endo
CCATACCGTATTGTCG-1	Fib
TAGTCCCTCATTCTTG-1	Endo
ACCGGGTAGAATCAAC-1	Endo
GCTGCGACACCTGAAT-1	CM
TTGCTATTCGGACGAA-1	Myeloid
TTTGCGCGTCTGCGCA-1	Myeloid
GTAGGAGAGTCTCTAG-1	Endo
AGCGATTGTGCATCAT-1	Neuronal
CGGACCAGTACGCCCA-1	Endo
CCTGGGAGTAGTCCAT-1	Endo
CAGTGTACACAGTTCA-1	CM
GTTATGGCAGCAAACG-1	Myeloid
GACCAATCATAGAATG-1	CM
CAGTATGAGAGATTAC-1	Endo
GTGGATTCACCGATCG-1	Endo
TACGCCTCAAGCAATA-1	Pericyte
TACTAGGAGGTGTCGA-1	Endo
CTGTATTAGGGCTCTC-1	Fib
AAAGATGCAAGGACCA-1	Fib
GTTGGTAGTAGTGATA-1	CM
CACAGATAGTCCAGAG-1	Pericyte
AGTCCGGGTCTGATTG-1	Endo
AGGACGAAGGTCACTT-1	Pericyte
TTGCGAACAAACGTTC-1	Pericyte
ACTGTCCGTGGACAGT-1	Pericyte
ACTAGGTGTTCTTTCA-1	Pericyte
CTACAGAGTCACTCTC-1	Endo
GGAGGATCAACGTCGC-1	Pericyte
CCGTACTGTCTCAAAC-1	Fib
ACGGATTTCCCGTATC-1	Myeloid
AATGGCTTCGGACGAA-1	CM
GTTGGGCGTCAGGCTC-1	Endo
TCACAGAGTTAAGTCC-1	CM
CTGCTCACAACCTCCT-1	Endo
CAACGGCGTACCCACG-1	Endo
CCGTACTAGTAGAAGG-1	Pericyte
TGGCGCAAGGTGTTGG-1	Endo
GGTGCTGCAAGGAGGG-1	Endo
TGGTCAACATTTAGGC-1	Pericyte
AGTTACGAGCCTGTAT-1	Endo
TTGCGGGCACGCGCAT-1	Fib
GCGAGAACAAGCAACG-1	Endo
ATGTCTTTCATACTTC-1	Pericyte
TCAGCTCCAGTTAAAG-1	Lymphoid
ACAAGCTGTCAATCCA-1	Pericyte
TCAGTTTTCTGCCGAG-1	CM
AGCCCGACAGCCGAAA-1	CM
CAGCCTTAGACCTATC-1	Endo
TGAGCCGTCTACTGCC-1	Endo
GTAGGAGAGCTTTCCC-1	Endo
TACCTATAGGATTTGA-1	Pericyte
TGATGCACAGACCTGC-1	Pericyte
GTCACCTGTCAGTGCC-1	Myeloid
TACTAGGGTATGCTAC-1	Pericyte
GGTACCGGTCGCGCTA-1	Endo
AAAGGGCCACTGTCAA-1	Pericyte
TTGTCTATCTGCGTCT-1	Pericyte
ACTACGAAGGGTATCG-1	Endo
ACTAGGTTCAGCCGGT-1	CM
GGAACCCCAGTTGGAG-1	Pericyte
GAGAACGCAGTGCGAA-1	Endo
CGCAGGTTCAAGGCAG-1	Lymphoid
CAGCTGGAGACTAATG-1	Myeloid
GGGTCTGGTATTCTTC-1	Pericyte
CTTGCCACAAACGACG-1	CM
CAGGGCTTCAAACCCA-1	Endo
CAGTATGCAACTACTG-1	Endo
AGCTGTAGTCTGGGCT-1	Pericyte
CTCATGCAGTGAATAC-1	Fib
CAGTATGAGGTTACAA-1	Lymphoid
TTGTTGTTCCTCATTA-1	Endo
TTGCACCAGCCATTCA-1	Pericyte
TAACTTCAGCGTCTGC-1	Pericyte
CGATGATAGAACGCCA-1	Myeloid
TGGGTGCAGCGCACAA-1	Endo
AATGGAATCCGCTATC-1	Pericyte
TCCCACATCTTGTGCC-1	Endo
CCGTGAGTCTTGTGCC-1	Endo
GTTATTCAGCCTATAC-1	Pericyte
ACTACGAAGAGCACTG-1	Endo
GACTAGTGTGCAAAGC-1	Endo
GCAACCGAGAACGTTA-1	Myeloid
TACATGGCAGGCTACC-1	CM
TTGGTCCCAAGGAACC-1	Endo
TCTAGTTGTAGTACAA-1	Pericyte
TGGACATCAAAGAAGG-1	Lymphoid
TGAGCCGAGTCCGGAA-1	CM
GGAACCCGTGAGGGTT-1	Pericyte
TGCTTCGTCACTTACT-1	CM
TTGTTCACAGACCTGC-1	Fib
CAACGTAAGTTGCCGC-1	Pericyte
GTTACTTCACGATTAC-1	Pericyte
CTCAACCCAGCCGAAA-1	CM
TCCGACTAGCATGTGG-1	Endo
GCGTAGCAGAGTGGTC-1	CM
TTACTTGAGCGATACG-1	Myeloid
GCTGCGAAGGTGTTGG-1	Pericyte
GGATGAGAGTTGTCCA-1	Endo
GGAGAACCATAGCCGC-1	Endo
ACATGGTGTATCACAC-1	Endo
AACGAGGTCGCCGAAC-1	Endo
CTCCCAACACAGGAAC-1	Pericyte
GAACTTGGTGATTCCA-1	Endo
TACTAGGTCGATCGCG-1	Pericyte
GAAACAATCGACGGAA-1	Pericyte
CTCTAGCTCTATGAGC-1	CM
GACCCAGCATGCGACC-1	Fib
TCAAGGTCAGATTGTC-1	CM
GACTAGTGTATCATGC-1	Pericyte
CGCACAGCACCCTTTG-1	Endo
GAACCGCAGTCGTATC-1	Pericyte
TTAGCGACACTCCACT-1	Pericyte
GAAGAGCTCTCGCGGA-1	Myeloid
AGCTGATAGAATAGTC-1	CM
CAGTGCGAGCGAATAT-1	Endo
TTGACGATCTACATCT-1	Pericyte
CTCTAGCCAAAGAGAG-1	Endo
CGCACAGAGATTGACA-1	Fib
CTGCGTTAGCAAGGTC-1	CM
AGATAGACACGGTGTC-1	CM
GCTGCGAGTGGACGAT-1	Pericyte
GAGGCTCTCAAGAGGC-1	Fib
TGACTCCTCAGCCGAC-1	Myeloid
CCTATTAGTGTCTCGG-1	Pericyte
GTCTACCAGTCGCGTC-1	CM
TAGGTGTGTGATGTGG-1	Pericyte
GACCTTCTCCCGAAGC-1	Endo
TCAGGGCAGCCGCAAA-1	CM
TCAAAGCAGATCGATA-1	Endo
CCAGAATGTTCCAGTA-1	Pericyte
TAGCACAGTTTGATCG-1	Pericyte
GGGTGTCAGGAGTACC-1	Endo
GAGGCTCGTGTCGGTC-1	CM
GGATAGGAGCCATTCA-1	Fib
TGAGCCGAGACTAATG-1	CM
TACTGCCCATCGACGC-1	Endo
GAAACAAGTACATGGG-1	Endo
AACGAGGTCTCTGTTA-1	Pericyte
CATAACGTCGATATGC-1	Fib
TACCCTGAGTGTCGCC-1	Endo
TGCCTCATCGCTATTT-1	Fib
GCGATTAAGTCTCTAG-1	Fib
TGAATCGGTAGGTCTT-1	Fib
TACTCGCCAGCCGAAA-1	Endo
AGTTACGTCTGGAAGG-1	Fib
AGGCGAACAGATTGTC-1	Myeloid
TCAGGTATCGATTACG-1	Fib
TACCCTGTCCACCTAC-1	Fib
GCCCGAATCGCATAAC-1	Endo
GGGTTATAGTTACCAC-1	Fib
TAAGCCATCGAGAACG-1	Fib
TCAGGTACACCTTGTC-1	Pericyte
GTACTTTTCCAATCCC-1	Fib
ATAGTCGAGTCTTAGC-1	Fib
GGAGGATTCTTGTACT-1	Fib
CACTAAGCAAACTACC-1	Fib
TTGTTGTGTGGGTAGT-1	Fib
CCCACATGTACGCCCA-1	Fib
CTTCTAAAGTTACACC-1	Fib
TAACGGTGTTAGTAGA-1	Fib
GGACACCAGTGTGTAA-1	Fib
