Barcode	cell_type
CACGTTCCAAGATGCG-1	CM
GTCACAAAGGACTAGC-1	CM
AGGCCTGAGCGTATCT-1	CM
CAACGTAAGACGTCAG-1	CM
ATTACCTAGGATGTAT-1	CM
CGCTAGGGTACCAAGG-1	CM
TTATGTCAGTAACTCC-1	CM
TTCTAACAGAATCAAC-1	CM
AGATTCGAGATATGTG-1	CM
GAGCGCTTCCTAGAGT-1	CM
AACCAACTCGGTGATT-1	Myeloid
ACCGGGTAGTACGACG-1	CM
TCTAGTTTCTCGGCGA-1	CM
TGATGCATCCATAACG-1	CM
CGGTGCAGTTCTCGAA-1	CM
TGCGTAATCGGGTCCA-1	CM
CACCTGTAGTGATAAC-1	Myeloid
TATCGAGAGCACCATT-1	CM
GCCTAGGAGACTTGAA-1	CM
TCAGTCCAGAACGTCG-1	CM
GGCATTACATCGAGTT-1	CM
GCCATAAAGGATATCA-1	CM
CCCTGATAGTTCAACC-1	CM
CAGTATGCACGGTTAT-1	CM
TAACAGCTCCAGGTCG-1	CM
ACAGCGCCATACAACC-1	CM
TGTACGAAGATCTAAG-1	CM
GCCTACTCATTCTTTG-1	CM
CGCAGGTTCAGAATGA-1	CM
CAAGCTATCCATGTTT-1	CM
AACTGGTCATACCCGG-1	CM
CATGCCTGTTTGCATG-1	CM
TTACGTTGTCATAGCT-1	CM
AGCCGCATCTATGAGC-1	CM
GATCATGCATTTGGTG-1	CM
CAGCTAAAGGACCGAT-1	CM
AGGCGAACATGGTAAA-1	CM
CGAGTTAGTGCTAGTT-1	CM
CACGTTCTCCAAGAGG-1	CM
AGATTCGAGGTTACAA-1	CM
GCGATTAAGGTAGGCT-1	CM
ACAGAAATCTCCTTGG-1	CM
GCCTACTGTGGTTCTA-1	CM
CAAGGCCAGCATTGGG-1	CM
CTCACCAGTCGACTGC-1	CM
TAGCGGCCAGCAGGTA-1	CM
ACAAAGAAGATGGGAA-1	CM
AGTCCGGGTACGGTTT-1	CM
GTGGATTTCCAGTTAG-1	CM
CTCTCAGAGTGAACCG-1	CM
TCACCTGGTCCATTGA-1	CM
TGGTCCTGTTGTGACT-1	CM
CGCTGGATCCGTTTCG-1	CM
TTGTTGTAGTATAGTG-1	CM
GGTCATATCGATTACG-1	CM
TTAGCGATCGTGTGCG-1	Endo
TTGCAGATCTGACATG-1	CM
CTGTATTGTTACGCTA-1	CM
CCCTAACCAGCCACGT-1	CM
AGTGTACAGGCTTAAA-1	CM
TGCTCGTGTGTTAGAA-1	CM
CGCGCAACAACACGGA-1	Fib
GCTCCTAGTTCCCGGA-1	CM
GTCACGGTCAGAATGA-1	CM
GGTACCGAGAAGGGCG-1	CM
CTGCGTTAGCGTGTTT-1	CM
TGTAGCACACGTACAT-1	CM
GGGTCTGAGCACCATT-1	CM
TTTGAGGCAGCGTGAA-1	CM
GCCAGACTCAAGTTGC-1	CM
GCAGATTCACAGATGG-1	CM
GGGCCATTCGAGTTAC-1	CM
ATTTGTCGTAATGTAG-1	CM
GGATAGGAGTGAATAC-1	CM
ACTAACGGTAGAAAGG-1	CM
TGGTCCTGTAACCCAT-1	CM
GCTGAGCAGTTACCAC-1	CM
TGCTCACAGAGGAAGT-1	CM
GCTTAAGTCGCGGCAT-1	CM
TATGTTCGTCAATCCA-1	CM
AGTCAACAGTGGACGT-1	CM
AGCCAGCTCAGTACAC-1	CM
GTAATCGGTGAGTAAT-1	CM
ACTACCCTCTCCCTTT-1	CM
TAGGAGGAGTTGTCCA-1	CM
ACTACGAGTTAACCAC-1	CM
TAGGTGTAGTGTAATG-1	CM
CATAACGAGCCGCAAA-1	CM
GGCACGTGTACTATGC-1	CM
CTTCTAAAGTTCCAGT-1	CM
GCCTAGGCATGGGACA-1	CM
AAGGAGCGTGCTTCCT-1	CM
AGCTGGCAGTGCCCTG-1	CM
ACGTGGCAGGAAGAAC-1	CM
TAGCCCTCAGCAATGG-1	CM
AAACTCGGTGCAAGAC-1	CM
TAGGTGTCAGGCAAGT-1	CM
GTCGTAAAGGCTGGAT-1	CM
AGGCCCAAGGATGTAT-1	CM
TAATTCCAGGTTTCTG-1	CM
CAGTGCGTCAAATGGA-1	CM
GTTGGTAAGAGCGGTT-1	CM
GTGTGATAGCATACCT-1	CM
ACATGCACAGGTGTCC-1	CM
CATGTTTAGGATTGAT-1	CM
TCCAGAATCTCTGCGT-1	CM
ATCCCTGAGGTAGGAA-1	CM
ATAGGCTGTCACATTG-1	CM
CGCTATCTCCTGTGGG-1	CM
CGCACAGAGGATATCA-1	vSMCs
TCAAGACTCCAGGCCA-1	CM
TAGGTGTAGGGAAATG-1	CM
TTGAGCAGTGCTTCCT-1	CM
GCCCAGAAGCGTAGCA-1	CM
GGCGAAACACTGTTAG-1	CM
CTGCTCACACCTATTT-1	CM
GCGGGTTTCGAAGCCC-1	CM
CGGACCAAGGTCGGTA-1	CM
GCGATCGAGCTAACAA-1	CM
ACTGCAAGTTGAATAG-1	CM
TAAGTGCCAAGTGGCA-1	CM
ATCCTGCCACTCCACT-1	CM
GAGGATGTCGTCCCTA-1	Fib
AACGAGGCACGATATC-1	CM
AGTCCGGCAGCGTACC-1	CM
AATGGCTGTAGCGGTA-1	CM
TGGTCAACATTCACCC-1	CM
TTGCACCAGAGCCTGA-1	Pericyte
AGTCCGGTCAGTCAAC-1	Fib
CGTTCCAAGTACCTCA-1	CM
GCGATCGTCCAGCACG-1	CM
TACTCGCTCAGGAATA-1	CM
GCACGGTTCGGTCCGA-1	CM
CCCACATCAGCGTACC-1	CM
ACTGTCCTCCAAGTCA-1	CM
GTCACCTTCAGCACGC-1	CM
GAATCTGGTCAATCCA-1	CM
GAATCTGTCCTCCTGA-1	CM
GAGCGCTTCACGTCAA-1	CM
AACTGGTGTTCCCGGA-1	CM
TCTCAGCAGCATTGGG-1	CM
CAATCCCGTATCGCGC-1	CM
TCTCTGGGTTCATTTC-1	CM
GTGTCAAGTTGCAGAG-1	CM
TGGAAGGGTATCCTTT-1	CM
GTTGGGCTCCGGGCAT-1	CM
TTACCGCAGTTCTCCC-1	CM
CCGTAGGTCGGAGTTT-1	CM
TACCCTGTCGGTTGTA-1	CM
TCCAGAACACATAAAG-1	CM
TCAGGTAGTTTCTTAC-1	CM
AACAAAGCAGGTTATC-1	CM
GTGGCGTAGGCGACTA-1	CM
CATTCATTCTGATCTT-1	CM
CGCTAGGAGCCTCGCA-1	CM
CTCGCTAAGGGTCTGA-1	CM
GACTAGTCATCCTGGG-1	CM
TGCCTGTCACGTACAT-1	CM
AGCTGTAGTCAAGACG-1	Fib
TCGCCTAAGTGATCTC-1	CM
GGGACCTCACATCATG-1	CM
ACTACGATCGTGCTGG-1	CM
AGGCCCATCTTGCGCT-1	CM
CTGCTCAGTGAATGGC-1	CM
CTCTAGCCATGGGAAC-1	CM
ATTCGTTAGGTCCTCG-1	CM
AATACGCCACAAGGGT-1	CM
GGTGCTGGTCTGGATT-1	CM
CGTGGCACAACTCGTA-1	CM
GTACTTTGTCTGATTG-1	CM
TGTTAGGTCGGACGAA-1	CM
AGCTGATGTGAGTAAT-1	CM
TGATCAGTCAGGATCT-1	CM
GCTCAGGCAATGGCTT-1	CM
GGACACCCAGTAACTC-1	CM
ACTACCCCAACGCAAG-1	CM
CGCTGGATCGTGAGTT-1	CM
GGGTCTGCAACTTGGT-1	CM
TATGTGGAGAAAGGGT-1	CM
TAATTCCGTAACTGAA-1	CM
GAGATTCTCACATTCT-1	CM
CTCACCACACGGTTAT-1	CM
CTTGTCGAGTATACGA-1	CM
TATTGCTCAGGTGGTA-1	CM
TGGACATCATCCCTTG-1	Fib
TATGTGGTCTTACCTA-1	CM
TTGTTCACATGCCCTT-1	CM
CCGTGAGAGAACGTCG-1	CM
CCGTAGGAGCCTATAC-1	CM
CAACGTACAGGGTACA-1	CM
ATAGGCTCACTAAACC-1	Fib
TACCTCGAGGCCAGTA-1	CM
CTCTACGAGCGCATTT-1	CM
CCGCATTAGCTGAAAT-1	CM
TACATGGGTCAGAGTG-1	CM
TCTAGTTCATTCGTCC-1	CM
GCATTCCAGGAGTAGA-1	CM
GGCATTACAAGTCTCA-1	CM
TTGCGGGCAAGACACG-1	CM
TGGTCAAAGCTGGAGT-1	CM
AGTGCGCGTGTCCAGC-1	CM
ATGTTTCAGGTTAGTA-1	CM
TCCCACAGTGTCGTGC-1	CM
TGGCCTTAGGGTAATT-1	CM
CTGGGACGTTCTGAGT-1	CM
AGCGTGCTCCCACTTG-1	CM
TTGCGAAGTGATGCTT-1	CM
CACCTGTAGGATCCTT-1	CM
CGGACTGTCCCAATGA-1	CM
ATAGTCGGTGTTGGTT-1	CM
GCAGCTGTCCGTACGG-1	CM
ACAGCGCCAGCAATGG-1	CM
TCCGACTGTACCCATA-1	CM
TTACTCACACCATTCC-1	CM
TTGCACCGTGAATCAA-1	CM
AACCAACGTAATGCAA-1	CM
AGGCCTGTCATACTTC-1	CM
GGATAGGCAACGTCGC-1	CM
TCTCTGGGTTCTACGA-1	CM
TTCGATTTCTGTAGAC-1	CM
CAATCCCAGAAGACTT-1	Myeloid
ACAGGCCAGGTTTCTG-1	Myeloid
GGCATTAGTCGATAGG-1	CM
TCAAGGTAGGGAGATA-1	CM
ACCGGGTCAGAACTTC-1	CM
TTGCGAACATGGTTTG-1	CM
ATGTACGGTAACTGAA-1	Fib
GCCAGACAGTCAGCCC-1	CM
CTTCCAGCAGGCAGAT-1	CM
TGGGTTATCTTACGGA-1	CM
TGCCTGTGTAGTACAA-1	CM
ACCCAAATCTTCACTA-1	Endo
ACCTGCTTCTCTATCA-1	Myeloid
CAGTGTACACGCTAAT-1	CM
CGGTGCAAGTGATTAG-1	CM
TGGGTTAGTAATGTAG-1	CM
CCCTAGTCAATGGTCT-1	CM
CCTGGGATCCTCTCTT-1	CM
AGACAAATCCGTCAAA-1	CM
TTTACGTGTCGCTACG-1	CM
GGAGAACTCTGAGTCA-1	CM
GACTAACGTCTGGTTA-1	CM
GCAGATTGTGCTGGCT-1	CM
TTCTGTAAGTATAGTG-1	CM
ACAGCGCAGAGGCGGA-1	Myeloid
TACTAGGGTCCGCTTT-1	CM
CCTATTATCCGTGCGA-1	CM
GCTTTCGAGCCGCAAA-1	CM
CTCTCGATCCATAGGT-1	Myeloid
GCAGATTCAGGGCTTC-1	CM
GGTCATAGTAGCATGG-1	CM
GTGCACGCAGGTTATC-1	CM
GCATTGATCCTCTCTT-1	Fib
ACTACCCAGGATGTCG-1	Fib
ACCGCAGGTCCTCAGG-1	CM
GCACGCACATGCACTA-1	Endo
ATTACTCGTAGTCCAT-1	CM
CCGTAGGCAGGCATCC-1	CM
TCGATTTCACTTTGGA-1	CM
GGTGTCGCACATTGCA-1	CM
TTAGGTGTCCTCCCAA-1	CM
TCACCTGGTGAATACA-1	CM
CGAGTTATCTCCACTG-1	Fib
GACTAGTGTTGTGAGG-1	CM
TCCATCGGTAGTGATA-1	CM
GGTAGGAAGATCTAAG-1	Fib
AAGGTTCCAGTTAAAG-1	Endo
TATCGAGTCGTGCTTC-1	CM
GTAGACTAGCACGTAG-1	Endo
AGACAAATCCACGAGC-1	CM
CTAACTTAGGTTTCTG-1	CM
CTTGTCGCACGCGATC-1	CM
TTGCTATAGGCGTCCT-1	CM
TTCGATTTCACGTCAA-1	CM
TGCTCGTAGCTAACAA-1	Myeloid
AACCTGATCAGGCCGT-1	Endo
AGACAAAGTTTGCATG-1	CM
TGCGTAAGTACGTATC-1	CM
CTTCCAGAGTGTAATG-1	CM
AACCTTTAGCTGCCAC-1	CM
TATCGAGAGACCAATA-1	Endo
GTTCAAGTCGACTGGC-1	CM
CACTGAAGTGGTGGTA-1	CM
CAAGCTACACCACCAG-1	Myeloid
GCCTAGGTCGCGGCAT-1	Endo
CTTGCTGGTAACAATG-1	CM
GAAAGTAAGCACCATT-1	CM
GGTTGCGGTCTTAGCA-1	Endo
CCGTAGGGTCGACTGC-1	CM
CCGTAGGGTTAGCTCA-1	CM
GATTAGCAGTGAAACT-1	CM
ATGTTTCGTATACGCT-1	CM
CGCTGGAGTTTCGACA-1	CM
TTCGCGTTCCTCTCTT-1	Myeloid
CTAACTTCAAGTAATG-1	Fib
AGGACGAAGAGGAATG-1	CM
TCTAGTTGTTCTACCC-1	CM
TGTGACAAGATATGAC-1	Myeloid
TGGTCCTCACCACGAC-1	CM
ACTTCCGTCACATCCC-1	CM
GATCGTACAAGATGCG-1	CM
GACTAACTCGTTCTAT-1	CM
CACCACTTCTCTTCCT-1	Endo
TCACTCGCATGATTGC-1	Endo
TGCTTTATCGGTCGAC-1	CM
GTAGACTGTGGCCTCA-1	CM
TCAAGCATCGATTACG-1	CM
GAGGCTCGTACTTGAC-1	CM
GAACGTTAGATAGGTT-1	Endo
ACCGAATAGGTAAGCC-1	CM
TGGACATCAGGAGCAT-1	Myeloid
CCGAAGCAGTCGGGAT-1	CM
TACCCTGGTACCTATG-1	CM
ACCGGGTTCACTAGCA-1	CM
TGCTTCGTCGACTCGG-1	CM
TACCCTGCATGATTGC-1	CM
TCGCAGGAGATATGTG-1	Fib
CTTGCCAGTAGCGGTA-1	CM
GTTGGGCGTGTCCTTC-1	CM
CAGGGCTAGGAGTCTG-1	CM
TCACAAGAGACCCTAT-1	Endo
GCGCCAACAGTGGTCC-1	CM
GTCGTAAGTCTCTGCT-1	vSMCs
AGGCGTCAGTGCACAG-1	Endo
TGGACATGTACTTGAC-1	CM
GCGTTGGTCCTGACCT-1	Myeloid
CTTGCTGGTAGATGAT-1	CM
CTGGGACGTACTTCGA-1	CM
CACCACTAGTGCTGAG-1	CM
AAACGAAGTTGCAGCC-1	CM
TCACAAGGTTTCGTTT-1	Pericyte
AACTGTGTCATTCGGA-1	Fib
TTGAGCAGTCCGCTTT-1	Myeloid
TAACTTCCAATTCAGC-1	Endo
ATCCCTGGTATACGCT-1	CM
GCGTTGGAGTCTGGGA-1	CM
ACTTCCGTCCGGCGAT-1	CM
AGGCCTGCACCTATTT-1	Fib
AGCTATGAGAGCGAAA-1	CM
CCTCCCTTCACACGTA-1	CM
ATGTACGGTCGGCTGT-1	Myeloid
AAGATAGAGTGATATG-1	Fib
TAAGTGCGTATACGCT-1	Endo
CTCTCGATCACAGGGA-1	CM
TGGCAATGTATGTTCG-1	CM
AGGCGTCCAAAGGAAG-1	Fib
GCTCGAGCAATGATGA-1	CM
TTCGATTAGAATATCG-1	Fib
TGCTCGTTCCTAGAGT-1	CM
TCAAGCAAGGCTCAGA-1	Fib
AACAAAGAGGGCGAAG-1	Myeloid
AACGTACCATTGCGAT-1	CM
GGTAGGATCTTACTCA-1	CM
ACCGCAGAGCAGTAGC-1	CM
AATGGAAGTTCACGTA-1	CM
CAGGGCTCAACTACTG-1	Fib
CCGTAGGGTGCCGGTT-1	CM
AACTGTGGTTCCAGTA-1	Myeloid
CGTTCCACAGCAACAG-1	Myeloid
GGAGAACGTTTCACCC-1	Fib
TTGCTATGTATCTGCA-1	Fib
GCATTGACATAGAATG-1	Myeloid
GTGACATTCTTGTACT-1	Pericyte
CAGGATTTCGTCCCTA-1	Myeloid
CTGCGTTGTGATAAGT-1	Fib
TTTACGTGTCTCTAAG-1	Fib
TCGCCTAGTTGTCGGC-1	CM
TAGGTCAGTCGATTAC-1	CM
TGACAACGTGCTTGAT-1	Fib
AAACGAATCGTGAACT-1	Myeloid
TTCTGTATCTACTTTG-1	CM
GCGGAAACAGAACAGC-1	CM
GTCACGGCAGAACTTC-1	Endo
TTCGATTTCATCATGG-1	Myeloid
CAACCAAAGCTGCCAC-1	CM
GAGCATTTCTTTCGAT-1	CM
TACCTCGAGTTCGACT-1	CM
CTACAGACAAACCTAC-1	Endo
GCTGCGAGTCCACCAG-1	CM
TCAAGGTAGATCGAGC-1	Fib
GCGATCGGTTGCCGCA-1	CM
TTGAGTGCATCCTGGG-1	Myeloid
TGGGTGCGTCGTCGCA-1	Myeloid
GAGATTCTCGCAGATT-1	Myeloid
GACCGACTCTCGACAA-1	Fib
CTCTAGCGTGCGTAGA-1	Myeloid
GCGCATGAGATTGACA-1	Endo
TAAACCGCACGATTAC-1	CM
TTTACGTCACCCATCT-1	Myeloid
ACAAAGAGTCAAGACG-1	Fib
TAAACCGTCGACTGGC-1	CM
AGACAAAAGTTAGCAA-1	Fib
CGTACAATCGCACCTT-1	Fib
TAGGTGTAGTTACACC-1	Fib
CGCTGGAAGTTCCAGT-1	Endo
GACCCAGTCTTCTTCC-1	Fib
GCCCGAAGTTAGTAGA-1	Fib
TGGGTGCCACAGGTAG-1	Myeloid
TTGAGCACATCCCTCA-1	Myeloid
ACAGAAACACTCCCAT-1	Fib
GCCATAAAGGTAAGTT-1	Fib
TGGGTGCGTTTGAAGA-1	vSMCs
TCAGGGCTCGGGTCCA-1	Fib
CCCTGATTCTTGTCAT-1	Pericyte
ACTGTCCGTGCCGGTT-1	CM
GGAACCCAGAGCACTG-1	Endo
GAGTGAGCACGTTGTA-1	Fib
CTAGGGCAGAAAGGGT-1	Pericyte
GTCCATCAGGCACTAG-1	CM
TCAAGACGTCATTGCA-1	Pericyte
TTCGGTCAGAACTAAC-1	Neuronal
TTGCAGACATTAAGGA-1	Fib
TTGGTCCTCGTGGCGT-1	Fib
CGCAATATCATGCTTT-1	Myeloid
ATCCCTGAGTCTTAGC-1	Fib
GCATTGAGTGCTGGCT-1	Fib
TTTGCGCCAGAATGCG-1	Myeloid
AATGCCAGTACGAGAC-1	CM
GCTGTTCCAGGCATCC-1	Endo
GCTGTTCAGGTCCTCG-1	Myeloid
TTCGCGTTCCCAGCGA-1	Fib
GAGCATTGTAACCCAT-1	Fib
CAACGTACAAGTAATG-1	Fib
AGCGATTCACGCGACT-1	Fib
ACCTGCTGTTTGCGAT-1	Myeloid
GCAGCCATCTTACGGA-1	CM
GTTACGAAGCATGTGG-1	CM
GCAGATTTCCCGTATC-1	CM
ACTAGGTCAGTAACGG-1	Fib
TTGCGAAAGTAACACA-1	Fib
CCAGAATCACGCCGAT-1	Myeloid
TTAGCTTGTATTCTCT-1	Fib
TGGTCCTTCTCTGACC-1	Fib
GTTACTTGTGCGCATC-1	Fib
ATAGGCTAGCCATTCA-1	Fib
CTCTAGCCAAACCCTA-1	Fib
CAACCAAAGCGATACG-1	Endo
GCCTACTAGTGTCGGA-1	Fib
GAGGCTCCACAAACAA-1	Fib
CTCTACGTCCGTGCAG-1	Fib
CCTCCCTTCGCAAACT-1	Endo
ACAGACTAGCACGTAG-1	Fib
TACATGGTCTGCTACC-1	Fib
TCACAGATCTTGTACT-1	Endo
TACTAGGGTTCCAATG-1	Pericyte
GCACGGTAGGTCTTGT-1	vSMCs
CTTAATCAGTCGTACT-1	vSMCs
GTCACCTGTCCACCAG-1	CM
CGGACCATCAATTCCT-1	Fib
CTTCTAAGTGAAACAT-1	Myeloid
CGCTATCGTCAGACGA-1	Lymphoid
ACTGTCCGTCTGTGTA-1	CM
AGCGTATCAGTAAGCG-1	Fib
TAGGTGTAGGGCTTCC-1	Fib
GGCACGTAGGTCCTCG-1	vSMCs
TCTCTGGCAAAGCATA-1	Fib
AGCCTCTTCAATTGGC-1	Fib
TGCACCTAGCTATCGT-1	Fib
GCGGTGTCATAGTCCA-1	Endo
TAGCCCTTCACATCCC-1	vSMCs
GTGTCCTCATTTGGTG-1	Endo
TTGAGTGAGGCGCTTC-1	vSMCs
ATATTCCCACTTACAG-1	Lymphoid
ACAGACTGTCAATACC-1	Pericyte
CCTAAAGTCCTGAAAC-1	Endo
GCACCTTCACATCATG-1	Endo
TTTGCGCAGTACAGTA-1	CM
CTCTAGCGTAGAATAC-1	Endo
CTCATGCTCCCAATGA-1	Endo
AAATGAGTCGCTTCAC-1	Fib
GCTTGCTAGAGCTACG-1	CM
AAGGAGCCAGAGAGAA-1	Fib
CACCACTAGGAGTAGA-1	Endo
AGCGATTCATCACAGT-1	Endo
AGGCCCAAGCTAGTTC-1	Pericyte
TCAATTCCAACTCGAT-1	Pericyte
GCTTGCTTCAATTGGC-1	Endo
ACGTGGCTCCGAGAGA-1	Fib
AGTGTACGTAAGTGCG-1	Fib
GCTTTCGGTAGTAACA-1	Pericyte
TTACCCGTCCTTGACC-1	CM
AGGACGAAGCAGTAGC-1	CM
CACCTGTCACATTCTT-1	Fib
ATTGTGGCAACTCCCT-1	Endo
ACGTTAGCATTACTTC-1	CM
AGCCTGGCAACGCACC-1	Endo
AGCGTATCAATGGCAG-1	Endo
TCCGACTAGGACCGAT-1	Myeloid
GGTACCGAGTACTCTG-1	CM
TAGCCCTGTCAAGACG-1	Pericyte
TAGCGGCAGTCTGCTA-1	Fib
CGCAGGTCAAGTGGCA-1	Myeloid
TCGTTCGAGTGGGACT-1	Endo
CATTCATCAGGTGGTA-1	CM
TATGTTCTCCTGTAGA-1	vSMCs
GTGCACGAGTTTGGAA-1	Endo
ACGGATTAGCCATTCA-1	vSMCs
GCACGGTCAGGTAGCA-1	Fib
TACTCGCGTCTCTAAG-1	Pericyte
TTCAACTAGTCCAGAG-1	Pericyte
TGACAACCACCGAAAG-1	Pericyte
ATCCCTGAGCCTGTAT-1	Endo
CAACCAAGTTGGAGGT-1	Fib
AACGGGACAGTGCGAA-1	Myeloid
TGGCGCACACGCGACT-1	Endo
GAGTGAGGTGATGTGG-1	Fib
TGGTCAATCGAGTTAC-1	vSMCs
ACCGCAGTCGGACGAA-1	vSMCs
CACAGATCAATTCAGC-1	Myeloid
GATCATGTCCTGACCT-1	Fib
TAATTCCGTTAGCTCA-1	Myeloid
CCTGCTAGTTCGGGAA-1	Endo
CACAACACACTCCCAT-1	Endo
AGATAGAGTGCAACAG-1	Pericyte
CAAGAAAAGTCTCTAG-1	Endo
GGCGAAACAGTATACC-1	Endo
GTGACATCAATGCACT-1	Pericyte
AATGGAACATTACTTC-1	Pericyte
GAGGTCCTCGATGTGT-1	Endo
TGGCGCAAGAGTGGAA-1	Endo
ACTAACGTCACGATTG-1	Pericyte
ACCAAACGTTGTATCG-1	CM
GCGGGTTTCAAACCAC-1	Endo
CAAGGCCAGACGACTG-1	Fib
CTGCGTTCATGGCCGT-1	Endo
TCCAGAAGTCAAACAA-1	Endo
CAGTGTACAAGACTAA-1	Fib
AATGTCGCAAAGAAGG-1	Endo
ACAAAGATCGGGAAAC-1	Pericyte
TGCCTGTGTCTCTAAG-1	Endo
GTCACAAGTTAAGTCC-1	Pericyte
ACAGCGCTCACTTACT-1	Pericyte
TCTAGTTAGTCGACCC-1	Myeloid
TGGACATTCTGGGCGT-1	Endo
TAAACCGCAGGGAGTT-1	Pericyte
ACAGCGCGTACCCACG-1	vSMCs
TGTGACACACTAAACC-1	Endo
CCGTGAGGTGTCCCAG-1	Pericyte
AATGGCTTCACTCCCA-1	Pericyte
GTGGATTGTATCGCGC-1	Fib
GATTAGCCAAGCACTT-1	Endo
AGGCCTGTCCTTACGC-1	Fib
TTCGATTCAATTCAGC-1	Endo
CCTGGGAAGGTGTTGG-1	Myeloid
TCACCTGTCGCTATAG-1	Endo
ATCCTGCAGTTTACGC-1	CM
AGTCAACTCAGAGTGG-1	Fib
CATGTTTTCAATTCCT-1	Fib
ACTAGGTGTGAGGGTT-1	Endo
ACATGGTTCCCGTATC-1	Endo
TGGCAATGTGTTAGAA-1	Endo
GCCCGAACAGGCTACC-1	Endo
GAGTGAGTCGGTTCCT-1	Endo
CAACGGCCATAGACGG-1	Endo
CACTGAACAACTCGTA-1	CM
CAAGCTAAGGCTTCGC-1	Endo
TGATTTCTCGATGCAT-1	Pericyte
ACCTGCTCAAGCCTTA-1	vSMCs
GTTATTCGTAAAGCTA-1	Fib
ATCCTGCGTCACTCTC-1	Fib
TACTAGGGTGTTTCTT-1	Pericyte
TTCTAACTCGCAGATT-1	Endo
GTGTGATCAACGTCCG-1	vSMCs
TAGCTTTTCTTACTCA-1	Pericyte
TAAGTGCAGTCCTTCC-1	Pericyte
AGACAAAGTCATCAAC-1	Pericyte
CAACGTAAGGACTAGC-1	Endo
TTGCTATCACCCTTAC-1	Endo
CAGGATTCAAAGCTGG-1	Endo
AGCCTGGGTCCCGTGA-1	Pericyte
ACCAAACTCTCTGCGT-1	Pericyte
ATGTCGACACAGTTAC-1	Pericyte
AGCGATTTCCATAACG-1	Endo
ATGTCTTAGTTCGACT-1	CM
TGCTTTACAAGGAGGG-1	Pericyte
AGTTTGGCAATCATCG-1	Fib
TAGCTTTCACCACGAC-1	Fib
CCTCCCTGTACGTAAA-1	Endo
ACAAAGACAGAAGTGC-1	Fib
GCTGAGCGTCCCTTTG-1	Fib
TGGACATGTAAACGAT-1	Pericyte
TTCGATTCACGCTGTG-1	Endo
GAGGATGGTAGTGATA-1	Endo
TGATGCAAGTTGCGCC-1	CM
GTCTACCCAAGTCTCA-1	Endo
GAAGAGCAGGTGTTGG-1	Neuronal
GACTAACTCACGATTG-1	Endo
AATGGAAAGCATGTGG-1	Endo
GTCGTAAGTATCAGCT-1	Endo
AATGGCTGTTCTGAAC-1	Pericyte
GCAGCCAAGTCCGTGC-1	Fib
GCGATCGTCCACGGCA-1	Pericyte
CACGTTCCATCCTCGT-1	Pericyte
GTGCCAGCATATAGAG-1	Endo
TAGGTGTGTAAAGGCC-1	Endo
TAGCACACACGCGATC-1	Fib
CTTTGCGTCACTCGGG-1	Endo
GTGCTGGAGCTGAAAT-1	Myeloid
GAGAACGCACGGCCAT-1	CM
CTGCTCACAGATACAA-1	Myeloid
CTCACCAGTTTCACCC-1	Endo
CGGTGCAAGATCTAAG-1	Endo
GATCATGCAGAGTCGA-1	Pericyte
ACCAAACAGAGGTACC-1	Endo
ACCCAAATCCGCTCTA-1	Endo
TTGCGGGGTTTCGTTT-1	Endo
ACTAACGTCTAGTCGA-1	vSMCs
GGACACCGTTTCCTAT-1	Endo
TATGTTCCAATACTGC-1	Endo
CTCAGAAAGTGTGTAA-1	vSMCs
GGGTTATCAACTGCGC-1	Endo
GAAGTCTGTTCAGAAA-1	Endo
GGTGTCGGTTGGCGAA-1	Endo
TTTGGTTTCCATATCT-1	Lymphoid
TCTCTGGCAATTGTGC-1	Endo
CGTACAAAGACACAAT-1	Endo
GAGGATGCACTTATGG-1	Endo
TTCGTTATCCACTAGA-1	Endo
TTCATCAAGAGAAGCA-1	Endo
ATTTGTCGTCCGGTAC-1	Pericyte
GTGCACGGTTTGCGAT-1	CM
GACCCAGAGGTACACG-1	Endo
CTCTACGCACAGGAAC-1	Endo
CCGCATTGTCCCTTTG-1	Endo
ATGTCGATCCATTGTT-1	Endo
TTGCCCAAGACCAATA-1	Pericyte
CCCTAGTTCTACCCGT-1	Endo
AAAGGATCATCACAAC-1	Endo
AACTTGGAGTTGACAA-1	Endo
GCTCACTTCCAGGTAT-1	Endo
CGGTGCAAGTGATAAC-1	Pericyte
AATGTCGGTAGGTGAC-1	Pericyte
CATGCCTCAAGCGGTA-1	Pericyte
GGGTGTCCACCGTTGG-1	Endo
TGTAGCACATCCGTAA-1	Endo
GCCATAACATTTGGCA-1	Endo
ACGTGGCGTGAATACA-1	Fib
TTGCACCAGCTGATTC-1	Myeloid
ATGTTTCGTGCTTCCT-1	Myeloid
CGGACCATCCTGACCT-1	Fib
TGTTAGGCAGCGCGTT-1	Endo
CATTCATTCTCGACAA-1	Pericyte
GGCATTAGTTTAGGAA-1	Pericyte
AGGCCTGAGAGCTGTG-1	Endo
TACGGATGTTGCAGCC-1	vSMCs
CTGGGACCAGGTCCTG-1	vSMCs
GGAGAACGTCTGGTCG-1	Myeloid
ACCGAATTCTCGTAGA-1	Endo
GTCGTAATCCTCCTGA-1	Pericyte
GGAATCTGTTCGGGAA-1	Endo
GCACCTTTCTCTGCAC-1	Endo
TTGCTATGTGGGTAGT-1	Pericyte
GAAGTCTCACAAACGG-1	Endo
GCAGCTGCAGGCATCC-1	Endo
GGTGCTGTCTGTAGAC-1	Endo
GCTTAAGCACGTGAAG-1	Pericyte
TGTTAGGCAGTGGTCC-1	Fib
CGTGGCAAGGCTCCTG-1	Myeloid
ACATGGTTCCAGGGAA-1	Endo
TTGCGGGAGTGATCTC-1	Pericyte
AAACTCGAGAGATTAC-1	Pericyte
AGCGATTCATAGACGG-1	Myeloid
ATTACTCTCAGCACGC-1	Pericyte
CAACGTAAGTTCCCGG-1	Pericyte
TTCGATTAGTACCACT-1	Endo
TTAGGTGCACTCGGAC-1	Pericyte
GCGATTATCTTGTGCC-1	Endo
GCTCACTGTAAGTCTC-1	Endo
CAGGATTCATGATCGT-1	Endo
CAAGCTATCAGTGTAC-1	Endo
GAGCGCTCACGATTAC-1	vSMCs
CACAACAAGGTAGGCT-1	Pericyte
TGCTCGTTCGCACAAT-1	Endo
CTTGCTGGTGGTAGAC-1	Endo
CCGTACTAGGCAGATC-1	Endo
ACAGCGCAGGGCATTG-1	Pericyte
CCCTAGTTCAGCACTA-1	Pericyte
AACTGTGGTCGAGGAT-1	Myeloid
ACGTTAGTCTGTCGGG-1	Endo
CTGGCAGTCTCGCGGA-1	Neuronal
TGTAAGCAGGGAAATG-1	Endo
TGTGGCGGTAACCGAG-1	Neuronal
TACTAGGGTGATTCCA-1	Fib
GCGTTGGCACTGTAAC-1	Endo
GAGACTTCATGGGACA-1	Endo
TACTAGGTCTGTTTAC-1	Pericyte
ACAGCGCAGAGTTTGA-1	CM
GATCGTACAGTTACAC-1	Endo
CGGACTGTCGCTGATA-1	Endo
GGTGTCGGTATTCTCT-1	Lymphoid
ACATGGTCACCAAGGA-1	Pericyte
TCAAGCATCCGTCAAA-1	Fib
GTTGGGCGTTCTACCC-1	Endo
ACAGACTGTAACACTC-1	Endo
TAATTCCGTGTCCAGC-1	Lymphoid
GGCACGTTCAGAACGG-1	Endo
CTCTCAGTCCTATCAT-1	Pericyte
ACCCAAAAGAGCTCCC-1	Endo
ATGCATGGTGGTAGAC-1	Neuronal
TACCCTGTCGGATAGG-1	Pericyte
AGACAAAGTGTTAGAA-1	Neuronal
TACGCCTAGCGGACTA-1	CM
TCGATTTAGAGGTACC-1	Endo
GTCACTCAGACAGTGC-1	Endo
TTGCCCAAGACGACTG-1	Endo
AAAGATGCATTTCACT-1	Myeloid
TAGCGGCGTTTGCCAA-1	Pericyte
GCGGGTTAGCATGTGG-1	Endo
AGACAAACAAGTCTGT-1	Endo
CCTTGCAAGTGAGCAC-1	CM
GGATAGGAGTATACCC-1	Pericyte
GTTACGATCCTGTAGA-1	Myeloid
TTAACGGTCCTGTGGG-1	Endo
GAAATGACACAGTTCA-1	CM
AACTTGGAGAGCTGTG-1	Endo
ACAAGCTCAGAAGTGC-1	Fib
CCCTAACAGTTGCGCC-1	Neuronal
TCGATTTAGAGCCTGA-1	CM
GAGACTTAGGAGGCGA-1	Endo
TACGCAATCAGTTGAC-1	CM
CCAGAATCACTTTGGA-1	Endo
TTGCGGGCAACTTGGT-1	Neuronal
ACATGCAAGAGAAGCA-1	Pericyte
TTGCAGAGTGAGTAAT-1	vSMCs
TCGTTCGTCTGCCGAG-1	Pericyte
TCAGCTCAGTCGCGTC-1	CM
TTCGCGTGTAGCGTTT-1	CM
GCAGCCAAGGGAGTTC-1	Pericyte
AGGCCCATCGTAGCGC-1	CM
CGGACCATCCCGAAGC-1	Neuronal
GCGTAGCAGGCTGGAT-1	Endo
GCAGATTCACACGGTC-1	CM
TCCCACAAGCGCAATG-1	Endo
TAGCCGGAGAATAGTC-1	CM
CCAGATAGTTTGATCG-1	Endo
TGTTAGGAGCGCATTT-1	Endo
GGAACCCCAGCAACGA-1	Neuronal
TACCCTGAGGGTCTGA-1	Myeloid
GCAGCCAAGAGGAATG-1	Pericyte
GGAACTTAGCCATGGA-1	Endo
GTGGCGTGTCAATCCA-1	Endo
GCTCCTAGTTGGAGGT-1	Lymphoid
GCGGAAAAGAGAGTAG-1	Endo
GGAGGATTCCCTATTA-1	Neuronal
AGCTGATGTGCAACAG-1	CM
ACAGCGCTCCCGATTC-1	Fib
GAATCTGCAACGTCCG-1	Endo
AATGCCAAGCTGCCAC-1	Endo
GAAGAGCGTACGGAGT-1	Lymphoid
CGCAATACACGCCGAT-1	CM
CCGTGAGTCTGAGTCA-1	Endo
TGCCTGTAGCCTGGTC-1	CM
ACAAACCCACATGATC-1	vSMCs
TAGCATGAGAGAGGTA-1	Fib
GAAGAGCTCGTGGGTC-1	Fib
GGATGAGCACACATGT-1	Endo
GTTACGATCGGTTGTA-1	Pericyte
CGCAGGTAGATCGAGC-1	Neuronal
GCACCTTAGCGCACAA-1	Fib
GCCCGAAAGGGTAGTC-1	CM
GGAGAACAGAATAGTC-1	Fib
TGGGTGCAGATGGGTC-1	Fib
AGGCGAAGTAGCGGTA-1	Fib
GAACCGCTCGGTTCCT-1	Pericyte
GCGCATGAGATCGCCC-1	Endo
TGCATTTTCACGGGTC-1	Fib
CTTGAAGTCACGGGTC-1	Endo
GGCATTACACAGAAGC-1	Fib
GCAGATTTCACGATTG-1	CM
AATGGCTTCAGTAGTC-1	vSMCs
TTGCCCACAGCAACAG-1	Fib
AAGATAGTCGATAGTC-1	Fib
CCACGTTCAAGATGCG-1	CM
CTAGCGGTCACGGGTC-1	Endo
TCAGTCCTCAGTAGTC-1	Endo
