Barcode	cell_type
ATTGTGGGTCGAGGAT-1	CM
TGATGCACAAACTACC-1	CM
TACCTATAGGGATCCA-1	CM
CACCTTGGTATGAAGT-1	Fib
GCAGCTGAGCGCGTTC-1	CM
GTGTCAAAGACACAAT-1	CM
CACGTTCCATTGAACC-1	CM
TAGCATGCAGTAGTCT-1	CM
CGTACAATCATTCGGA-1	CM
TGCGTAATCGCTATAG-1	CM
TCACCTGCAGTGGTCC-1	CM
GTTGGGCGTAAGGTCG-1	CM
AATGGAACACTAGGAG-1	CM
GTCTACCTCCAGTACA-1	CM
GAGGATGTCATTGCCC-1	CM
TACTCGCTCCTTCGAC-1	CM
CTCGCTACAACAAACA-1	CM
TAGGTGTAGCTGATTC-1	Fib
ATTACCTTCGGTCAGC-1	CM
CCTATTACATTTGGTG-1	CM
CTCTACGGTGATAGAT-1	CM
AGTCAACAGCTACGCC-1	CM
GCCAGACCATTGAACC-1	CM
TGTTAGGGTGATTCCA-1	CM
TGACAACCACAGGAAC-1	CM
AGGCGTCCAGAGAGAA-1	CM
TGGGTTAGTCAATCCA-1	CM
CCTTGCAGTACGCCCA-1	CM
ATTACCTAGGATTTGA-1	CM
CTTGAAGAGACGCCAA-1	CM
CCGTGAGAGCAGTAGC-1	CM
GCCCGAAAGGATTTGA-1	CM
GACCTTCTCTCGCGGA-1	Myeloid
TACCTATAGTATACCC-1	CM
CCTATTAGTTTGAAGA-1	CM
CTACTTATCGCTAGTA-1	CM
CTCTCGACAAGTCTGT-1	CM
TGAATCGAGTGAAGGA-1	CM
TCAGTTTAGCATTGGG-1	Myeloid
TAAGTGCGTACAAATG-1	CM
TATCGAGCATATACGC-1	CM
CTAGCGGCATAGAATG-1	CM
TCTATTGGTACGGTTT-1	CM
GACTAGTTCGATCTTT-1	CM
TTGAGCAGTACAACGG-1	CM
AATGTCGTCTTGTGCC-1	CM
GCGCATGAGTGAACCG-1	CM
TTGCGGGTCTTTATCG-1	CM
TGTAAGCAGTACCCAT-1	CM
GTCTACCTCGCCTTAC-1	CM
TTCGATTAGACACGGT-1	CM
CTCGCTAAGACTTCCA-1	CM
GACTAACAGGACCGAT-1	CM
CCAGAATCAATTGTGC-1	CM
CTTGAAGTCGACTTAG-1	Myeloid
CATTCATAGTCTTAGC-1	CM
AGCGATTTCTTACTCA-1	CM
TCAAGCATCTTAACGG-1	CM
AACAAAGGTGAGCTAG-1	CM
CCACGTTGTCTGTCCT-1	CM
TATCTGTTCCGTTAGA-1	CM
CTCTCAGAGACGACTG-1	CM
TAGCACAAGCCGCAAA-1	Fib
TACTGCCGTATTGTGC-1	CM
AAGGTTCAGTCTGCTA-1	CM
CCCAGAGGTTCGGGAA-1	CM
ATTGTGGCAATGCCAT-1	CM
GACCGACTCCAGTTAG-1	CM
GGCGTTGAGGAGACTC-1	CM
TGAGCCGTCACCCGGA-1	CM
CTGCTCACATTAAGGA-1	CM
TGAGTCAAGTACTCTG-1	Pericyte
GACCCAGGTTCCCGGA-1	CM
TGGGTTATCGATGCAT-1	CM
GCTCCTAAGTGAACCG-1	Fib
GGGTCTGGTGACCAGA-1	Pericyte
AGTTTGGTCTTGTCGC-1	CM
GACCGACAGTCTGCTA-1	CM
AGCCTGGCAATGGTCT-1	CM
GTAGTACTCTTCTTCC-1	CM
TATGTTCGTCATCAAC-1	CM
TTACTTGTCGGTAGGA-1	Pericyte
ACTACCCGTCAGGTGA-1	CM
GACCTTCTCAGTACAC-1	CM
GATTGACAGTCAACTC-1	CM
CATTGGATCTGGTACA-1	CM
TTGACGAAGTAGTGTA-1	Myeloid
GTTGGTACAAGTCTCA-1	Myeloid
GGGTTATAGTGAAGGA-1	CM
AACGAGGGTGAGTTGG-1	CM
CCCACATCATAAAGTG-1	Fib
CTGAATGAGACCTATC-1	CM
GGGTTATGTGCGCTCA-1	CM
CACCTTGTCTCCTTGG-1	Endo
GGGTGTCAGTCGATAA-1	CM
GACTAGTGTTGCAGCC-1	CM
TGATCAGAGCAACTGG-1	CM
AACCAACAGCGGACAT-1	CM
TATGTTCCATTGATGC-1	CM
ACGGATTAGTCTCTAG-1	CM
TTGACGATCCTGTGGG-1	CM
TACCTATAGCACGTAG-1	CM
TGGTCAAAGTGATAAC-1	CM
GTACTTTGTAGCAGGT-1	CM
TAGCGGCTCAAGAGAT-1	CM
GAATCTGTCCTAGAGT-1	CM
AGGCCCAGTTTCTACT-1	CM
TCTAGTTCAGTTGGAG-1	CM
GGGTGTCAGAGCCACA-1	CM
TCGATTTAGGACTTTC-1	CM
TAGCATGGTTCACGTA-1	CM
CACGTTCAGGTACATA-1	CM
GCTGCGAGTTACCCAA-1	Neuronal
GTGTCAACATGCACTA-1	CM
ACTAGGTAGAACAGGA-1	CM
ACTGCAAGTGAATACA-1	CM
GTTACTTGTATCGCGC-1	CM
AACTGTGAGTGATAAC-1	CM
CTACTTATCGCCACTT-1	Fib
ACTGTCCTCCTGTAGA-1	CM
GACCTTCAGTGTCGGA-1	CM
GCATTGAGTGCAGACA-1	CM
TAGCCCTGTCAGAAAT-1	CM
CTCAACCTCTACATCT-1	Endo
TAGCACACAAGCGGTA-1	CM
ACAAGCTTCTATAGGC-1	Endo
ATCGAGTCATCATCGA-1	CM
TCAGGTAAGTCGAGCA-1	Myeloid
TTACTTGAGTCCTTCC-1	Fib
TATGTGGCAACTCGTA-1	CM
TAGCATGCAGGGTAAC-1	Fib
CTTCTAAGTCGCTACG-1	CM
GCAACCGCAAGCGAAC-1	Myeloid
TTACCGCCATTTGTTC-1	CM
TATGTGGAGGCCAGTA-1	CM
CATGCCTGTTAAGTCC-1	Fib
GCGAGTCTCGAGGCTC-1	CM
GTACTTTAGGACTAGC-1	CM
ACAGCGCTCTCTGCAC-1	Neuronal
GGAACTTGTCACTCTC-1	CM
GACCGACAGAGTGGAA-1	CM
TCGATTTGTATCACAC-1	CM
TAACGGTAGAAATCTG-1	Fib
TGGGTGCAGAAGAGTG-1	Pericyte
ACTATTCCACTCGGAC-1	Pericyte
TAATCGGCAACTCGTA-1	Myeloid
GAACGTTCATTACACG-1	CM
CGGACTGTCTTGCGCT-1	Pericyte
TAGTCCCCAAGCGTCC-1	CM
TTACCCGCAGGTAACG-1	Endo
ATTTGTCGTTGTCGGC-1	CM
AGTCAACAGGCGACTA-1	CM
CTCTACGCAGGGCTTC-1	Fib
CCCTAGTGTGAATACA-1	Fib
TGTAGCATCTCGTGAA-1	CM
CTGAATGCAATGACTC-1	Fib
GACTAACGTCACCCGA-1	Fib
ACTTTCACAGCTTACA-1	CM
TGGGTTACAGTGCTCG-1	CM
GTGTCAAAGTACGACG-1	CM
TTGAGTGTCTCTGAGA-1	Fib
CTCAACCTCCTATCCG-1	Fib
GTCGTAACACGTACAT-1	Myeloid
AGCGTATGTTCCCGGA-1	CM
AGCCTTCTCCGTGCGA-1	Pericyte
GCTGCGAGTCGTAATC-1	CM
TCAGCTCTCACTAGCA-1	CM
GAGAACGAGCTACGTT-1	Endo
ATGTTTCGTATCTAGC-1	Pericyte
TATGTGGAGTCTGTGT-1	Fib
GAGTGAGAGAGGAACA-1	CM
GCTGTTCAGATCCGAG-1	CM
TTGTTCAAGTCCGGAA-1	CM
GGCACGTCATACTGCA-1	CM
GAAATGAGTAAGTGCG-1	Fib
ATTACCTAGGGTAATT-1	CM
ATTGTGGGTTGGAGGT-1	CM
CACAGATGTTTAGAAG-1	Myeloid
TTATGTCAGAGGAAGT-1	Pericyte
GCTCGAGAGTTCAGGG-1	Fib
TTGTTGTGTCAAGACG-1	Fib
GGATGAGTCGACGGAA-1	CM
CAAGAAAGTGGACCAA-1	CM
GCCTACTTCTCTTCCT-1	CM
TTAACGGCAATGGCAG-1	CM
TGCTATTAGACGTCAG-1	Endo
TTGCAGATCGCATACA-1	CM
CCTTGCACAGAGCCAA-1	Fib
GGGTCTGCAGTTAAAG-1	Fib
GCGTTGGCAAGGAAGA-1	CM
TGTAGCAAGGTAAGCC-1	Endo
TGCTCGTCACCGTCTT-1	CM
TTATGTCTCCGTTAGA-1	Pericyte
GTTACTTGTGTCCTTC-1	CM
TCAGGTACATAGACGG-1	CM
CGTTCCAAGGCTCAGA-1	Fib
CTTCTAAGTACGGAGT-1	Fib
TCACAGAAGCTAACAA-1	Fib
GGAACCCGTGTCTACA-1	Fib
TGCTTTATCGCTTGAA-1	Fib
AAATGCCTCGACTTAG-1	Myeloid
AGCCAGCGTGAGTCGA-1	CM
ACAATCGAGTGTCACT-1	Endo
ACAATCGTCGGTCTAA-1	Endo
GGAATCTCACACTAGT-1	Fib
AGCGTATAGAGCGAAA-1	Fib
CTTGAAGTCTGTGTGA-1	CM
AGCGTGCGTATCTAGC-1	Myeloid
AGTCAACTCTTTATCG-1	Fib
TTGTTGTTCGGATAAA-1	CM
GTAGACTCATATAGAG-1	Pericyte
AGACAAACAATTCTCT-1	CM
GTCACCTGTCCGGTAC-1	Endo
AGCTGTAAGTGTCGCC-1	CM
TCTCTGGCACGTTACA-1	Endo
AACGAGGAGCTCGGCT-1	Myeloid
TCACAGATCCGAGAGA-1	Myeloid
GTTCAAGTCCATAGGT-1	CM
TTTACGTCACTGAAGG-1	Fib
TAGGTCAGTTAGGCTT-1	Neuronal
CGGACCAGTCCCTAAA-1	CM
TAATTCCCAATGATGA-1	CM
AATGGAAGTCGCTAGC-1	Fib
TGCTCACAGCTACGTT-1	Fib
GCAGATTGTGCAAAGC-1	CM
TTACCCGTCCCTACGT-1	Pericyte
TTGCGGGTCTACTTTG-1	Pericyte
TTAACGGTCAGGGTTT-1	Endo
TGCCTGTGTGCGACCT-1	Pericyte
GGGAACATCGATGTGT-1	Myeloid
GTTATTCCAATTCGTG-1	CM
CCGTACTTCTCTATTG-1	Endo
AACGAGGCATCGCCTT-1	Pericyte
TAGGAGGTCTTCACTA-1	Neuronal
CTCTACGTCGATATGC-1	Endo
GCGAGAACATGGGACA-1	Pericyte
CACAGATAGACTAGCG-1	Pericyte
CTCAACCCATCCATAG-1	CM
CCTTGCAAGCATGATA-1	Pericyte
GATGGCCCAAACGACG-1	Fib
TCAGGGCCAACGGGTA-1	CM
TAACTTCAGAGACTCG-1	CM
AACTGTGGTAAGTGCG-1	Myeloid
GTGGATTCACGCCGAT-1	CM
GGGTGTCTCGGTACTA-1	Endo
TGGACATCAAATAGTG-1	Pericyte
TAGACTGAGTCCGTGC-1	Myeloid
GTTATTCGTAATGTAG-1	CM
TGTGTCCTCCAGCACG-1	Endo
TAGCACAAGGGTGTTG-1	Endo
TCGCCTACATGCGACC-1	CM
TTGCGGGGTGTTAGAA-1	Fib
AAAGGGCCAGTAACTC-1	CM
ACGGATTCAACGCAAG-1	Fib
TACTAGGAGTGATAAC-1	CM
CCTCCCTAGGGAGATA-1	CM
TTAGCGAAGTTGCGCC-1	CM
GAGTGAGTCCAGAGAG-1	vSMCs
TGCATTTCATTCTTTG-1	CM
TCACCACGTCAGACGA-1	Fib
CACTAAGGTAGCGTTT-1	Pericyte
CCTAAAGGTGCCCGAT-1	Fib
TTGCCCAAGCATGTGG-1	CM
CAATCCCGTGACAAGC-1	Myeloid
AACGGGAGTACAACGG-1	CM
TGGTCCTCAATGCACT-1	CM
TCACCTGCAAACCCTA-1	Endo
GTGATCACATTCTCGC-1	CM
ACTTTCAGTGATGTGG-1	CM
TTGACGAAGGCAGTGT-1	Fib
CGAGTTAGTACGCCCA-1	Fib
AGATTCGCATACAACC-1	Fib
GAGGTCCGTTAACCAC-1	Endo
GGCATTAAGAACGACC-1	CM
GCGCCAAGTAGCGTTT-1	Endo
ACCCAAACAGTGCTCG-1	Endo
TGATTTCAGTGCTGAG-1	Endo
AGCTATGCATTGTGAC-1	CM
TACATTCCAATTCTCT-1	Myeloid
AAACGAATCAACTTGG-1	Pericyte
TAGCGGCCAGTAAGAT-1	Pericyte
ACGGATTTCGTTGTAG-1	Pericyte
TTCATTGCAGTAAGAT-1	Fib
TAGCACAGTAGTAACA-1	vSMCs
CCCACATGTAGAACGC-1	CM
GTTACTTAGACGCCAA-1	Endo
CACTGAAGTCAGGCTC-1	CM
CGGACCATCTCGACCT-1	Pericyte
AACAAAGAGGCTAAAT-1	Pericyte
TTTGGCCAGGAACCGT-1	Fib
GGAATCTCATTGATGC-1	Endo
AACCGATAGGTTCGTT-1	Endo
CTGAATGGTTGCTTGA-1	Endo
TGGGTGCAGATCTCAC-1	Pericyte
CCCTAGTTCGCTGATA-1	Endo
TTACTCATCGTGGTAT-1	CM
CCGAAGCAGAGTGGAA-1	Myeloid
AACTTGGTCTTCGTTA-1	Pericyte
CAACGTATCACTGATG-1	Endo
GCCAGCAGTGTCCCAG-1	CM
ACGGATTGTGCATTGT-1	Endo
TTGACGAGTCAACTGT-1	CM
AAACGAAGTGATAGAT-1	Pericyte
AACGAGGGTCCTATTT-1	Endo
CCTATTAAGAATCAGT-1	Myeloid
ACAGCGCTCCGTACGG-1	vSMCs
CCCTGATGTCACAGGA-1	Endo
AATGTCGAGTACAGTA-1	Fib
TGTACAGTCAGGAATA-1	Pericyte
TATCGAGGTACGCAAG-1	Endo
GGGTCTGAGAGAACCC-1	CM
TAGACTGCACAGCCAC-1	vSMCs
CATTCCGTCTTCCACG-1	CM
GGAGTAGTCGCGCCAA-1	Endo
TACATTCGTTTAGAAG-1	Fib
CCACAGGAGGAGGCGA-1	Pericyte
CACAGATCACTCGTGG-1	Pericyte
TCTCAGCTCGATGTGT-1	Endo
CGCAATAAGGGACGTT-1	Pericyte
CTCTAGCTCCCGCAAG-1	Endo
CCAATGAGTTCTTAGG-1	Pericyte
GTCTACCAGCCTGTAT-1	Pericyte
GTCGTAACATTCCCGT-1	Pericyte
CTCAGAATCTCTATTG-1	Pericyte
ACAGCGCTCTGGCCAG-1	vSMCs
CCTAAAGGTAACTCCA-1	Pericyte
ACTTTCAAGAGAGTTT-1	Myeloid
GAAACAACAAGATTAG-1	Endo
TGTTAGGTCTGTTGCC-1	Pericyte
ATCGAGTTCCAGTACA-1	Pericyte
CACATGAAGTCGACCC-1	Endo
CCTAAAGAGCAATAAC-1	Endo
TCAGCTCTCAGCCGAC-1	CM
CTGCTCAGTCTGGATT-1	Pericyte
GTGTGATCAATAGTGA-1	Neuronal
TTGCAGAGTGTGTGTT-1	Pericyte
CCTTGGTTCCATAACG-1	Endo
AACGGGAAGTCAGCCC-1	Myeloid
TTGCACCGTTAGTAGA-1	Pericyte
TTGCTTATCGCTTACC-1	Endo
TTGGTCCAGTGATATG-1	Endo
TGTTAGGAGAAGGGCG-1	Fib
TCGGGACGTAACTCCA-1	Endo
CTGCGTTTCAACGTGT-1	CM
TGAGCCGCAAGAGATT-1	vSMCs
TTGTCTAAGCCCATTA-1	Endo
GGGACCTTCGCCACTT-1	Myeloid
AGTTTGGCATCGGCCA-1	Endo
TGATTTCCATCATGTG-1	Endo
TGTAAGCGTGCTTCCT-1	Pericyte
GTCACGGCAAGTTCGT-1	Pericyte
TTGCACCAGTACGACG-1	Fib
CTCTACGTCGTAGCGC-1	Pericyte
GTAGGAGGTTACGGAG-1	vSMCs
TACTGCCAGTATACGA-1	Myeloid
TACCCTGCAATGCCAT-1	Myeloid
TGTAAGCCAGCGCGTT-1	Endo
CCAGAATGTTCCCAAA-1	Pericyte
GACCTTCCACGCGACT-1	Endo
GGCATTATCATTCATC-1	Endo
AAGGTTCGTAGAAGCC-1	Endo
CGAGTTAAGGAGAACA-1	Pericyte
TACATGGGTGATCAGG-1	Endo
TCAATTCAGAGGCCTA-1	Pericyte
GCAACCGTCGCTTGAA-1	Pericyte
GACTAGTGTCGACTGC-1	CM
GTGCTGGGTTTGTCTT-1	Myeloid
TGGCCTTCAAAGGTCG-1	Myeloid
TTTGGTTCACAAGGGT-1	Pericyte
AAACTCGGTAGAAAGG-1	Pericyte
TGATCAGGTATTCACG-1	Pericyte
GATCGTAGTGGGTAGT-1	Endo
TTCATTGAGGTTGTTC-1	Endo
CTGCTCAGTGGTGGTA-1	Endo
CTAACTTGTGCTTCCT-1	Pericyte
CAGCTGGAGAGCAGCT-1	Pericyte
ATTGTGGGTCATTGGT-1	Pericyte
ATGTTTCGTGCTAGTT-1	Pericyte
CCTTAATTCTATACCT-1	Pericyte
GTCCATCTCCATAGGT-1	Pericyte
TGGGTGCGTCCCTAAA-1	Myeloid
TCAAGCACAAACCGAG-1	Pericyte
GGGTTATAGTAATGTG-1	Pericyte
ATCGAGTGTTTAAGCC-1	Pericyte
CTTAATCGTTCTTATC-1	vSMCs
GAACTTGTCGCCACTT-1	Pericyte
TTGCACCGTACGGTTT-1	Fib
GTTATGGAGATCGCCC-1	Pericyte
GGAGGATAGCACACCC-1	Pericyte
TTGACGAGTCATCGTA-1	Endo
CAGGGCTAGGTTCTCA-1	Endo
CATAACGTCGGTCGAC-1	Pericyte
GCCTAGGTCCCGGGTA-1	Endo
AACAGTCTCTCCTTGG-1	Pericyte
GATCATGCATTAAGGA-1	Endo
CAAAGCTAGTGAAACT-1	Pericyte
CACAGATCATAGCCAT-1	Pericyte
GCGGTGTAGCTTCAAC-1	Pericyte
ATTGTGGTCAGGCCGT-1	Endo
GGCGAAAGTTTGACCA-1	Lymphoid
ACAGAAAAGAAAGCAG-1	Endo
AGATTCGCACTCGTGG-1	Myeloid
TACTGCCTCGGTCTAA-1	Endo
CCTCCCTAGGTACTCT-1	Endo
ATCCCTGAGTGAAACT-1	Pericyte
CATTCCGTCGGTCTAA-1	Pericyte
GACCAATGTGGACTGA-1	Pericyte
GCGGGTTCAGACCTGC-1	Pericyte
CCGTAGGCATGCCTTC-1	Endo
AGCGTATGTATGGATA-1	Pericyte
TAGTCCCTCTGTGTGA-1	Pericyte
CAACCAACACGCTAAT-1	Pericyte
GGCATTATCCTGTGGG-1	Endo
CTTGAAGTCGGATAAA-1	Myeloid
CCATACCGTTTGATCG-1	Endo
GTCACCTAGTTAGCGG-1	Endo
GTCACAACATTTAGGC-1	CM
TCGATTTGTTTCTACT-1	Pericyte
GCATTCCAGGCTGGAT-1	Myeloid
TTCATCAGTTTGAAGA-1	Endo
CGCTAGGCAAAGGAAG-1	Endo
CGAGTTACATTACTCT-1	Myeloid
TAATTCCAGTGTCGGA-1	CM
CCTTGGTCAAGCAGGT-1	Pericyte
CTCTCGACAATTGTGC-1	Pericyte
TGAATCGTCGTAGCGC-1	Myeloid
CACAACAAGCTGGAGT-1	Myeloid
CTCAACCCAGCAACGA-1	Myeloid
GGTTGCGAGCATGTGG-1	Endo
GAGGATGAGTGAGCTG-1	Myeloid
CCATACCAGGCCTCTG-1	Endo
GGTTGCGAGAGGTACC-1	Pericyte
TAAGTGCCATGCACTA-1	CM
CGTAAACTCCATTGTT-1	Neuronal
TGAATCGTCATTCATC-1	Pericyte
TGGTCAAAGCAGGACT-1	Endo
TACGCCTGTTCCAGTA-1	Endo
GCGGGTTAGCGATACG-1	Pericyte
TTATGTCGTCCGGTAC-1	Endo
GAGATTCTCGTCCCAT-1	Lymphoid
AGATAGAAGTACAGAT-1	Lymphoid
GAATCTGGTGCTGTCG-1	Pericyte
CCTTAATGTGGCCTTG-1	Endo
TTACCCGAGTACTCTG-1	Endo
GGAACTTAGTTACCAC-1	Endo
TACAGCACAGCGTAGA-1	Pericyte
TTACGTTTCTCGGCGA-1	Endo
CCCTAGTGTGGCGCTT-1	Pericyte
CTCTAGCCAAAGAAGG-1	Pericyte
GGGTCTGAGGGTTCTT-1	Endo
ACCAAACTCTAGCTGA-1	Endo
TAGCCGGTCATCGCTC-1	Endo
CAGCTGGTCACTAGCA-1	Pericyte
TCAAGGTAGAACAGGA-1	Endo
GCGGGTTGTTCCGCGA-1	Pericyte
TCCCACAAGAGCTGTG-1	Pericyte
TGCCTCAGTTAAGGGC-1	Endo
TAACTTCGTTTGTAGC-1	Pericyte
CCAGATATCTAGTCGA-1	Lymphoid
TGCCTCACACAGGAAC-1	Endo
ACAGCGCCAACTCGTA-1	Endo
TCGCAGGCAATGCACT-1	Pericyte
TCGCCTACAGCAACAG-1	Endo
ATGGATCAGCCATCAT-1	Endo
ATATTCCAGCTGATTC-1	Endo
CATTCCGCATTACCTT-1	Myeloid
TCGTTCGCAAGGGAGG-1	Pericyte
AATGCCAGTAGGTAAT-1	Endo
ATCCTGCAGACCCATT-1	CM
TTACTTGAGCGAGCTA-1	CM
AACCTTTGTACCAAGG-1	Endo
CGCGCAATCGCATAAC-1	CM
CTCGCTACAATCCATG-1	Endo
TGTGTCCTCGCTATAG-1	Endo
ACATGGTTCTGCGTCT-1	CM
GATCATGAGTCGTGAG-1	Lymphoid
TTGAGTGGTGAATACA-1	Myeloid
TTGCAGAAGCTGATTC-1	Endo
GAGTGAGAGTACCTCA-1	Fib
TACTAGGGTTCCATCC-1	Pericyte
TACATTCCAGGTCCTG-1	Myeloid
TTGTCTAAGCTCGTTA-1	Endo
GAGACTTAGTGTCACT-1	Pericyte
CATGTTTTCTCTTCCT-1	Pericyte
CAAGAAACAGTGCGAA-1	Endo
TAGACTGGTTTCGTTT-1	Endo
TCAAAGCAGAACGACC-1	Myeloid
ATGTTTCTCTCCTTAA-1	Endo
AGCCTCTAGGCAGTAC-1	vSMCs
CGTACAATCACTAGCA-1	Pericyte
ACTGCGGAGGTCTTGT-1	Endo
TAACGGTCAGTAGTTC-1	vSMCs
TGGACATGTAGCGTTT-1	Lymphoid
CGGTGCAAGGCTAAAT-1	Lymphoid
CCTTGGTAGCTGAAAT-1	Pericyte
AGACAAAGTCCAAGAG-1	Endo
TCCATCGCACTCCCAT-1	Lymphoid
GCATGATGTCCCTTTG-1	Pericyte
AGCCTTCTCCTTCGAC-1	Endo
ACCGCAGAGAGTTTGA-1	Pericyte
CCAATGAGTGTCTACA-1	Endo
GTCCATCGTTCTACCC-1	Pericyte
TACCTCGAGTAATCAG-1	Endo
ATCCTGCCAATTGCCA-1	Pericyte
TGACAACTCAACTTGG-1	Endo
TCAAGGTCAAGGTTCT-1	Myeloid
TATCTGTAGGGTAATT-1	Pericyte
CCGTAGGAGGAGTACC-1	Pericyte
TCGAGCGGTGTTGGTT-1	Myeloid
GAACTTGAGTGAGCAC-1	vSMCs
GCACGGTCAAGGGAGG-1	Endo
GGAGTAGTCAACTTGG-1	Endo
GTTGGTAGTACCTATG-1	Endo
ATCCCTGCAGGTGTGA-1	Lymphoid
AACAAAGGTTGGTAAA-1	Fib
GCGATCGGTAGCGTTT-1	Pericyte
AACAAAGTCATAGGTC-1	CM
GCGATCGTCCTCCTGA-1	Lymphoid
AAAGGATGTTGGCTTA-1	Lymphoid
GCGATTATCCACGGCA-1	Pericyte
TAAGCCATCGCCTTAC-1	Pericyte
TTCTAACGTTCTGAAC-1	CM
GCAGCCACACCTACCT-1	Myeloid
TGCTCGTCACAACGGA-1	Endo
CGCTATCTCCAGGGAA-1	Myeloid
CATAACGAGTTCGTTG-1	Endo
CGATGATCACCAAGGA-1	Endo
CGAGTTAAGTGTAATG-1	Endo
GCGTTGGGTAACTCCA-1	Endo
ACGTGGCTCTCTTCTC-1	Endo
AGCGATTGTAAGGTCG-1	Pericyte
TAGGAGGAGTGCTGAG-1	Myeloid
ACCGAATGTTAACTCG-1	Endo
CCCTAACAGAGGTCCA-1	Pericyte
GCTCCTACACGGTGTC-1	CM
CGCTATCTCCATGACA-1	Endo
TCTATTGCATGGGAAC-1	CM
ACTATTCGTTGCCGCA-1	CM
AAGGTTCAGAAGACTT-1	Pericyte
GTGTCCTCACTGGGCT-1	Lymphoid
TTACGGACAAGAAACT-1	Myeloid
CAACGGCAGTATGGGC-1	Endo
GGTACCGCAAAGCTGG-1	Pericyte
GCGATTATCTCAGATG-1	Endo
TTGCACCAGGAAACTT-1	Myeloid
TGGTCCTGTGCAGACA-1	Endo
ATTACTCAGCTCGTTA-1	Endo
AGTGCGCTCCTTCGAC-1	Pericyte
GCGATTAGTGATGCGA-1	Endo
GCGGAAAGTTAACTCG-1	Pericyte
TCAGTTTCAGAAGTGC-1	Endo
GCCCAGATCTGGGCGT-1	Endo
GGGCCATCATTAGCAC-1	Neuronal
GAGATTCCACTCGGAC-1	Endo
CAACGTAAGTTGCGCC-1	Endo
GAACCTAAGAATAGTC-1	CM
TCCCACATCAAACCAC-1	Lymphoid
CATGTTTAGGCGACTA-1	Myeloid
GTGCCAGGTCAGCAAG-1	Pericyte
TGATTTCGTCGTCGCA-1	Pericyte
CGCAATAGTCAACAGG-1	Endo
GCAGCCACAGATTAAG-1	Pericyte
CAACGGCAGTCTTAGC-1	Lymphoid
AACAGTCCATGGTATC-1	Pericyte
TGGTCCTAGTGAGTGC-1	Endo
GCATGATGTTTCGATG-1	Endo
ACTGCAAGTTCCGGCA-1	Endo
CCTTGGTTCCAGGCCA-1	Endo
TTCAACTCAGATTGTC-1	CM
TACGCAATCTAAACGC-1	Pericyte
GAAAGTAGTTCTTATC-1	Endo
CGATGATTCTCTGAGA-1	Pericyte
CTAGGGCGTAAGTGCG-1	Endo
TATCTGTTCTCGTGAA-1	Endo
TTGTTCACAAGGCGTA-1	Lymphoid
GAAGTCTGTGCTGGCT-1	Lymphoid
GCTGAGCAGCCGCTGT-1	Pericyte
ACCATCCCAATCCATG-1	Endo
CTCAGAACAGATTGTC-1	CM
TTAGCGATCACGGGTC-1	CM
GGGAACAAGAGGTACC-1	Endo
GCTCACTAGCAGAATT-1	Endo
TTCGTTATCGAAGCCC-1	Myeloid
CAACGGCAGCCCATGC-1	Endo
GACCGACTCTCATATC-1	Endo
TGCTATTCACCGTCTT-1	Pericyte
TGAGCCGTCGCTTGAA-1	Lymphoid
GGAACCCCATTACTCT-1	Pericyte
TACCCTGCAAGACACG-1	Myeloid
TGGGTTACACTGTCAA-1	Endo
ACATGGTGTGCGTGTC-1	CM
TAACTTCTCAGTAGTC-1	Endo
TGGTCCTCACGACGAA-1	Lymphoid
ACAATCGGTGCGCATC-1	Endo
CAGTATGAGTGTAATG-1	Endo
ACTGCAAGTGAGAGTC-1	Pericyte
TCAGGGCAGTACCTCA-1	Lymphoid
TCGGGACGTGTCGTGC-1	CM
ACTGCGGCAAGGAGTC-1	Myeloid
ATGTACGAGTGGACGT-1	CM
TCAAAGCTCGATAGGG-1	CM
CATGCCTTCTAAGGTC-1	Pericyte
CGCGCAATCTGGCCAG-1	CM
GCGCATGAGGATTGCG-1	CM
TAGGTGTCACAGATGG-1	CM
CTCGCTACAGCAACCC-1	CM
GTGTCAAGTAATGCCT-1	CM
GTACTTTCACCGTCTT-1	CM
AAACTCGGTAATGTGA-1	CM
CGGACCAAGGTAGGAA-1	CM
CCCTAGTGTAACATAG-1	CM
CTGTTCGCAATTCTCT-1	CM
TGCATGAGTGGACTGA-1	CM
GCGCATGAGAGAACCC-1	CM
CTGCTCACAGCCACGT-1	Fib
CAAGCTAAGGTACATA-1	CM
TTGCTTATCTATCCTA-1	CM
TTACCGCCATATAGAG-1	CM
TTGACGACAGATACAA-1	Pericyte
TCAGTCCGTAATGCAA-1	CM
TGTGTCCAGGAGAACA-1	CM
TACCTATAGGAAGGTA-1	CM
