Barcode	cell_type
AGATTCGTCGGCTATA-1	CM
GCCCGAAGTCGTAATC-1	CM
CTGTTCGCAGCTTACA-1	Fib
TGTGGCGTCTATTTCG-1	CM
TTCTAACGTCTTAGCA-1	CM
AACCAACCAGTTACAC-1	CM
GCTCAGGTCAAAGTAG-1	CM
TAGCATGCAAGGAAGA-1	CM
GGTACCGAGAATATCG-1	CM
CACCTTGTCGAAGCCC-1	CM
TATGTTCCAAGTAATG-1	CM
TACCTATCAATGCCAT-1	CM
TTGCACCGTGGAGTGT-1	CM
TGCATTTGTGCTTGAT-1	CM
CCCGTTAAGAAGCCGT-1	CM
ATTACCTTCCATCGAA-1	CM
TGTGTCCTCAAAGTAG-1	CM
AACAAAGTCAGCACTA-1	CM
GCGTTGGAGCTTACCA-1	Fib
GTCCATCCATGCGTTA-1	CM
CTAACTTAGGCTTCGC-1	CM
TCACAAGTCGTCGCAG-1	CM
GAACCTAAGGTGAACC-1	CM
TGGGTGCCAATGTGCT-1	CM
TTGCAGAAGCAATAAC-1	CM
ATGTTTCGTTACGCTA-1	CM
GCGATTAGTGGACTGA-1	CM
AATACGCGTTTCTTAC-1	CM
ATGCATGGTACGGATG-1	CM
CGATGATAGCTGGAGT-1	CM
ACCGCAGCACAAGTGG-1	CM
AAGGTTCCAATCCATG-1	CM
TAGTCCCGTGGTGGTA-1	CM
TGGGTGCAGGAACCGT-1	CM
TTACGTTCACTCAGCG-1	CM
TAGCTTTCATAGCAGG-1	CM
ACCAAACCAAGACTTC-1	CM
CCATACCCAGGCATTT-1	CM
GAGACTTCATGGTTTG-1	CM
CCCTCTCAGAGCTACG-1	CM
GGTGAAGGTGGTTCTA-1	CM
CAGGATTGTCATGAGG-1	CM
ATTCGTTTCGAGGTAG-1	CM
CCAATGACATGCACTA-1	CM
TATTGCTTCGAGGTCC-1	CM
AATGGCTTCAAGGCAG-1	CM
TCGATTTCAGATTTGC-1	CM
TGTAAGCCACATCATG-1	CM
TGAATCGAGTCGCCTG-1	CM
TCAAGGTGTCACAGGA-1	CM
AGGCCTGCAGAACAGC-1	CM
GGATAGGAGCAGGACT-1	CM
TTAGCTTTCGCATAAC-1	CM
CACCTGTTCTGGTACA-1	CM
TACGGATTCCACGCTT-1	CM
TCGATTTTCCTGAAAC-1	CM
TACAGCACACTCAAGT-1	CM
CACAACACAGGCACAA-1	CM
GAACTTGTCTTACTCA-1	CM
TCAAGACAGTAGTCGG-1	CM
AGATAGACATCGCTAA-1	CM
CAAGAAAAGTGAGCAC-1	CM
CGGTGCACATGGGAAC-1	CM
TACTCGCTCATGAACC-1	CM
GCTCGAGGTCACAGGA-1	CM
TAACGGTAGTCCCGCA-1	Myeloid
TGATCAGCAGTAACTC-1	CM
ACTCGGGAGCTTCAAC-1	CM
GAGAACGTCTGAACGT-1	CM
CTAGGATTCATTCTCA-1	CM
CAGGGCTGTTTGCGAT-1	CM
GCTTTCGTCTGGTACA-1	CM
CCGTAGGGTCCAAGTT-1	CM
TGCTCGTAGCTAGTTC-1	CM
ACTGCAAAGGTAAGTT-1	CM
ACAAACCAGACGCCCT-1	CM
ATCGAGTAGAGGTCCA-1	CM
CAGGATTTCATGTTCT-1	CM
GGAGAACTCATCATGG-1	CM
AGGCCCAAGGATGTAT-1	CM
AAACGAACAATGGTCT-1	CM
TTTGGCCTCGATATGC-1	vSMCs
GTCACTCAGGTGTTGG-1	CM
TCGAGCGCACTGTAAC-1	CM
ATTCGTTAGTCCCTCT-1	CM
GAGATTCTCAAGGCAG-1	CM
TGTACGAGTACCCACG-1	CM
GTGTGATCACGTTAGT-1	CM
CCCTGATTCCAATCCC-1	CM
CAGTGCGTCAAGGCAG-1	CM
GCACCTTGTGAGCTAG-1	Endo
GTGTCAACACTCAGCG-1	CM
GACTAACCAACGTAGG-1	CM
ACTGCAAAGTTATGAG-1	CM
AATGCCAGTGACCAGA-1	CM
TTCGGTCAGTACAGTA-1	CM
TTTGTGTTCGCCAGAC-1	CM
CTACTTACAGTTGGAG-1	CM
CGTGGCATCTTGGCCT-1	CM
TCGATTTAGGATTGCG-1	CM
TGCATGAAGTCATCTG-1	CM
CTCTAGCCATTCACGA-1	CM
TTGTCTATCTATCTTG-1	CM
ACAAAGAAGCACGTAG-1	Endo
CTCCCAAAGCGAGAAA-1	CM
ACCATCCGTCCGTAGC-1	CM
ACATGCACAACTCGAT-1	CM
GGACACCAGTAATGTG-1	CM
GTCCATCGTGGACGAT-1	CM
TCTATTGCATGGTATC-1	CM
TTACGTTTCCGGCGAT-1	CM
GGATGAGCATCACAAC-1	CM
CCGTGAGAGAAATGGG-1	CM
CAGTGCGTCTGTGTCC-1	CM
TTGCGGGAGAGGAAGT-1	CM
CACCTTGCACGCTGTG-1	CM
TTTGTGTCACAACGGA-1	CM
CTCTCAGGTTACGGAG-1	CM
GCAGATTTCCTTCGAC-1	CM
TCAGTTTGTATCAGCT-1	CM
CAAGGCCAGTGGTGTG-1	CM
GTAGGAGTCGAGAACG-1	CM
GCCAGACAGAGACTCG-1	CM
AATGGAAGTGCATCAT-1	CM
ACAAGCTGTTCCGCGA-1	CM
TTTGTGTTCGGACGAA-1	CM
TGCATTTGTGACAAGC-1	CM
GATTGACTCCGTTAGA-1	CM
GCTCCTAAGGTCGGTA-1	CM
TAGACTGCAGGGTACA-1	CM
CCAGATAGTTAGAGAT-1	CM
TGCATGACACCACGAC-1	CM
GCGTTGGCACATAAAG-1	CM
AGCCAGCGTGCTTCCT-1	CM
TGGTCAAAGGATTAAC-1	CM
CTCTCGAGTTCCCAAA-1	CM
TTAGCTTGTGTGACCC-1	Fib
TCACTCGTCTAGCTGA-1	CM
TTGAGCAAGTCTCGAT-1	CM
GCGCCAAGTAATGCAA-1	Endo
GCGATCGGTTACGCTA-1	CM
CCGTACTTCTTCGTTA-1	CM
ATCCCTGGTGTTAGAA-1	CM
TTCGCGTGTGCTGTCG-1	CM
TTACCCGAGGCAAGGG-1	CM
TGAGTCACATCCTGGG-1	CM
TGCTCGTTCGATCGCG-1	Endo
AACGAGGTCGCCGAAC-1	CM
ACAAAGAAGCAACGGT-1	Myeloid
TGCATTTCAGCGTCGT-1	CM
AGCTGATGTAGTATCC-1	CM
GTAATCGCATCATCGA-1	CM
TCTATTGCAATGCACT-1	Fib
GCCAGACCATTTCACT-1	CM
AGCGTGCAGTTCCAGT-1	CM
GCAACCGTCGGCAATT-1	CM
GCAGCCATCTACTGCC-1	CM
GTCGTAACAGGTAGGT-1	CM
TTGTCTATCTGTCGGG-1	CM
CGCTATCAGTGAACCG-1	CM
GTCACAACATGTGGGA-1	CM
GGTAGGAGTGGAAAGA-1	CM
TGGTCAAGTTTAGACC-1	CM
AGCCCGAAGGCTCCTG-1	CM
GTCACAAGTGTGCTTA-1	CM
CAGGGCTTCACTAGGT-1	CM
CGATGATCAGACCTGC-1	CM
CACCTTGAGTTGCTTG-1	CM
ACAGACTCAATGGTCT-1	Endo
CACAGATAGTTCAGGG-1	CM
TTGCGGGGTCGTCGCA-1	Myeloid
GCAGCTGAGCTGCTCG-1	CM
TACTAGGGTCAGTGTT-1	CM
ATGCATGTCATTCGGA-1	CM
AGCTGATGTTCCAGTA-1	CM
TGGCGCACAAGTCTGT-1	Fib
TTCGGTCGTCAACTGT-1	CM
GGGTTATAGGCAAGCT-1	Endo
GTGACATAGTCCGGAA-1	CM
TGGTCCTCACATTCTT-1	Endo
ATTTGTCGTAGGTCTT-1	CM
CCATACCAGTCGTGAG-1	Endo
GAGCGCTCAATCACTG-1	CM
CAGGATTAGGAGAACA-1	Fib
GGGAACATCTTGTCGC-1	CM
AGGCGTCGTACTAGAA-1	Myeloid
TTACTTGTCAGTCACA-1	CM
ATCGAGTAGTCGTATC-1	CM
GCCAGACTCCGAGGAA-1	Fib
GCGTAGCGTTCTACGA-1	CM
ACTACCCAGTCGCCTG-1	CM
CGCTGGAAGAGCACTG-1	CM
CCTTGGTCAGACCTGC-1	CM
TTACTCAGTGCGTTTA-1	CM
TCAGGGCCAGTCAGCC-1	Endo
TCAGTTTCATGCGTTA-1	CM
AAACGAAAGGTTGTTC-1	CM
GTCACAACACGCGATC-1	CM
AGCCAGCCACTAAACC-1	CM
TGCTCGTAGATTCCGT-1	CM
AACAGTCAGGTTAACA-1	CM
GCATGATAGTCTCGAT-1	Endo
TAATCGGCATCTCTCG-1	CM
CTAGCGGTCGGGACAA-1	CM
ATGTTTCGTGCATTCA-1	CM
GCCCGAACATCATGTG-1	CM
TTAGGTGTCTGGCTAA-1	Myeloid
GACCCAGTCTTAATCC-1	CM
CCACGTTGTTTGCATG-1	CM
TATGTGGGTGCAAAGC-1	Myeloid
GCTGTTCTCACCACAA-1	Fib
CAAAGCTGTCAGTGTT-1	Endo
CCTGGGATCTTTCGAT-1	CM
TTGTTGTTCAGTGTGT-1	CM
CCTGGGATCTCCCTTT-1	CM
AACTTGGAGGCACTAG-1	CM
GCGAGAATCCGGAAAG-1	Fib
GGTGTCGCAGGCTACC-1	CM
GGATAGGTCATCGCTC-1	CM
GAGGTCCGTCGTCGCA-1	Fib
TTGCAGACACATTGCA-1	CM
GGGTCTGCAGTAGTTC-1	Fib
AATGTCGAGGTACATA-1	CM
CAGCTAAAGCCTATAC-1	CM
GGTGCTGAGCATTCCA-1	CM
CATAACGCACGCGACT-1	Endo
CATTCCGAGGAGTAGA-1	CM
CTCGCTATCAAACCCA-1	CM
GCATTCCTCCAGAGAG-1	CM
GCTCAGGTCAAGTTGC-1	CM
TTGCACCGTAGCAGGT-1	CM
CTACTTACAAGGTTCT-1	CM
CCTGGGAGTTAGGAGC-1	CM
ATAGTCGAGGGTCCCT-1	CM
GGACACCTCGACGGAA-1	CM
AGGCCTGTCCGCGATG-1	CM
GGGCCATTCTGTTGCC-1	CM
TTAACGGTCCCGTATC-1	Lymphoid
CTGCGTTTCTGAGTCA-1	Endo
TGTAGCACAAACCGAG-1	Myeloid
AGTGCCGTCGTTACAG-1	CM
GTTGGTACAGGATAGC-1	Endo
TTAGCGAAGAGTTTGA-1	CM
CAGTGCGGTAAGCCGA-1	Fib
CTCAACCTCCATCTAT-1	Endo
CTCTCGACAACTGCGC-1	CM
CAAGAAATCGGTAGGA-1	Pericyte
ATGCATGAGTGAGCTG-1	CM
TAGGTGTTCGCTAGTA-1	Endo
ATAGGCTCAAAGGAAG-1	Myeloid
CCTTGGTCACGCTGTG-1	Myeloid
TAATCGGCAACGTAGG-1	Endo
TGCTCACAGATGCGAC-1	CM
CTACTTATCTGGCGCA-1	Pericyte
GTTACTTTCGACTGGC-1	CM
TCAGGGCAGTGCTGAG-1	CM
TAGCCGGGTGGAAAGA-1	CM
AACAAAGCATAGAATG-1	Myeloid
GTTATTCAGGGTGTTG-1	Endo
GAAGAGCTCATGCTTT-1	CM
AACGGGACACTGATTG-1	CM
AGTGTACCAGCACATT-1	CM
TAGCGGCCACCTGTGG-1	CM
AGCTGGCAGATCGCCC-1	CM
TTTGTGTCAGCGTAGA-1	Myeloid
GTTCAAGGTGCGTCCA-1	CM
TACTAGGTCGCACCGA-1	Myeloid
CTGTTCGTCACAGGGA-1	Pericyte
TTACGTTGTCCAGACC-1	Myeloid
GTTGGGCGTTTCCTAT-1	Pericyte
TTGCGGGGTCATAAGA-1	Fib
CCTTAATTCTTACCTA-1	Endo
GCTCACTTCTTTATCG-1	Pericyte
CTCGCTATCGCTTGAA-1	Endo
GGTGCTGGTATCTGCA-1	Pericyte
CTCTAGCCAGATTTGC-1	CM
TGACAACAGACTAGGC-1	CM
TAAGCCACAGTAACCT-1	Neuronal
AGCCTGGGTCTGATTG-1	Fib
AACAGTCTCGCAGATT-1	CM
AAATGCCGTTAGAGAT-1	Endo
TGGGTGCGTGTTGTTG-1	Endo
TAGGTCAGTCCACCAG-1	Myeloid
AACGAGGAGCAGTAGC-1	Lymphoid
TCAATTCGTTGGGAAC-1	Myeloid
TTCTAACTCGTTCCGT-1	Endo
CAGCCTTAGGGCATTG-1	CM
CTCTCAGAGTTAGAGT-1	Endo
TGACTCCAGGATTTGA-1	Endo
ATGTACGAGTCATCTG-1	Fib
CCTTGGTGTCAGAGTG-1	Pericyte
TAGTCCCAGGCGACTA-1	Fib
ATGTCGATCGGGACAA-1	Myeloid
GAGGCTCGTTCCCTTG-1	Endo
TAGGTCAAGCCGCAAA-1	Endo
ACCTGCTTCCGATGCG-1	Myeloid
CCCTGATGTATCTCAG-1	Pericyte
CTTAATCTCAGAGTGG-1	CM
GTGCACGAGATTGACA-1	Fib
CTGGGACGTCATAGCT-1	Myeloid
AGTGTACCAGGTCCTG-1	Pericyte
GAGGATGGTGAGCTAG-1	Pericyte
ACCATCCAGACCAATA-1	Myeloid
TTCGGTCGTGGCCTTG-1	Myeloid
TTCTAACCATTGCACA-1	Myeloid
AAAGATGCATTCTCGC-1	Fib
TGCGTAAAGCCCATTA-1	Fib
TCACCTGGTGCACTTA-1	Fib
AATACGCGTGTCCCAG-1	Pericyte
TTGGTCCTCCGTGCAG-1	Pericyte
GACTAACGTGGACTGA-1	Endo
GTGGCGTCAGTATACC-1	Myeloid
GCCATAAGTTCCGCGA-1	Endo
TGATTTCAGGTTCGAG-1	Endo
AAGGTTCGTCGATTAC-1	Endo
TATCGAGGTGCTTTGA-1	Fib
ATTCGTTCAATGATGA-1	Fib
AACGAGGAGTCGAAAT-1	Pericyte
CATTCCGCATGGAGGT-1	Fib
ACTACGAGTGTGACCC-1	Endo
CGCAGGTGTAGAATAC-1	Lymphoid
GAACCTATCTGCTACC-1	Pericyte
GCACGGTCAAGGTTCT-1	Fib
GGACACCTCTTCCAGC-1	CM
GGACACCAGAGGCCTA-1	Fib
TGATGCATCCATGTTT-1	Myeloid
GGTAGGAAGTCCCTCT-1	Lymphoid
AGTTACGTCCTATCCG-1	Pericyte
CTTTGCGTCCGTTTCG-1	CM
GAAATGATCTCTGCGT-1	Endo
TGGCAATAGGGAAATG-1	Pericyte
CACGTTCAGGTCCTCG-1	Fib
CCCTAGTCATAGACGG-1	CM
AGTTACGCACAAGGGT-1	Endo
AAAGGATGTGAATCAA-1	Myeloid
CAGTATGCAGATAAGT-1	Endo
CAAGCTATCACACGTA-1	Endo
GCATTGAAGGTTAGTA-1	Myeloid
CGTGGCAAGAAGCCGT-1	Lymphoid
CATTCCGCAACAACTC-1	Endo
TCAAGCACAATGGTCT-1	CM
GAGGTCCAGACGTCAG-1	Fib
TTACGGACACGATTAC-1	Endo
ATGCATGCACCCTTTG-1	Pericyte
GAAACAATCAGCCGGT-1	Endo
AAACGAAAGCCTCGCA-1	Myeloid
TTACGTTGTCGATTAC-1	Endo
GGTGCTGCATTCCCGT-1	Myeloid
ACCCAAACACTCGCAG-1	Endo
GGTAGGAGTAGTATCC-1	Fib
AACCTGAGTATGGTTC-1	CM
CGTTCCATCTCGGCGA-1	Pericyte
AACCAACGTGTGTGTT-1	Myeloid
CGCTATCGTAATGTGA-1	Endo
GTCACCTGTTTCAGCA-1	Endo
TCTCAGCCAATCAGGG-1	Endo
ACCTGCTAGGATGTCG-1	Fib
TTGCGAAGTCTTAGCA-1	Endo
CGGACTGGTTTGCGAT-1	Myeloid
GTCCATCAGTTCAACC-1	vSMCs
GAAAGTAAGCTAACAA-1	Pericyte
CTAGGATTCAAGGCAG-1	Endo
CAATCCCTCTTGTCGC-1	CM
GGATGAGAGAGCTCCC-1	Fib
CAGTATGAGGAGAACA-1	Endo
GCGCATGTCGACCCGA-1	Fib
CTGGGACCATCGCCTT-1	CM
TGCATGAAGGTACTCT-1	Myeloid
GAAAGTAGTCAATCCA-1	Myeloid
TACGCAATCCCAGTAA-1	Endo
GGGACCTGTACCAAGG-1	Myeloid
ATCGAGTAGAGAGTAG-1	Endo
CTCTCAGAGAAATTCG-1	Endo
CATTCATCAAACCGAG-1	CM
CCAGATAAGATATGTG-1	Pericyte
TGGCGCACATTCACGA-1	Endo
TTACTCAAGAACGACC-1	CM
TAGCGGCAGAGCGGTT-1	Endo
GGCACGTTCCACACCT-1	Endo
TCCATCGTCCCTACCA-1	Myeloid
TAGGTGTAGCATTGGG-1	Endo
TAGCTTTTCTCGCGGA-1	Myeloid
TGAGCCGTCTTCTCTC-1	Fib
TAAGTGCAGACTTCCA-1	Pericyte
AGCCTTCGTGAGTAAT-1	Endo
TCAAGGTGTAGGTCTT-1	Pericyte
TAGCTTTTCCACGCTT-1	Pericyte
GGAGTAGTCACGTCAA-1	Endo
TAGCTTTTCTGAAAGA-1	Pericyte
TAGGTGTTCATTCTTG-1	Fib
TCACTCGGTGATAGAT-1	Myeloid
AGTCAACGTCTGGTTA-1	vSMCs
GAAATGAGTCGGCTGT-1	Pericyte
ACTGTCCAGATCGATA-1	Pericyte
GCTCGAGTCTTCTTCC-1	Fib
TACCCTGGTAGGTAAT-1	Fib
ACAGCGCGTAACGTAA-1	Pericyte
CACAGATCAGTGGTCC-1	Fib
TACGCCTCACAGAAGC-1	Fib
CATAACGCATCTCACC-1	CM
ACTACGATCTTCCACG-1	Endo
TGCTTTACACCCATCT-1	Pericyte
CACCTGTGTGTAGGAC-1	Endo
TTGGTCCTCGGTAGGA-1	Endo
AGTCAACCATGACTGT-1	Myeloid
TCCCACAGTCCAACCG-1	Fib
CGTAAACCATCTCACC-1	Endo
CGGACTGAGGGATCCA-1	Endo
GCAGCTGTCTATACCT-1	Endo
ATATTCCCAACCTCTC-1	Myeloid
CTCTCGAGTGATAGAT-1	Myeloid
CTCAGCTGTTTGTACG-1	Pericyte
GGAGTAGAGAGATTAC-1	Endo
GAAATGATCAAACCCA-1	Fib
AGTCAACGTACAACGG-1	Fib
TACCTCGGTGCTTGAT-1	Pericyte
GCGCATGTCTCTTAAC-1	Pericyte
CATAACGCATGGCCCA-1	Pericyte
CTAGCGGCAAGCCAGA-1	Endo
CTAGCGGCAGGCATTT-1	Pericyte
AACGGGATCTTCAGAG-1	Lymphoid
TTGAGCACAAAGCTTC-1	Fib
CATGTTTCAATTGTGC-1	Myeloid
CGTACAATCCGAGAGA-1	Endo
CAGTATGTCCTTTGCG-1	Endo
GAATCTGAGTCCGGAA-1	Pericyte
GCGCATGCACTCCCAT-1	Endo
TACGCAATCGCTCGGA-1	Fib
GATCATGGTCACCCGA-1	Pericyte
GTTACGATCCGCTCTA-1	Endo
ATGTCTTTCGCTAGTA-1	Pericyte
AACGGGAGTCACAGGA-1	Endo
CTCATGCGTAACGGCA-1	Myeloid
CACCTGTCAATTCGTG-1	Pericyte
GATTGACGTAACGTAA-1	Endo
ATCGAGTTCGGCAATT-1	Myeloid
ACTACCCGTTTGCCAA-1	Endo
TTCATCAGTTGGCTTA-1	Fib
CTCAGCTTCCCATAGA-1	Myeloid
CCCTGATGTAGCAGCA-1	Pericyte
AGCTATGCACCTCGTT-1	Fib
TTACGGAAGATCGATA-1	Myeloid
ATGGATCGTCTGTGTA-1	Pericyte
GCGATCGTCACCCTTG-1	Pericyte
GTAGTACTCGATCGCG-1	Endo
TGGAAGGTCCCAATGA-1	Myeloid
TTAACGGAGCGAATAT-1	Endo
GTCGTAACAGGTGGTA-1	Endo
CAATCCCTCCTGTAGA-1	Myeloid
GCTTGCTGTTTGCGAT-1	Endo
CTTAATCGTCCTTCAC-1	Lymphoid
TTACTTGTCGCAACTA-1	Pericyte
AACGAGGTCCAAGAGG-1	Endo
TTTGAGGGTTTCACCC-1	Fib
CTAGGGCGTTACTACG-1	Pericyte
TACTAGGAGATCGCCC-1	Fib
CTTCTAATCTATGAGC-1	Pericyte
ATGCATGTCACAGGGA-1	Pericyte
TCAAGACTCCATCATT-1	Pericyte
ATTACTCTCAGTGTAC-1	Myeloid
GTGTCCTTCAATGCAC-1	Endo
AGCTGGCCAGCGCGTT-1	Pericyte
TGTGACAGTTTCTACT-1	Endo
GGATAGGAGTGAATAC-1	Endo
TTCTAACCAACGTCCG-1	Endo
GAACCGCGTGTTGGTT-1	Myeloid
CTCACCAGTTTCGATG-1	Endo
ACAGGCCAGGAGTCTG-1	Myeloid
CGTACAACAAGTCTCA-1	Endo
ACAGACTCAGTAAGCG-1	Myeloid
AGCTATGGTTACCCAA-1	Pericyte
TGGCGCACATCCTGGG-1	Endo
GGATAGGGTTATCGAC-1	Pericyte
ACTTCCGGTTCTACGA-1	Myeloid
AGCTGTAAGATCTCAC-1	Endo
TCCATCGCATACCCGG-1	Endo
ACCATCCTCGTTGTTT-1	Endo
TCCAGAATCCAGTACA-1	Pericyte
AACCTTTGTACATGGG-1	Pericyte
TTGTCTAAGACTCGGA-1	Endo
TGCACCTAGGTACACG-1	Endo
GCGATCGCATTAGCCA-1	Lymphoid
CAACCAAAGGTTGTGG-1	Myeloid
GTGACATCATACTGCA-1	Endo
CGCGCAAAGGCCTCTG-1	Endo
TTGACGAAGTTTACGC-1	Fib
GTAGTACTCTACATCT-1	Endo
TAGGTGTTCTATCTTG-1	Fib
GACTAACCATAGATAG-1	Endo
GGTTGCGTCTTACCTA-1	Endo
AGCGTGCCACCCTTAC-1	Pericyte
ACAGACTCACAAACAA-1	Myeloid
TGGCCTTGTTCTTTCA-1	Endo
ACAAGCTTCGACTGGC-1	Endo
GAGCGCTTCGCTACCT-1	Pericyte
TGCACCTTCTTACCTA-1	Endo
ACCGGGTGTTTGCCCT-1	Endo
AACTGTGCAAGGCTTT-1	Myeloid
TGTACGAGTGTTTCTT-1	Endo
ATTACCTCAGCGTGAA-1	Myeloid
CAGCTGGAGTCGGGAT-1	Endo
TCAAGACTCCAGGGAA-1	Myeloid
AGTCCGGCAGAGTCGA-1	Endo
TAGCTTTGTGTGAGGT-1	Myeloid
AGATTCGGTCTGGGAA-1	Endo
AGTGCGCGTCAGAGTG-1	Lymphoid
TGCTTTAGTATTGTCG-1	Endo
AATGGCTCATTAACGC-1	Endo
ACTAGGTCAATAGCGG-1	Myeloid
AGGCCTGAGTCGCCTG-1	Endo
GAGCATTTCTTCAGAG-1	Pericyte
CTACTTAAGATTGACA-1	Myeloid
TTGCTTAAGATCGCCC-1	Fib
CCCTGATAGTTGACAA-1	Fib
GTGCCAGGTTCTGATG-1	Fib
ACAGAAAAGATTACGA-1	Endo
ACCGGGTTCGAGAAGC-1	Endo
TACGGATCAGTGGTCC-1	Pericyte
AGACAAACATTAGCCA-1	Pericyte
ACAAAGAGTATGTCCA-1	Endo
TCAATTCAGACCCATT-1	Endo
CCCTAGTCAACATAAG-1	Endo
GATCGTAAGCGAATAT-1	Pericyte
ACCATCCAGGATGTAT-1	Endo
TGTGTCCCACAGTAGG-1	Fib
CCGTACTTCGATTACG-1	Pericyte
CAGGGCTAGCGTAGCA-1	Fib
TAACGGTCAGAGTCGA-1	Fib
CGGTGCATCCTGTAGA-1	Myeloid
TTAGCTTGTAACAATG-1	Endo
TTGTTGTCACGCTGTG-1	Endo
GTCGTAAAGTACAACA-1	Pericyte
CCTCCCTAGAGATTAC-1	Endo
TCCATCGGTGTCCCAG-1	Myeloid
ACAGGCCCAGTGCGAA-1	Lymphoid
GTCACGGCATTGCCTC-1	Myeloid
GGTTGCGCATTTGGTG-1	Pericyte
AATGTCGTCTATTTCG-1	Endo
TCGTTCGAGAGCGGTT-1	Fib
TCAAGGTTCAAACCAC-1	Endo
ATGGATCAGTTCCAGT-1	Endo
CGGACCATCGACCCGA-1	Endo
TCAAAGCGTAAGCCGA-1	Endo
CTGAATGGTGTCCCAG-1	Pericyte
GTCACGGGTGCAAGCA-1	Pericyte
ACAATCGAGAGTTCGG-1	Endo
ATGGATCGTGTGCTTA-1	Endo
AGGCGTCTCCCATAGA-1	Endo
ATCCTGCAGCACCATT-1	Pericyte
TGAGCCGCAAATAGTG-1	Pericyte
TATGTGGTCGATGTAC-1	Endo
TGTAGCAAGCATACCT-1	Myeloid
TAGCCGGAGGAGACTC-1	Endo
TGCTTCGAGGTTACAA-1	Pericyte
GCTTAAGCACCCTTAC-1	Endo
CACAACAAGTGCACAG-1	Pericyte
GTCTACCAGTAGTGTA-1	Pericyte
TTTGGTTCACTCGTGG-1	Myeloid
GCTTTCGCACATATCG-1	Lymphoid
CCTTGGTCAACTCGTA-1	Pericyte
CTGCTCACATGATCGT-1	Endo
AAATGAGTCCACGAGC-1	Endo
AATGTCGTCACCGCGA-1	Endo
AGACAAAGTTCCCTTG-1	Pericyte
TATGTTCCACCACAGC-1	Myeloid
TGTACGAAGTTACCAC-1	CM
AACATCGTCCACGCTT-1	Endo
CGCTATCAGGTCGTTT-1	Myeloid
TGCTTCGTCTTGTCGC-1	Endo
CACGTTCGTTTGTAGC-1	Pericyte
TAGCGGCCATCAGAAA-1	Pericyte
CGGACCAGTAGTAACA-1	Myeloid
TTTACGTGTCCTCAGG-1	Lymphoid
CAAGCTAGTGACGCAA-1	Pericyte
AATGGAACACGAACGA-1	Endo
GAGTGAGTCATCATGG-1	Pericyte
TTACCGCTCAGCCGGT-1	Pericyte
GATCGTACACGTACAT-1	Endo
CCTCCCTCATGCACTA-1	Endo
AATGGAATCCAGTACA-1	Pericyte
AACAGTCTCGCGCTGA-1	Pericyte
TAACAGCCAAGGCTTT-1	Fib
TTGTCTAGTAGCGGTA-1	Endo
TAGTCCCGTTATGCAC-1	Endo
TGTTAGGCAGCGTCGT-1	Endo
CTACTTAAGCTAGCAG-1	Myeloid
GAAGTCTTCTGGACAT-1	Myeloid
CATTCCGGTCTGGGAA-1	Neuronal
CTGTATTCAGCTATAC-1	Neuronal
TGCATTTAGGGTGTTG-1	Myeloid
ACATGGTAGTCACGCC-1	Myeloid
GAGACTTTCGACCCGA-1	Endo
TAGCCGGCAACGGACA-1	Endo
GAGGTCCCAAACCCTA-1	Myeloid
CCTTGCAAGTAGTCGG-1	vSMCs
CTCACCATCATCGCTC-1	Endo
TTCAACTGTGGTTCTA-1	Pericyte
TGGGTTACACTGCTCT-1	Endo
TTAGCTTGTTTCTTAC-1	Myeloid
AGCCTCTTCCAACAAC-1	Lymphoid
TAATTCCGTGAATGTA-1	Endo
AACTGGTGTGACAAGC-1	Endo
GTCTACCTCACGTCAA-1	Pericyte
ATCCAGACATATACGC-1	Myeloid
TATGTTCTCTCCTTAA-1	Endo
TACATTCGTTATAGAG-1	Myeloid
TACCCTGTCCCTATTA-1	Pericyte
GCGAGTCCAACTAGAA-1	Lymphoid
TACATGGAGGAGAACA-1	Pericyte
CTCATGCTCTCTTCCT-1	Fib
GATTGACTCAACTTGG-1	Pericyte
CAGCCTTGTGTAGGAC-1	Myeloid
TTCAACTCAAGGAACC-1	Lymphoid
ACTACCCGTTTGAAGA-1	Lymphoid
GTCACTCCACATAAAG-1	Myeloid
GACCTTCAGTCCCTCT-1	Pericyte
GCGATTAGTCTGGTCG-1	Myeloid
AAATGCCGTTTGTACG-1	Myeloid
GCAGCCAAGGCCAGTA-1	Fib
ACAAAGATCCCGGGTA-1	Endo
GAGGTCCAGGCCAATG-1	Endo
GGTGCTGTCGCCTTAC-1	Endo
TGTTAGGGTGTTTCTT-1	vSMCs
CACTGAAGTGGCGCTT-1	Myeloid
CTCAGCTTCTGTTTAC-1	Endo
GGACACCTCGGTCTCT-1	Myeloid
GTCTACCGTGGTAAGC-1	Endo
CACTGAAAGTAATCAG-1	Endo
TGTACGATCCCACGGA-1	Endo
TAATCGGTCAGTGTAC-1	Endo
ACGTTAGGTTTCGACA-1	Myeloid
CCACGTTAGCATGATA-1	Endo
TGTACAGTCACTAGCA-1	Endo
ATTCGTTCATTACTTC-1	Pericyte
GTCACGGGTGCGCTCA-1	Pericyte
TCAGCTCCAGTAGGCA-1	Endo
ACCGCAGCAAACCTAC-1	Lymphoid
AGGCGAATCGCGCCAA-1	Endo
ACAATCGTCAGGTCTA-1	Lymphoid
TTGAGCATCCGGACTG-1	Pericyte
GAAGTGGCACTGCTTC-1	Pericyte
AGTCAACGTGCTGGCT-1	Lymphoid
TCCGACTAGCAGGACT-1	Pericyte
TTTGGCCTCGTGGAAG-1	Myeloid
GAACGTTAGGCGTAGT-1	Endo
TTACGGAGTTAGAGAT-1	Pericyte
GCCATAAAGGGTATCG-1	Endo
CGATGATCACGCTGTG-1	Pericyte
AGCCCGACAAGTGGCA-1	Myeloid
TGCCTCATCGAGGTAG-1	Endo
TCCATCGGTTCAGTAC-1	Endo
CTCAGAAAGGTTGTTC-1	Endo
CCTTAATCACTGTCGG-1	Endo
TAAACCGGTAGACGCA-1	Myeloid
ATGCATGGTCCAAGTT-1	Pericyte
GCGGAAATCTTGGCCT-1	Myeloid
ACAATCGTCTGACATG-1	Myeloid
ACTATTCCATCGAGTT-1	CM
AGCCGCAGTTAGTAGA-1	Lymphoid
CTGTTCGGTATTCTTC-1	Pericyte
AACCGATTCCCGCAAG-1	Pericyte
CGAGTTAGTTGTGAGG-1	Endo
AGTCCGGCACCACCAG-1	Pericyte
GGTGCTGCAACGTCCG-1	Pericyte
TGCATGAAGTGCTAGG-1	Endo
TCGATTTCAAGGATGC-1	Pericyte
TCAGTCCGTGCACTTA-1	Myeloid
CAAGGCCGTGCTTCCT-1	Endo
TCCGACTAGAAATACC-1	Endo
CCGCATTCATCGTACA-1	vSMCs
GCTCAGGGTTGGAGGT-1	CM
AAGGAGCCAGATTGTC-1	CM
TTACCGCTCCATCATT-1	Endo
GCGAGAACATGATTGC-1	Myeloid
GCTGTTCCAGCACATT-1	Neuronal
TTCAACTCAGTTCGGC-1	Lymphoid
CTGCTCATCAGCCGAC-1	Endo
CTTAATCGTGTGTGCC-1	Endo
AGTTTGGTCGATAGCT-1	Pericyte
CACCTTGGTGCGACCT-1	Fib
GTTGGGCAGTTCGCGC-1	Pericyte
AGCCGCACACGCGTTG-1	Endo
TGGGTTACACAAGTGG-1	Endo
CTTTGCGGTTGGCTTA-1	Endo
GACCGACGTAGCGGTA-1	Fib
GGCGTTGAGGGTTCTT-1	Myeloid
TCCGACTCAGATTGTC-1	CM
CTTCTAAGTATTGTGC-1	Pericyte
CTCTACGTCCGGGCAT-1	Endo
AACCTTTGTTTCCGGG-1	Endo
GCAGCTGAGAGCACTG-1	Endo
CCTTAATTCTACTGCC-1	Myeloid
CTTTGCGTCGCTATAG-1	Endo
GAACCGCAGTACAGAT-1	Endo
TGTGGCGAGTCCCTCT-1	Lymphoid
CATTGGAGTAGTTTGC-1	Pericyte
GACCTTCTCAAGGCCC-1	Pericyte
TGGGTTAAGTACAACA-1	Lymphoid
TAACGGTTCAGCCGGT-1	Endo
CCCACATGTTTCGACA-1	Myeloid
ATGGATCGTTCTTATC-1	Fib
CTCCCAAGTCGACTGC-1	Fib
GAACGTTTCGTCGCAG-1	Lymphoid
TGGGTGCCATTAGCAC-1	Pericyte
CTGTTCGGTAGACGCA-1	Pericyte
AATGGCTTCCGGGCAT-1	Pericyte
TAGCCGGAGAACAGGA-1	Neuronal
GTAGTACCAGATTTGC-1	Endo
GTACTTTGTAGGGTCA-1	Myeloid
GCATTGAGTTGTCGGC-1	Endo
TTGCTATTCGGTCGAC-1	Fib
TCACAGAGTGCTTTGA-1	Myeloid
CTTTGCGAGTCGTATC-1	vSMCs
TTGTTGTCATTGCGAT-1	Myeloid
GAAGTCTGTACAAGCG-1	Myeloid
GCTTGCTGTTGTATCG-1	Endo
TGGAAGGCACTAGCCG-1	Endo
GGTGCTGGTGTCTCGG-1	Endo
AGCCTGGGTCTGGTCG-1	Endo
GCGCATGAGTTGCCGC-1	Endo
AGTCCGGCAAACCCTA-1	Endo
GAGGATGCAAGCGGTA-1	Lymphoid
GACCTTCGTAGTTTGC-1	Endo
TTACCCGGTGTCTCGG-1	Pericyte
CACAGATTCACGTCAA-1	Endo
GTCTACCTCATAGGTC-1	Myeloid
CCTTGCAGTGAGAGTC-1	Myeloid
TCACAAGGTTCAGAAA-1	Lymphoid
GGAGTAGTCCTCCCAA-1	Lymphoid
TACAGCACAAACCGAG-1	Myeloid
