Barcode	cell_type
GTGCCAGGTCAGAGTG-1	CM
AGATTCGTCGGTAGGA-1	CM
TACGCCTAGTAGTTCC-1	CM
CCCAGAGCAAACCGAG-1	CM
GACTAACCACAGGAAC-1	CM
GGAGTAGTCCTGAAAC-1	CM
TTGCGAAGTACGACCC-1	Fib
GTAGGAGAGAGAACCC-1	CM
TTGCGGGAGTAACTCC-1	CM
GAAACAACATGGAGGT-1	CM
CCGTGAGAGCCGCAAA-1	CM
GATTAGCTCATGTTCT-1	CM
CTCTCGAGTGGCCTCA-1	CM
AACGGGAGTGCATCAT-1	CM
ATTGTCTGTGTCCCAG-1	CM
GACCCAGGTAGTATCC-1	CM
CGATGATCAACCTCCT-1	Myeloid
CAGTGCGCATCATGTG-1	CM
CGTACAAAGTGTGTAA-1	CM
GTGTGATAGAGAAGCA-1	CM
ACTGTCCGTAGTAACA-1	CM
GCGCATGTCTTCCACG-1	CM
GTGGCGTTCTCCCTTT-1	CM
GAGATTCCATAGATAG-1	CM
GGAGAACTCTTCATAC-1	CM
CTTGAAGGTAACTCCA-1	CM
CAGGATTAGCTACGTT-1	CM
TCACAGAAGTTCCCGG-1	Fib
GAATCTGCATTGTGAC-1	CM
CGTGGCAGTTTGTGAC-1	CM
AGCGATTGTAACCGAG-1	CM
TGACAACTCTGTCGGG-1	CM
AACCTGAGTGTGAGGT-1	CM
GGTGTCGAGAACTAAC-1	CM
AGTGCCGGTGCACTTA-1	CM
GCACGGTGTCCTTATT-1	CM
TACGCCTTCCAATAGC-1	CM
CAAGCTAAGTTGTCCA-1	CM
CAGTGCGCATACAACC-1	CM
GCGAGTCAGATGGCAC-1	CM
GCACGCAAGGCGTCCT-1	CM
GGTGTCGTCGAAGCCC-1	CM
CGTTCCAGTACTAGAA-1	CM
GTCACTCCACCCTTAC-1	CM
GCGGGTTCATTGCCTC-1	CM
TTGCGAACAGATACAA-1	CM
ATGCATGTCACGTCAA-1	CM
ACTTCCGAGACTAGCG-1	CM
GCAACCGTCCGAGAGA-1	CM
GATTGACCAGAAAGAG-1	CM
GGAACTTTCGATGCAT-1	CM
GATTGACCACGAACGA-1	CM
CTGTTCGCAGAGCCAA-1	Myeloid
TCACCTGAGATACCAA-1	CM
AGATAGAAGTGGACGT-1	CM
TCGAGCGAGGTAGGCT-1	CM
TTAGGTGCAACGTACT-1	CM
TCGATTTAGATGTTCC-1	CM
ATGCATGGTGCGTCCA-1	CM
TACCCTGGTTCCCGGA-1	CM
GGAGGATCAATTGCCA-1	CM
CAGCTGGAGGCAAGCT-1	CM
AACCGATCATATAGAG-1	CM
TCTATTGCAGCAGGTA-1	CM
CCTTGCAGTATCTAGC-1	CM
TCAGTTTCAAATGTCC-1	CM
TAGCACAAGATCGATA-1	CM
GTCACGGCAATTCTCT-1	CM
CATAACGAGACACAAT-1	CM
TGGGTGCAGTTGACAA-1	CM
GTCTACCTCCTGAAAC-1	CM
CTACTTAAGAATACTG-1	CM
CATTGGAGTGGCCTCA-1	CM
TTAGGTGTCCCAGTAA-1	CM
ACTTCCGGTACCCACG-1	CM
CGGACTGCAAAGGCCA-1	CM
AGTGTACTCGACGGAA-1	CM
CCTGGGATCGAGAACG-1	CM
CCACAGGAGTACCCAT-1	CM
GACCTTCGTAAGTGCG-1	CM
TACCTCGAGAATCAGT-1	CM
TAAGTGCGTCGCGCTA-1	CM
TCACTCGAGTCGACCC-1	CM
CACCTGTCACTGTCGG-1	CM
CATTCATTCTATCTAC-1	CM
AGCTGTATCTTTGCAT-1	CM
TGACTCCCAGAACGAC-1	CM
TTACTCAGTCGATAGG-1	CM
AGCCTGGTCTACCCGT-1	CM
TTTGGCCGTGCTAGTT-1	CM
ACAGCGCCACGCGTTG-1	CM
CAAGGCCAGGCTCAGA-1	CM
AGCCTGGTCCCGCAAG-1	CM
ACAATCGTCAATTCCT-1	Fib
GATGATCTCCGGCGAT-1	CM
TCAGGGCAGAAGGGCG-1	Fib
TTACCCGAGTCCCGCA-1	CM
ACCTGCTAGTCGATAA-1	CM
TACAGCACAAGGAACC-1	CM
CTAGGATGTTATGCAC-1	CM
GTAGTACCATGCCCTT-1	CM
GGCGAAAAGTTCGTTG-1	CM
AAAGATGTCACTAGCA-1	CM
AATGGCTGTGAAACAT-1	CM
AGCCTTCAGTGAAGGA-1	CM
GGAACCCGTTTGTCTT-1	CM
AACTGGTAGACTTCCA-1	CM
TTGGTCCAGCTCCATA-1	CM
TTTGGTTAGTAGTTCC-1	CM
TACATTCGTGCTGAAG-1	CM
TGCGTAAAGGTTCGAG-1	CM
TCGCCTACAAGAGCGT-1	CM
TTGCGAACAAAGAGAG-1	CM
CTCAACCCAATTGCCA-1	CM
TAACAGCAGACGCCCT-1	CM
CCCTCTCCACATAAAG-1	CM
AGCCTTCCACTCGGAC-1	CM
TGCATTTCAATGGTCT-1	CM
TAGCATGCATGTCCCT-1	CM
GAACCGCAGATAGGTT-1	CM
TCGTTCGTCCGTGCAG-1	Myeloid
TTACCGCAGTACAGTA-1	CM
GATCATGTCTATCTTG-1	CM
TGGTCAAAGAATCAAC-1	CM
ACATGCACAGTTGCAT-1	CM
CCCTGATGTTTCTACT-1	CM
TTACTCATCAATGCAC-1	CM
ACTATTCAGGCTTAAA-1	CM
CCGCATTAGCAACGGT-1	CM
AACCAACAGAAATCTG-1	CM
TAAGCCAGTCAACTGT-1	CM
ACTCGGGGTCCTTATT-1	CM
GAAATGAGTAGCAGGT-1	CM
ACAATCGAGGAAACTT-1	CM
AAATGCCCACCACCAG-1	Endo
GCCATAAAGGTACACG-1	CM
AAACTCGTCATGAACC-1	CM
CCTAAAGAGTTATGAG-1	CM
CAAGCTATCGATGAAA-1	CM
CCCTAACGTCAATACC-1	CM
GGCACGTAGAAATGGG-1	Endo
TAATCGGTCGAACACT-1	CM
GGGACCTGTATTCACG-1	CM
TCCCACAGTCTGCGCA-1	CM
TTGCACCAGCGTGTTT-1	CM
CTGTATTTCGTTCTAT-1	CM
GACCCAGCAGACCTGC-1	CM
AAGGTTCAGTCCGATT-1	CM
GAACCTATCGGTGATT-1	CM
CCATACCAGTAGTTCC-1	CM
CGTGGCAGTCCCGTGA-1	CM
TCGATTTGTGCATTGT-1	CM
CTGAATGCAGTTGGAG-1	CM
CGGACCAGTGTTGTTG-1	CM
GAGGTCCGTAGCGAGT-1	CM
GCTCACTTCGGAGTTT-1	CM
GCAGCTGAGGGCATTG-1	CM
CTCACCACAGGTAACG-1	CM
GTCACCTAGCAGGAGG-1	Neuronal
TGGACATGTATTCGCA-1	CM
ATCCTGCAGTCAGGAC-1	CM
CTTGAAGCAAGTAATG-1	vSMCs
TGTGACAAGCATTGGG-1	CM
TATTGCTAGCTTCAAC-1	CM
CAACGGCCATAGCCAT-1	CM
CTTTGCGGTTTCTACT-1	CM
GTACTTTTCTCCAACC-1	CM
ACTCGGGCATCGACCG-1	CM
TCGAGCGGTCTGGTTA-1	CM
GAAGTGGGTTGGCTTA-1	CM
AGGCGAATCCGGGCAT-1	CM
GTGGATTTCCTGTAGA-1	CM
AACGGGAAGGCAATTA-1	Endo
AAAGGATGTAAGGTCG-1	CM
GTGGATTTCCAAGTCA-1	Endo
TGCATTTCAGGCTACC-1	CM
GACTAGTCATATACGC-1	CM
ACTGCAAGTCCCTAAA-1	CM
GTAGACTTCTATACCT-1	CM
TGTACGAGTGAGTCGA-1	CM
GGAGAACAGGGAGTTC-1	CM
TGGCCTTCACTAGCCG-1	CM
GTGGCGTGTAGTCTGT-1	CM
TCAGGTAAGGCACTAG-1	CM
TACTAGGGTACCAAGG-1	CM
TGTAGCACATTCTCGC-1	Fib
ATCCTCGCATGATCGT-1	CM
CAAAGCTGTCTGGTCG-1	CM
GCTCGAGTCCGCGATG-1	CM
GATGATCGTTCTTATC-1	CM
TCTATTGTCGATCGCG-1	Fib
GAACGTTTCTGTTTAC-1	CM
GAGCATTTCATCGCAA-1	CM
ACCTGCTGTACTTCGA-1	CM
CACCACTTCCATACCC-1	CM
TGGGTTACAAAGCATA-1	CM
TATGTTCTCGGCAATT-1	CM
GCCAGACCAAGTTCGT-1	Fib
TGTGTCCAGGGCGAAG-1	CM
ATAGGCTTCTGAAAGA-1	CM
CATGCCTTCGGATCGC-1	CM
TAGCCGGAGCAACTGG-1	CM
TGACTCCAGTTAGAGT-1	CM
GTCTACCTCGCCAGAC-1	CM
GGGCCATCAGGGAGTT-1	CM
CTCATGCTCGTTGTTT-1	CM
GCGATTATCGTCCCAT-1	CM
TAGCCCTCAGGAGCAT-1	CM
AGACAAATCGATATGC-1	Lymphoid
GGGTGTCCAATCAGGG-1	Endo
CTCATGCGTCCGTAGC-1	CM
GACCCAGCAAGGTCGA-1	CM
TTTGCGCCATGCACTA-1	CM
GAAGAGCTCTATCTAC-1	CM
TGCCTGTTCGACTCGG-1	CM
CATGCCTGTCATAAGA-1	CM
GCCCAGATCGGTTCCT-1	CM
TCCCACACAGGCAGAT-1	Fib
AACTTGGCACCAAGGA-1	CM
CCAATGAGTTTGCCAA-1	Pericyte
TGCATGAAGTCTGTGT-1	Fib
TGCACCTGTTGCAGAG-1	CM
CGCAGGTAGAGGAACA-1	CM
AAAGGGCCATTAACGC-1	CM
GCTGTTCGTGGACAGT-1	Myeloid
GTCGTAAAGTTGCTTG-1	CM
TCGATTTGTCTGGATT-1	Myeloid
TCACCTGGTCACAGTT-1	CM
TGCATTTTCAGTGTAC-1	CM
TCACAGATCAAATGGA-1	CM
TGCTCGTGTCTTAGCA-1	CM
AACGAGGTCGGTAGGA-1	Neuronal
ATCCCTGTCTTACCTA-1	CM
ATTACTCAGGTGAACC-1	Myeloid
ACTGCGGCAGTCAGAG-1	Fib
TAGTCCCGTGGAAAGA-1	CM
CCCTAGTGTTGCAGAG-1	Myeloid
GGAGAACTCTTTCGAT-1	Myeloid
AGCTATGGTGAGGTCA-1	CM
GGAACTTTCCGGAAAG-1	Fib
AGCCTCTAGTTACACC-1	CM
TAGCCGGAGGTAAGCC-1	CM
CAACGGCTCAGTCACA-1	CM
CCTGCTAGTCATTGGT-1	CM
TTGTTCAAGACACAAT-1	Fib
AAGGTTCGTCGCGCTA-1	Fib
ATGTCTTTCAGGCCGT-1	CM
ATCCTCGAGCATTGGG-1	Myeloid
AGGCCCATCTAGCAGT-1	Myeloid
CGCAATACACCTGGTG-1	CM
TGCACCTGTCATTGGT-1	CM
GCTTAAGGTGGCGCTT-1	CM
GCCCGAAGTGCTGAAG-1	CM
TAGCTTTGTCCGGTAC-1	CM
CATTCATTCTCGACCT-1	CM
TCGATTTCAATTCGTG-1	Pericyte
GCTCAGGCATGGCCTG-1	Pericyte
TAACTTCTCAATTCCT-1	Endo
ATAGTCGTCCATTGAG-1	Pericyte
TTCGGTCAGATCTCAC-1	CM
GCTGTTCGTGTGTGCC-1	CM
CGCTATCTCCTGTAGA-1	Neuronal
GATCGTAAGACGACTG-1	CM
CGGTGCAAGTTCTCCC-1	CM
AAACTGCTCCTGTAGA-1	CM
AGCTGGCAGGTGATGC-1	Fib
TGCTCACCATCTCTCG-1	CM
TAAGTGCAGACAACGC-1	CM
CAGCTAATCAAACCAC-1	Endo
TGCATTTCATTGCCTC-1	Pericyte
CAGCCTTAGAATACTG-1	CM
TGTGGCGTCCATAGGT-1	Endo
CACCACTTCCTAAGTG-1	CM
GGCGAAATCTGTGTGA-1	CM
GCAGATTAGAGTGGAA-1	Fib
TTGCTATGTTCTTTCA-1	CM
GCGATCGAGGGTTCTT-1	CM
GATTAGCAGTTACCAC-1	Endo
TCACAGAGTACTTCAG-1	Myeloid
ATGCATGCATTAAGGA-1	Fib
CAGCTGGAGATTACGA-1	Myeloid
TTCGATTTCGGAGTTT-1	vSMCs
ATGTTTCTCCTTACGC-1	Endo
TTTGAGGTCCAGGTCG-1	Pericyte
CAGTGTACAAGGGTAC-1	CM
GTCACCTCATAGAATG-1	CM
GTTGGGCCAATTGCCA-1	Myeloid
CACTGAAAGACTAGGC-1	Fib
GGCGAAAGTCACCCGA-1	CM
CAATCCCTCGATGTAC-1	Myeloid
AACAAAGGTAAGGTCG-1	Neuronal
AACCAACTCCTGAAAC-1	CM
ATTTGTCTCGGCTATA-1	CM
GGGTGTCGTTTCTCTA-1	Pericyte
TAGCGGCCACTAAACC-1	Myeloid
ACCGCAGGTACGTAAA-1	CM
TCACTCGAGTCTAGAA-1	Myeloid
CCACGTTTCTGAGTCA-1	Endo
TTGCAGACAGTGGTCC-1	CM
AACAGTCTCGCTATAG-1	CM
GAAATGAAGAATATCG-1	Fib
GGTCATAGTATTCTGG-1	CM
AGTCAACTCGTCCCTA-1	Fib
TAGCCGGAGTTACACC-1	CM
ACAATCGCAGCTGATT-1	Lymphoid
GCCTACTGTAGAGAGA-1	CM
ATTTGTCCATGCCTTC-1	Fib
ATGCATGGTTTAGACC-1	Pericyte
CAAGGCCGTTCCGGCA-1	CM
TCGAGCGAGAGCGAAA-1	vSMCs
CCTAAAGAGGTTGACG-1	vSMCs
ACTATTCGTCCAAGAG-1	Myeloid
GAGACTTTCGCTCTAC-1	CM
CACTGAATCCCAATAG-1	Myeloid
CCACAGGTCTCCACTG-1	Endo
CCCTAACAGTTGGAAT-1	CM
CACTAAGGTATCATGC-1	Endo
TGCTCGTCATCCCTTG-1	CM
CATTGGAGTGAATCGG-1	Myeloid
GGCATTACAAGCCAGA-1	CM
GAATCTGTCAGGTCTA-1	Myeloid
ATTACCTTCGGTACTA-1	CM
TTGAGCATCGCATACA-1	Myeloid
CAAGAAAGTAGTCCAT-1	CM
ATCCTGCCAATTCTCT-1	Myeloid
ATTACCTTCTGAGTAC-1	Myeloid
TAGGAGGCATAGCCAT-1	vSMCs
TCACAGATCCACCTAC-1	Fib
CATGCCTCAGTTGGAG-1	vSMCs
CGTAAACCACGTTGTA-1	CM
GCTTAAGCACACACCG-1	Fib
GTCTACCGTCCCGTGA-1	CM
GCATGATGTCATAGCT-1	Fib
CTGCGTTCAACGCACC-1	CM
TCAATTCAGCCCATTA-1	Fib
GAGGCTCAGGATGTCG-1	Myeloid
AATGCCATCAATGCAC-1	Myeloid
CGCAATAAGCTGAAAT-1	CM
CTTCCAGTCACCACAA-1	Myeloid
GAACTTGCACTGCTCT-1	Pericyte
TCAGGGCCAGATGGCA-1	CM
ATCCCTGGTGCCCGAT-1	CM
GCGATTAGTGGCCTTG-1	CM
TCCGACTAGTTGGAAT-1	Fib
GCACGGTCAGAGCCAA-1	Endo
CTTGCCATCTATCTTG-1	Pericyte
AGTCCGGGTGGAAAGA-1	Fib
CCGCATTGTTAAGTCC-1	Endo
GAGTGAGCACTCGTGG-1	CM
TCACCACAGTAACACA-1	Lymphoid
GGCACGTCAAGCCTTA-1	Fib
GGGTGTCGTCATCAAC-1	Fib
ACGGATTAGTTACACC-1	CM
TTGCTATCAATTGCCA-1	vSMCs
ACCGCAGCAGGTGGTA-1	CM
TACGCAATCCTAAAGC-1	Fib
TGCTCGTAGGCTTAAA-1	Fib
TTAGCGACATAGACGG-1	Endo
GAGGCTCCAACTACTG-1	Myeloid
GACCAATTCCCACGGA-1	CM
CATTCATCAAGCTTTG-1	CM
CTCGCTAAGCTGCCAC-1	CM
GTTGGGCGTAAACGGC-1	CM
AGCTATGTCTAAACGC-1	CM
ACAGACTGTAATGCCT-1	Myeloid
GAACCGCGTTTAAGGA-1	Endo
TAGGTCAAGACGACTG-1	Fib
TAGCTTTTCTGACATG-1	CM
CATTCCGGTATCTCAG-1	Pericyte
TCGCCTAGTTCTGAAC-1	Pericyte
ACCATCCTCCACCTAC-1	CM
AACGAGGGTGAGCTAG-1	CM
ACAATCGGTATTCGAC-1	CM
GAACCGCCATCTCACC-1	Fib
GCCCAGAAGTAGAAGG-1	CM
ACCTGCTTCGAGTTAC-1	Fib
CGTACAACACATTCTT-1	Myeloid
CCCACATCAGTAACCT-1	Fib
CGCAGGTGTAGGTCTT-1	Pericyte
ACATGGTCAAGGACCA-1	Myeloid
GTCACGGGTGGATTTC-1	Fib
TAGTCCCCAGGTAGCA-1	Pericyte
GTGATCAAGTACCCAT-1	Myeloid
AGCGATTAGATGGGAA-1	Myeloid
CCGTACTCAATTCTCT-1	Pericyte
GCCCGAAAGGACTTTC-1	CM
AGCCTCTAGACTTGAA-1	Fib
TAAGTGCCACCGAATT-1	Endo
ATAGGCTTCTTAATCC-1	Pericyte
ATGGATCTCAATTGGC-1	Endo
TAGGAGGCAGAAGTGC-1	Fib
ACGTTAGTCCCACTTG-1	Myeloid
AACAAAGTCGGCATAT-1	Pericyte
TTGTTCAAGTCTCTAG-1	Fib
GGAGGATGTAGTCTGT-1	Endo
GGTACCGCAAACCTAC-1	Myeloid
AAACTGCCACCATTCC-1	CM
GCCAGCAAGCGTCTGC-1	CM
ATGCATGAGAGTTCGG-1	Myeloid
CGCAGGTCATAGGCGA-1	Fib
ACTAACGTCTTATCAC-1	Endo
TACGCAACAACTACTG-1	Fib
AGCCAGCGTGGTGGTA-1	Endo
TGGGTTAAGTTCAAGA-1	Pericyte
TAGTCCCCATAGCCGC-1	CM
GCCCAGAGTGTCCAGC-1	vSMCs
TTCGTTACAAAGAAGG-1	Fib
CTCAGAATCGCCCTTA-1	Myeloid
CATGCCTAGAGGTCCA-1	Neuronal
CTTGAAGCATTAAGGA-1	CM
TCGCCTAAGTTCAACC-1	Endo
AGCTATGAGCCTTTGA-1	CM
CAGTGTAAGGCAAGCT-1	CM
CTTGAAGTCACCGCGA-1	Myeloid
AACGTACAGTTCTCCC-1	Fib
ACAAAGATCCCGGGTA-1	CM
CAGTGTAAGAACGTCG-1	CM
ATTTGTCTCGAGGTAG-1	Fib
TGTACAGCACCGAAAG-1	Fib
TGAGCCGGTATATGGA-1	Myeloid
AGTGCGCAGATTAGAC-1	Endo
AACATCGGTGGTAGAC-1	CM
ATGGATCCAGATACAA-1	CM
AGACAAAGTCAGTGCC-1	Pericyte
TACCTCGGTTCTACCC-1	Fib
GTTACTTAGCCCATGC-1	Fib
TTGAGTGTCAATGCAC-1	Endo
GGAGTAGGTGCAACAG-1	Myeloid
GTCCATCGTCCGGTAC-1	Endo
AGGCCCATCGCCACTT-1	Fib
GACCGACAGATATGTG-1	Endo
TGTACGATCGCTCTAC-1	Pericyte
TTTGAGGAGTCACACT-1	Endo
AACCTTTTCGTGGTAT-1	Fib
CTAACTTAGTCTAGAA-1	CM
CATGTTTAGGCGTCCT-1	Endo
GGGTCTGTCTCCACTG-1	Lymphoid
GCTTGCTGTAGCGTTT-1	CM
GACCTTCTCCTCCAGT-1	Fib
CAAGAAAAGAAAGCAG-1	Endo
TAAACCGGTGAGTAAT-1	CM
TAGCGGCTCCAGCACG-1	vSMCs
GAGCGCTAGAGGTCCA-1	Endo
TCGTTCGAGCCTCGCA-1	Pericyte
GAGGATGAGAATCAAC-1	CM
CGTAAACTCGGATCGC-1	Fib
GCGCATGTCGAACACT-1	Myeloid
CTGCGTTTCAGTCACA-1	Fib
TGACTCCTCCAGGGAA-1	Pericyte
ACTATTCAGGTTAACA-1	Pericyte
GAACCTAGTTTCTCTA-1	Fib
AACAGTCAGCCATCAT-1	Pericyte
CTCTCGACACCACGAC-1	Myeloid
CTCAACCCATCATGTG-1	Pericyte
AGCGTGCGTGCTAGTT-1	Pericyte
CGATGATTCGATGCAT-1	CM
GAGTGAGGTACGGTTT-1	Pericyte
ATTGTCTGTGGTCGAA-1	Pericyte
CCTTAATCAGTTACAC-1	Myeloid
GATTGACCAAGCAGGT-1	Endo
CTCGCTATCTTTATCG-1	Myeloid
CAGGATTGTATCCTTT-1	Myeloid
CTGGGACAGTCGTACT-1	Lymphoid
GGGTCTGTCTTGGCCT-1	Endo
ATCGAGTTCTCCTTAA-1	Pericyte
TTAGGTGTCTGAGTAC-1	Endo
CAGCTAACACTCGGAC-1	Fib
CCACGTTAGAACCCGA-1	Myeloid
GCTCCTATCGTGGAAG-1	Fib
GCGTTGGTCGATCTTT-1	Fib
CTAGCGGAGACTTCCA-1	Myeloid
CCCTCTCCAGAAAGAG-1	Pericyte
CGCGCAACACCGTTGG-1	Myeloid
AAAGGATAGCGATACG-1	Endo
GTCCATCCAAGGCTTT-1	Endo
GCGGGTTGTGAGGTCA-1	Fib
ACCATCCTCCGCCTAT-1	Fib
AACAAAGCATACTGCA-1	Endo
AAAGGATGTGGACCAA-1	Endo
TCAGCTCAGTGATAAC-1	Pericyte
TACATGGAGAGCAGCT-1	Fib
CACATGAGTAGTTTGC-1	CM
GTCGTAACACTAGCCG-1	Myeloid
CTTGCCATCCTGAAAC-1	Myeloid
GACTAGTAGGCCAGTA-1	Myeloid
GGAGGATTCAAATGGA-1	Myeloid
TTGTTGTCATCAGAAA-1	Pericyte
AAATGAGAGAATCAGT-1	Pericyte
TACGGATTCCCGGGTA-1	Fib
ACTGCGGGTTGGCGAA-1	Fib
GAGATTCCACCGTTGG-1	Endo
CAGGGCTCAGCGTACC-1	Myeloid
CTAACTTCAGCAACGA-1	Myeloid
GCCAGACAGGCGATTG-1	CM
GTTATGGCATTTGGTG-1	Pericyte
CAACGTATCGATAGCT-1	Myeloid
CGTACAACAGCGTGAA-1	CM
ACTACGAAGAGCTCCC-1	Fib
TTGCTTATCTTAATCC-1	Endo
AAATGCCAGCATGATA-1	Endo
TCAAGCAGTGTACGCC-1	CM
GTGCTGGAGATCACCT-1	Myeloid
ACCGGGTCAGTAGGCA-1	Endo
TGTACGAGTCAGAGTG-1	Endo
GTAATCGCAGGTGGTA-1	CM
TAGCATGAGGGAGTTC-1	CM
CAGCTAAGTACCGGCT-1	Myeloid
TTCATCAAGCCCATTA-1	Endo
TTAGCTTGTCACTCTC-1	CM
TGAGTCATCGAGGTCC-1	Fib
ATCGAGTCAGGATAGC-1	Myeloid
ATTACTCGTCAATCCA-1	Myeloid
AGTTACGTCCATACCC-1	Myeloid
GTGGCGTTCCGGCTGA-1	Endo
ACCAAACGTGAGTAAT-1	Neuronal
TTACTCAGTCTCTGCT-1	Endo
GGAGAACAGGTGTCGA-1	Pericyte
ACTTTCAGTCTCGGGT-1	Fib
GGTGTCGGTGACGCAA-1	CM
CACCTGTCAGTAACTC-1	Pericyte
GCGCCAACAGAAAGAG-1	Endo
AGGACGAGTATCCTTT-1	Endo
GTTGGTATCGCATAAC-1	Pericyte
TCGCCTACATTTAGGC-1	Fib
GCGGGTTGTAGTTTGC-1	Endo
CTAGGGCCAATTAGGA-1	Myeloid
GTCACGGGTTGTCGGC-1	CM
TGCTATTCATTTGGTG-1	Pericyte
GCACCTTAGACTTCCA-1	CM
TCTAGTTTCGGTACTA-1	Myeloid
TACTAGGCAACAAACA-1	Myeloid
TGATCAGGTTACGGAG-1	Pericyte
GCCTACTAGTTCGCGC-1	Pericyte
TCAGCTCAGTCAGGAC-1	Endo
CCTCCCTAGTAGTCGG-1	Endo
GAGCATTTCCTGTAGA-1	Endo
TTCGGTCTCTCGACCT-1	Endo
CGCAGGTCAGCGCGTT-1	Endo
TCGAGCGTCAGTTGAC-1	CM
GACTAACAGTTCGACT-1	Fib
CGCAATAGTAGATGAT-1	Myeloid
AAATGAGCAACGGACA-1	CM
GAAGAGCAGCAGTAGC-1	CM
AGCGTGCCAGAAAGAG-1	CM
ATAGGCTTCACTAGGT-1	Fib
TGTAAGCTCCATAACG-1	Myeloid
AGTGTACCAACTCGAT-1	Fib
AATGGAAGTCAGAAGC-1	Myeloid
GGGCCATAGCCTGTAT-1	Myeloid
TGGGTTAGTATTCTCT-1	Pericyte
CACCACTGTCAGACGA-1	vSMCs
GGGAACACAACTGCGC-1	Fib
CCTGGGAAGATCTCAC-1	Endo
CTTCTAATCTCTTCCT-1	Pericyte
ACTTCCGTCAGGAAGC-1	vSMCs
TCAAGGTAGGCTTAAA-1	Myeloid
AGTGTACCAGGTGTGA-1	Myeloid
CTACTTATCCTGTGGG-1	Pericyte
ACTAACGCATCCCTCA-1	Pericyte
AGTCCGGAGTAGTGTA-1	Endo
CTTTGCGCAAAGGCCA-1	Pericyte
AATGCCAGTGAGGTCA-1	Myeloid
TTCTGTAGTTCGGGAA-1	Pericyte
TGATGCATCTGAACGT-1	Endo
ACAGCGCCATCAGCTA-1	Endo
AACAGTCCAGGTAGGT-1	Endo
GGATGAGGTCCATTGA-1	Pericyte
CAGGGCTGTAGAAAGG-1	CM
TTAGCGATCGCTCGGA-1	Myeloid
GTCACAATCAGCACGC-1	Myeloid
CAGCTAAAGTGGGACT-1	CM
ATCCCTGGTATACGCT-1	Myeloid
CGCGCAACACAAACGG-1	CM
CTAGCGGAGCAGGAGG-1	Fib
CTGTTCGCAATTCTCT-1	Pericyte
TTGCACCGTCCATTGA-1	Fib
TACGCCTTCTGTTTAC-1	Endo
AACGGGAGTCATTGGT-1	Endo
TGGGTTAGTATGGTTC-1	Fib
ACATGGTAGGTGAACC-1	Pericyte
GGAGTAGGTGATAAGT-1	Myeloid
CGTACAACAGCAAACG-1	Pericyte
TGCATTTTCGTGATAC-1	Pericyte
CCGTGAGTCGGATAGG-1	Pericyte
ATAGGCTAGATATGAC-1	Endo
TAGGTCACAAGGTCGA-1	Fib
AGGACGAGTTCCATCC-1	Pericyte
TCTATTGTCGTCAACA-1	Pericyte
CGCGCAATCGCCAGAC-1	Pericyte
GCTCAGGGTGTCCTTC-1	Fib
TCTCTGGCAAGGAGGG-1	Endo
GGGTTATGTGCAAAGC-1	Myeloid
GATCATGAGGACTTTC-1	CM
GGTGTCGGTTAGGAAT-1	Myeloid
ACGGATTGTTATGCAC-1	CM
AAATGAGGTCAACTGT-1	Endo
ACAGAAAGTTACCCAA-1	Endo
CCTATTAAGGGACGTT-1	Pericyte
TGCATGAGTCAACGGA-1	CM
TTGCGGGCACCTACCT-1	Endo
GAAGTCTCACGCCGAT-1	Endo
CTACTTAGTAGTATCC-1	Fib
GTCACGGTCAGGTCTA-1	Endo
GAGGTCCCAAGGCGTA-1	Endo
CCGTACTTCGCCTTAC-1	Endo
GAACCTATCGATGCAT-1	Pericyte
GGTACCGGTATTGTGC-1	CM
CTGTTCGAGATCGCCC-1	Myeloid
CCATACCTCTATCCTA-1	Pericyte
CAAGCTAAGGAGTAGA-1	Pericyte
AGCCTGGTCATTCTTG-1	Myeloid
GAGAACGAGCTTTCCC-1	CM
GCTCAGGGTTAGGAAT-1	vSMCs
CACGTTCTCCGAGAGA-1	Endo
CCGAAGCGTCGTCGCA-1	Endo
TAAGTGCCACATCATG-1	Neuronal
AGGCGAAAGTAGTGTA-1	Myeloid
GATGGCCCATTCGTCC-1	Pericyte
GTCACGGTCCGGAAAG-1	Pericyte
TTCAACTCAGGGAGTT-1	Fib
CTTCTAAGTGCGTTTA-1	Endo
GCTTTCGCAGGGTAAC-1	Pericyte
GAGGATGGTTACCACA-1	vSMCs
GGATGAGCATCACAGT-1	Pericyte
CCACAGGAGCTAGTTC-1	Myeloid
GCTGAGCCATGCTATG-1	Endo
GTTACTTTCTTCAGAG-1	Myeloid
GGGTTATTCCAGTACA-1	Pericyte
GATCATGGTCCTATTT-1	Myeloid
GATCATGAGTAGTCGG-1	Endo
GCCAGCAGTGAAACAT-1	CM
TCAAGGTCACCCTTTG-1	Myeloid
GGCGTTGTCTAGCAAC-1	Endo
TCACTCGTCATACTTC-1	Endo
AGTGCCGGTTGCTTGA-1	Endo
GCCTACTCATCAGCTA-1	Endo
TACAGCAGTTTGCCCT-1	Endo
ACAAAGAGTTCAGTAC-1	Pericyte
GGAGTAGCAAATGTCC-1	Endo
AACTGTGTCAGTGTGT-1	Lymphoid
TTGCGAACACCAAGGA-1	Myeloid
ACTGCGGTCGCATAAC-1	Endo
TTACGGACAGGCATCC-1	Fib
TTGAGCAAGTCTGCTA-1	Endo
CTCAACCGTATTCTGG-1	Fib
TGCTCACCAACTCCCT-1	Endo
TTGTTGTAGCTACGCC-1	vSMCs
GATTGACGTGCAAAGC-1	Myeloid
GGACACCCAGATACAA-1	CM
TTTGGTTCAACACGGA-1	Endo
TCAGCTCAGGATCCTT-1	Fib
AAACTCGAGGTTGACG-1	Fib
TCAATTCTCTGTGTCC-1	Endo
CCATACCAGTGAATAC-1	Endo
AGCCTTCCAGGGTACA-1	Pericyte
TACGCCTCAGTCAGCC-1	Fib
GCGGAAATCGTTACAG-1	Endo
GGTGAAGGTGAATACA-1	Lymphoid
TGCATTTTCCGGCGAT-1	vSMCs
ACCGAATCAGGGTAAC-1	Neuronal
TTACCGCGTACAAGCG-1	Endo
TCCCACAGTACCGGCT-1	Endo
CGCGCAAAGCGTTGCC-1	Endo
GATGATCGTAAGCCGA-1	Endo
GATGGCCAGTAGGTCG-1	Myeloid
CTAGGATCATCGCCTT-1	Endo
TCAGTCCTCTATTTCG-1	Endo
ACCCAAAGTCGATTAC-1	Lymphoid
TTTGAGGTCAGGTCTA-1	Endo
GCCTAGGAGTACCTCA-1	CM
TTGGTCCCAGTAACTC-1	Endo
GAGCATTAGCGCCTAC-1	Pericyte
TAAACCGCAGCGCGTT-1	Myeloid
AACCTGATCAATTGGC-1	CM
ACTAGGTGTGCTGAAG-1	Fib
CCTATTACATGTGGGA-1	vSMCs
GACCTTCTCTTGCGCT-1	Pericyte
ACAGACTCAAGTTGCT-1	Fib
AAGGAGCTCATTCATC-1	Endo
GTGTCCTAGACTCGGA-1	Myeloid
TCAGGGCGTGATAACA-1	Pericyte
GTGCTGGTCCATACCC-1	Endo
TTCTAACAGCCGCTGT-1	Myeloid
GGGTTATAGGCCTCGT-1	CM
TCACCTGTCTGAACGT-1	Endo
CCTTAATCATTACACG-1	vSMCs
TCAGCTCGTAGATTAG-1	Fib
TCACTCGTCTGCTACC-1	Endo
ACCTGCTTCCTCAAGA-1	Endo
CAGCCTTTCGATGTGT-1	Fib
CTACAGATCGCTATAG-1	Endo
GTCACTCGTCGGCTGT-1	Endo
ATAGGCTCATGTGAGG-1	Endo
GCCTACTGTCAACTAC-1	Fib
GCTGCGAAGCAGAAAG-1	Endo
GTGCACGAGCTCCGGT-1	CM
GCTTGCTAGAACAGGA-1	Endo
TATGTGGGTAGCAGGT-1	Endo
AAGATAGGTAGCGGTA-1	CM
ACCCAAAAGTGTCGCC-1	Myeloid
CTCATGCTCGCCTTAC-1	Endo
CGTTCCAAGTACTCTG-1	Myeloid
CCGAAGCTCCAATAGC-1	Endo
ACCAAACGTTAACCAC-1	Fib
TGCCTGTTCAAAGTAG-1	CM
CCAGAATTCCAGAATC-1	CM
GCTCGAGCATTACTTC-1	Endo
GAAACAACAAGGTTCT-1	Pericyte
TTCTGTAAGAACGCCA-1	Endo
TACTGCCCAGGTAACG-1	Pericyte
ACATGGTTCGACTATG-1	vSMCs
AATGTCGCAATGGCTT-1	CM
TGCCTCAGTACTTCGA-1	Endo
GAGGTCCCAAGACTAA-1	Lymphoid
GGCATTAAGACCATAA-1	Endo
CCCTCTCAGGGAAATG-1	Pericyte
AGTGCGCAGATCGATA-1	CM
TCACTCGCAGTATCTG-1	Pericyte
AATGTCGCAGCGTACC-1	Endo
GGAGAACAGGCAAGGG-1	Lymphoid
CTACAGATCATTCGGA-1	Lymphoid
CCCTAGTGTCATAGAA-1	Endo
TCACAGAAGACGACTG-1	CM
ACTTCCGTCTAGCAAC-1	Lymphoid
CGGACCAAGTCGACCC-1	Endo
ACAAAGAGTTCTGAAC-1	CM
CCGTGAGCAAGTCTCA-1	Endo
CTCTACGTCCAGGTCG-1	Endo
GCATTCCAGTACTCTG-1	Myeloid
CACCTTGTCCGCTCTA-1	Pericyte
GCACGCATCCAACAAC-1	Myeloid
CAAAGCTCACGTTACA-1	Endo
GCTGTTCGTTTCCTAT-1	Endo
TTAACGGCAATACTGC-1	Fib
CTGAATGGTGACGCAA-1	Endo
GAGAACGAGGGAAGCG-1	Endo
ACCCAAATCTGAGTAC-1	vSMCs
GCGTAGCGTCCCGTGA-1	Pericyte
TTGCGAACAGGTCTGC-1	Pericyte
TGCTTTAGTTGGACGA-1	Endo
GTTACGAAGTAGACCG-1	Myeloid
AGCGTGCTCCAACGCG-1	Pericyte
ACGTGGCAGACAGCTG-1	CM
TTCGATTAGTTACCAC-1	CM
GTGCCAGGTACGGTTT-1	Pericyte
CACCTTGGTACGGATG-1	Myeloid
CAGCCTTTCGACCCGA-1	CM
TTATGTCAGATCTCAC-1	Fib
GTTGGGCGTAATGCCT-1	Endo
AGCGATTCAAAGGAAG-1	Pericyte
GCTGCGAGTATGTCCA-1	Endo
TACTGCCGTAGCAGGT-1	Myeloid
GCCCAGAGTATCAGCT-1	Endo
CCTGCTACAAGTAACA-1	Endo
GGTGTCGCATGTAGAA-1	Endo
GTAGACTAGCTACGTT-1	Endo
TGAGCCGAGCGAGAAA-1	Myeloid
TACCTCGCAGGTTATC-1	CM
TGCTTTAGTTTGGATC-1	CM
GATCATGCAACCTCTC-1	Endo
GATTAGCAGGTGTCGA-1	Myeloid
CCGCATTCATCGCTAA-1	Endo
GAGGTCCAGATCTCAC-1	Endo
TCAGGGCTCGCCTTAC-1	CM
GCTGTTCAGAGAGGTA-1	Lymphoid
GGTACCGGTCTGGATT-1	CM
CTGGGACCAAGCCTTA-1	CM
GCTGCGAGTCGAGGAT-1	Pericyte
GCGAGTCAGTACTCTG-1	Endo
GAAAGTATCTTACGGA-1	Endo
TCACTCGTCTGCCGAG-1	CM
CTCAGCTGTCGTAATC-1	Pericyte
ACAATCGAGGGCTCTC-1	Endo
AGCTGTAGTTCTGAAC-1	Fib
CATAACGGTGTACGCC-1	Fib
GGCGAAAAGCTACGCC-1	Endo
GCACGGTCATCTGCAA-1	CM
AAAGGGCAGACGACTG-1	CM
ATGCATGGTTGCAGCC-1	CM
TTCTGTAAGTCCCTCT-1	Endo
GCGGAAACAGTTAAAG-1	Lymphoid
TGATTTCGTTACCACA-1	Endo
ACTTCCGAGTCCGTGC-1	Neuronal
CGCTATCAGTTGCGCC-1	Myeloid
CAAGGCCGTATTGTGC-1	Pericyte
AAAGATGGTCTGTTGA-1	CM
ATCCTGCAGTATACCC-1	Endo
ACAAAGATCTATGAGC-1	Fib
ACCGAATCATGGGACA-1	Fib
GTTGGGCAGGAAGACA-1	Endo
TGGAAGGGTCCTTCAC-1	CM
CCGTAGGTCAGAGTGG-1	Lymphoid
TTATGTCAGCGAGCTA-1	Pericyte
GTAGACTCAGTAAGAT-1	Myeloid
ACTAACGTCAAGGCCC-1	Lymphoid
TGATTTCTCGATAGCT-1	Pericyte
GCGGGTTGTTCTCGAA-1	Endo
GGAATCTGTGCTGTGC-1	CM
TCAGGTAAGATTAGAC-1	CM
TCTCTGGGTCTGGTCG-1	Fib
CGCTAGGGTGCAGACA-1	Endo
CCCACATGTTGGCGAA-1	Endo
GAACCTACATGGTTTG-1	CM
TTCATCATCGGCATAT-1	CM
AGGACGATCAGTGGTT-1	CM
CCGCATTAGGGCTCTC-1	Myeloid
GAAAGTAAGGCGACTA-1	Endo
GATGGCCGTGCTGTGC-1	Endo
TCACCACGTCAGAGTG-1	CM
GGGCCATTCAATTCCT-1	Fib
GTGTCAAAGCGGACAT-1	Myeloid
GGGTCTGAGACGACTG-1	CM
ACAGAAATCTCTGAGA-1	Pericyte
GGAGGATGTATTCTTC-1	CM
CCGTGAGCACCTGAAT-1	Endo
GACTAACCAAAGGCCA-1	Fib
CGTGGCACAATCAGGG-1	Pericyte
GTTGGTACACGCGATC-1	Fib
ATATTCCCATAGCCGC-1	CM
CCTTGGTGTCCACCAG-1	Neuronal
CACAGATTCCTTACGC-1	CM
CTTGCTGTCGACTGGC-1	Myeloid
ATTGTGGCATTTCTTG-1	Neuronal
AGCCGCATCTGCCGAG-1	CM
ATCCTGCTCCATGTTT-1	Fib
AATGTCGGTAAAGGCC-1	Myeloid
ACAAACCAGATCGCCC-1	CM
ATAGGCTCATGCCTTC-1	Fib
CACCACTGTAGCGAGT-1	Fib
AGTTACGAGCTGCTCG-1	CM
CACTGAAGTGTTGTTG-1	Pericyte
TTGCAGAGTTGTATCG-1	Fib
CTCTACGGTAACAATG-1	Fib
AAACTCGCAGTAGTCT-1	CM
AACGTACTCATACTTC-1	Fib
TTAGCGACACTGTCAA-1	CM
GTGCCAGTCCAGCACG-1	Fib
CAAGAAAGTGCGCATC-1	Myeloid
GGAACCCTCTAAGGTC-1	CM
GTAGGAGTCTTTCGAT-1	Fib
GACCTTCTCTGAGTCA-1	Fib
TTCATTGAGGCAGATC-1	Fib
TTTACGTCATCAGCTA-1	Endo
