Barcode	cell_type
TCAAAGCTCGCCTTAC-1	Endo
TAGCACATCTTGGCCT-1	Endo
ATAGGCTTCCTCCCAA-1	Fib
GTGTGATCACGACGAA-1	CM
GAGAACGGTTTGATCG-1	Endo
TTTGCGCCAGTTAAAG-1	Fib
GCCAGCATCCACGAGC-1	CM
TGATCAGTCTCGTAGA-1	CM
GCTCGAGAGAAATACC-1	Fib
AAAGGATTCCTCTCTT-1	CM
CACGTTCTCGTGAACT-1	Fib
CGCACAGAGCTAGTTC-1	Fib
CTTCCAGTCAAGGCAG-1	Endo
GGATAGGGTCTGGGAA-1	Endo
GCACCTTCATTCACCC-1	CM
CTCATGCCATGCGTTA-1	Fib
ATGTACGTCTACTTTG-1	Fib
AAACTCGAGCACACCC-1	CM
CCTGGGAAGAGGCCTA-1	CM
ATAGGCTTCCATTGAG-1	Fib
GCGCATGGTCCAAGAG-1	Fib
TACATTCCACATGATC-1	CM
ATGTCGAGTTCCCAAA-1	Pericyte
TGATTTCCATCCCTTG-1	Fib
GCGGGTTGTGGTAAGC-1	CM
GCACCTTGTGTTTCTT-1	Endo
CGGTGCAAGCTATCCA-1	Fib
GTAGACTAGTTCCAGT-1	Myeloid
TCACTCGCAACGTCCG-1	Myeloid
ACGGATTGTGGCCTCA-1	Pericyte
ACTGCGGAGTGGACGT-1	CM
GTAGTACGTCCACCAG-1	Fib
CATTCATTCCCACTAC-1	CM
TAACTTCGTTGCAGCC-1	CM
AGGCGAAGTAGAAGCC-1	CM
CCCTCTCTCATGTTCT-1	Fib
TTCTAACCAATTCTCT-1	Pericyte
ACTGCGGTCAGGTCTA-1	Neuronal
TTCTGTACAGTTACAC-1	Myeloid
CTTGTCGGTGTCTACA-1	Pericyte
AAATGAGAGATGTTCC-1	Pericyte
AACCGATGTCAGTGCC-1	CM
TTCAACTAGGTCTTTG-1	Endo
TAACTTCCAAGTTGCT-1	Fib
ACGTGGCGTCAAATCC-1	Endo
GAGCGCTCACGGCCAT-1	Fib
CTCACCATCCATCGAA-1	CM
TACCTCGTCGCCGAAC-1	CM
TGATGCAGTATTGTCG-1	Pericyte
CCAATGAAGTATGGGC-1	Lymphoid
GTGCACGCAAGACACG-1	Endo
GAGCATTAGTGCTGAG-1	CM
CCAGAATTCTGTAGAC-1	Endo
GGGTTATCACGTTACA-1	Lymphoid
TACCTCGGTGAGTAAT-1	Endo
TGCACCTTCTCGACCT-1	Fib
CAAGCTACACGTTAGT-1	Endo
CACCTTGTCCATATCT-1	Fib
AAGGAGCGTTCTGAGT-1	Endo
TCAAGACTCGCCTTAC-1	Endo
ACCTGCTTCATTCTTG-1	vSMCs
ACTGCGGTCTCCAACC-1	Fib
ATAGTCGCATAGTCCA-1	CM
TACCTCGGTTTCGACA-1	CM
CGCAGGTGTTACTACG-1	Endo
GCTTAAGAGTCTCTAG-1	Neuronal
CCGTGAGTCACGTCAA-1	Fib
CAGTGTATCCAGCACG-1	CM
TCAGCTCGTATCTAGC-1	Endo
ACTTCCGAGGGTTCCC-1	Fib
GTAGTACCATGGTAAA-1	Endo
AAATGAGCAATCAGGG-1	Endo
TAAGTGCGTCTGTTGA-1	Fib
ACGGATTTCGTGGAAG-1	Myeloid
ACTGTCCTCAGGCGCT-1	Endo
GTACTTTCACGCTGTG-1	Myeloid
TCAATTCAGATACCAA-1	Endo
ACCAAACAGAGGCCTA-1	Lymphoid
AGATAGACAGTCAGCC-1	Fib
AAAGGGCGTTAGGAAT-1	Endo
CAGGATTCAGATTAAG-1	CM
CTAGCGGCATAAAGTG-1	Endo
TACGGATAGGATGTCG-1	CM
AGACAAAAGTACCCAT-1	Fib
AACCTGATCGGGATCC-1	Fib
GTGCCAGAGATTGACA-1	Endo
GGAGGATTCTACTTTG-1	Pericyte
TTCGTTAGTACCAAGG-1	Endo
TAGCATGTCCAGAATC-1	Myeloid
CAAGAAATCAGTGGTT-1	vSMCs
CCTTAATAGCGTCAAG-1	Myeloid
GCGATCGAGCTGAATA-1	Myeloid
TACATTCCAGATAAGT-1	Endo
AACTGTGGTTGGACGA-1	Fib
TACGGATGTCAACTAC-1	Endo
TGCGTAACAATTGCCA-1	Myeloid
CACAACACATCCATAG-1	Pericyte
TGGACATGTTCCCAAA-1	Fib
GGCATTAGTTAGTAGA-1	Endo
AACGGGATCCTCCCAA-1	Fib
GCGGGTTTCGGGACAA-1	Endo
GGTACCGTCTTAACGG-1	Fib
CTACTTACAAGGTCGA-1	Myeloid
CTTCTAACAAGCGAAC-1	Endo
TGACAACTCATACTTC-1	Pericyte
ATGCATGTCCTATCCG-1	Lymphoid
CGGACCAAGTCAGCCC-1	Endo
CCGTGAGCAAGTAACA-1	Lymphoid
GCATTCCAGAGTGGAA-1	Endo
ATAGTCGCACCCATCT-1	Endo
GCGCATGTCACTTACT-1	Myeloid
CGAGTTAAGGCAATTA-1	Myeloid
TGTACAGTCTTCAGAG-1	Endo
ACAAGCTCAGTAGTCT-1	Endo
CCCTCTCCACCTGAAT-1	Lymphoid
AGGCCCATCCGATTGA-1	Pericyte
TCACAAGGTGATGTGG-1	CM
GAGTGAGGTCTGGGCT-1	Myeloid
AAATGCCTCTGTTGCC-1	Endo
CTACTTAGTCCGTAGC-1	Fib
GTGTCCTAGGCTTAAA-1	Pericyte
TCAATTCGTACGCCCA-1	Endo
CAGGATTCATCATAGC-1	Pericyte
GGTACCGAGAACCATA-1	Myeloid
TCAAGGTAGCCTTTGA-1	Endo
CCGAAGCTCGGTGATT-1	Myeloid
TCACTCGAGGCTGGAT-1	Endo
TAGCACACATGTAGAA-1	Lymphoid
TGTAGCATCTGAACGT-1	CM
CTAACTTGTTGTGACT-1	Endo
GCGTTGGGTGGTGGTA-1	Endo
CAGTGTATCAAGGCAG-1	Endo
TATGTTCAGGAACCGT-1	Lymphoid
TGTTAGGTCTATATCC-1	Endo
GTCACTCGTATGAAGT-1	Endo
CGCTGGAGTGCACCCA-1	Pericyte
TCTAGTTGTGTCGTCG-1	Endo
AACTTGGCAATCCATG-1	Fib
TATGTGGGTCGTCGCA-1	Endo
TTCGTTAAGTCTTAGC-1	Myeloid
GACCTTCGTTTAAGCC-1	Fib
CCCGTTACACAAACAA-1	Endo
GAAAGTAAGCCCATTA-1	Myeloid
CTACTTATCGGCATAT-1	Lymphoid
GTTATTCTCAGGCGCT-1	Endo
TCACCTGAGGTCCTCG-1	Endo
GAGAACGTCCTATCAT-1	Endo
TCAATTCCAAACCCTA-1	Endo
AACCGATTCTGTGTCC-1	vSMCs
TACCTATTCATCGCTC-1	Endo
TGCATTTAGCATTCCA-1	Lymphoid
CTGTATTAGCCTCGCA-1	Endo
GAGGCTCTCAGTCTTT-1	Fib
GATGATCGTAGTATCC-1	Endo
ACAGGCCCATAGACGG-1	Fib
GGTCATAGTAGCCATT-1	Lymphoid
GACTAGTCACACTAGT-1	Endo
TTGAGTGCACCATTCC-1	Myeloid
CCCTCTCAGAGGCGGA-1	vSMCs
TATGTGGGTTGTGAGG-1	Myeloid
AAATGAGGTAACCCAT-1	Endo
ACATGCAAGAGGTGGG-1	Lymphoid
CAAGGCCTCGCTTACC-1	Endo
GTCCATCAGAGCACTG-1	vSMCs
GTGTCAAAGATCTCAC-1	Endo
TGGCAATTCGCGCTGA-1	Neuronal
CTGAATGTCTTCTTCC-1	Pericyte
GTTGGGCGTCAACGGA-1	Endo
CGATGATGTTGAAGCG-1	Endo
GTGATCAAGGTTCGAG-1	Endo
GTGGATTTCCACACCT-1	Pericyte
GCTGTTCCAGTTGGAG-1	Myeloid
GCGAGAAGTTAGAGAT-1	Pericyte
GTGGCGTGTCTAAGAA-1	Endo
TCACCTGAGTTGACAA-1	Endo
AGCCAGCTCCCTATTA-1	Myeloid
TGAGTCATCGGCAATT-1	Endo
GCGCCAACAGAGTCGA-1	Endo
GTGCACGAGGTGATGC-1	Endo
CCGAAGCGTGTGAGGT-1	Endo
GAACTTGGTAGTATCC-1	Endo
GCGGAAAAGTCTGCTA-1	Lymphoid
AAGATAGAGCTCCGGT-1	Myeloid
TTTGGTTTCCCTACCA-1	Myeloid
ACTCGGGGTACAAATG-1	Fib
CTCGCTAAGCCTTTGA-1	Lymphoid
GTAGGAGAGTAGAAGG-1	Myeloid
TGCACCTGTGATTCCA-1	Pericyte
GGAGTAGGTAAACGTA-1	Lymphoid
TATGTGGCAGCGTCGT-1	Endo
ATCCCTGCAGGACCTC-1	Endo
AGCGATTCAGCCGAAA-1	Pericyte
CTTGCTGTCTCTGCAC-1	Fib
CTTGCCATCGTTCAGA-1	Lymphoid
AGCCCGATCCGGGCAT-1	Endo
GAAACAATCCAACAAC-1	Endo
CTACAGAGTTTCCGGG-1	Endo
CAGCTAACATACCCGG-1	Myeloid
GGAGGATAGCAGAAAG-1	Pericyte
CCCAGAGTCCAGGTAT-1	Myeloid
ACGGATTAGTCCTTCC-1	Endo
TACTGCCAGTAACATG-1	Myeloid
TGGAAGGTCTATCTCA-1	Myeloid
CTTGAAGAGTGTCGGA-1	Lymphoid
CTGAATGTCGTATAGC-1	Endo
GCGCATGAGATACCAA-1	Endo
ACAAAGAGTTTAAGCC-1	CM
GGGTGTCTCGCTTACC-1	Lymphoid
TACGCAACAAACCCTA-1	Myeloid
TATGTGGAGATGAGGA-1	Myeloid
AGGCGTCTCTCTTCCT-1	Endo
AGGCCTGCAACGAGGT-1	Endo
GGGTCTGTCGCGATGC-1	Myeloid
CGCACAGGTCAAATCC-1	Endo
GCTCAGGTCTTACGGA-1	Endo
AAACGAAGTAGACACG-1	Endo
AGCTGTAAGGTTGTTC-1	Fib
AAGGTTCGTCTCTGGG-1	Pericyte
CCTATTAAGCGTGTTT-1	Lymphoid
GGTGAAGAGGATATCA-1	Fib
GCGATTAGTAAAGGCC-1	Fib
ACCAAACTCCGTTAGA-1	Myeloid
AACGAGGGTAATGCCT-1	Endo
AAATGAGGTTAACCAC-1	Fib
AACCAACCATACCCGG-1	Endo
CGCTATCTCAAGGCAG-1	Endo
GGAGAACCAAGTCTGT-1	Endo
CCCTAACCAGGATGTG-1	Pericyte
AGTTACGAGCGCCTAC-1	Myeloid
TTGTCTATCGCATACA-1	Lymphoid
GTACTTTCATACTGCA-1	Lymphoid
TTCGGTCCATCGTGAT-1	Endo
TTACGGAGTGCAAGAC-1	Endo
ATCCTGCAGCTGAGGT-1	Fib
AAACTGCCAACTCGTA-1	Endo
TCTCAGCGTCCGGTAC-1	Myeloid
CATTCCGTCCTTTGAT-1	Endo
GCGAGAACATGTATCG-1	Myeloid
CTGGGACCAGAACAGC-1	Lymphoid
TTGAGTGTCAACGTGT-1	Lymphoid
ACAGCGCGTCAACGGA-1	Endo
GAGGATGTCCGCTCTA-1	Lymphoid
TAGGAGGGTGGTAAGC-1	Lymphoid
CCCTGATGTTCCATCC-1	Endo
CCAGAATCAGAGATGC-1	Pericyte
CAAGCTACAGGACCTC-1	Lymphoid
TTAGGTGAGACCAATA-1	Endo
CAGTGCGCAAGTTCGT-1	Endo
GGTTGCGGTCAGAAAT-1	Endo
GGGTCTGTCCCAGTAA-1	Lymphoid
ACATGCAAGCCTTTGA-1	Lymphoid
GTTGGTATCGCCGAAC-1	Myeloid
CCTATTAAGTCGTATC-1	Pericyte
TAGCTTTCACTCGTGG-1	Endo
GAGACTTCAGAGATGC-1	Endo
CTCTACGTCGCAGATT-1	Pericyte
TTGCAGAAGTTCGCGC-1	Pericyte
CGCTAGGAGCTCCATA-1	Endo
GGTAGGAGTTTGCCAA-1	Endo
TGCTCGTCAAGACTTC-1	Endo
GCAGCTGGTGTGTGCC-1	Endo
AACCTGAGTCCTTCAC-1	Endo
TCTCAGCTCGCGCTGA-1	Lymphoid
TCTATTGCAAGGAGTC-1	CM
GCACGGTAGTACCCAT-1	Myeloid
ATGTCGAAGATGGGAA-1	Myeloid
TTGCTTACACAGTAGG-1	Endo
TTACTTGGTGTCCAGC-1	Myeloid
AACAGTCCACAAGTGG-1	Pericyte
GAACTTGTCTGGCCAG-1	Lymphoid
CGGTGCAAGGATTTGA-1	Lymphoid
CTTAATCCACTGTCGG-1	Endo
GCTGCGATCCAGGCCA-1	Endo
CTGTTCGGTGAAACAT-1	Fib
GCTCCTAAGCAATGTA-1	Lymphoid
CACCACTAGAGAGGTA-1	Lymphoid
TGATGCATCGGTTCCT-1	Myeloid
TTGACGAAGTGTCACT-1	Endo
CTTAATCGTTGTATCG-1	Endo
TAAGTGCTCCGTTAGA-1	Lymphoid
GTGGATTGTATGGTTC-1	Myeloid
ATGTCTTTCGGCTATA-1	Lymphoid
AGCTGATGTCGACTGC-1	Myeloid
AGTGCGCGTTACACTG-1	Lymphoid
TACTGCCGTAAACGTA-1	Endo
GCGTTGGGTGCGTAGA-1	Lymphoid
TTGTTCACAAATGCTC-1	Myeloid
TTCGTTAAGGGCTTCC-1	Lymphoid
GAACCGCAGTCGTATC-1	Endo
GCGATTACAACTAGAA-1	Lymphoid
TTTGGCCGTACGGTTT-1	Fib
TGCTCACAGTATCTGC-1	Endo
ACCGCAGGTAGTTTGC-1	vSMCs
TGTAAGCTCAGCCGAC-1	Endo
GTTATTCCACGCCGAT-1	Pericyte
GGTACCGCAGTGGTCC-1	Endo
AGCTGGCGTTTCTTAC-1	Lymphoid
TTGCGGGCAATCCATG-1	Endo
GCAGCCATCCCGAAGC-1	Lymphoid
GTGCTGGCATTCGTCC-1	Pericyte
TGTACAGCAGCCGAAA-1	Fib
ACCGCAGCATCATAGC-1	Endo
CATTGGATCGCCGAAC-1	Endo
CCGTGAGGTTTAGGAA-1	Endo
GCGTAGCAGCTGATTC-1	Lymphoid
ACAGACTGTGTCGTGC-1	Endo
CGCTGGACATTGCCTC-1	Pericyte
GTAATCGAGTGAAACT-1	Pericyte
GTTACGAAGATGGGTC-1	Endo
