Barcode	cell_type
CGGACCACAGGGTAAC-1	Myeloid
ACAATCGAGGATTGCG-1	CM
GTGCACGGTTACCCAA-1	CM
GCGGTGTTCGCTTCAC-1	CM
TGCACCTGTACCCATA-1	Endo
ACCGCAGAGGCAGTGT-1	CM
TTCATTGCATCACAAC-1	CM
ATCCTGCCAAGATGCG-1	CM
CTGAATGAGAACGCCA-1	Fib
GGGTCTGAGCGGACAT-1	CM
AACGTACAGAGATTAC-1	Myeloid
CCGTACTTCGGATAGG-1	Fib
CACAACAGTAGCTGTT-1	CM
ATTGTCTGTAGTTTGC-1	CM
GGACACCGTTTCTTAC-1	Endo
TCAGCTCTCCCACGGA-1	Endo
CGATGATTCTACTTTG-1	CM
TGTAAGCCACTTATGG-1	Fib
GAATCTGCATGGGTGA-1	Endo
CATGCCTGTAACATAG-1	CM
AGTGCCGTCCCAGCGA-1	Fib
TACATGGGTCAGAGTG-1	CM
ACATGGTAGGTCTTTG-1	Lymphoid
ATAGGCTGTTCCTATT-1	Fib
TAAACCGGTAGGTAAT-1	CM
TAGTCCCGTGATCAGG-1	CM
TGCTCACCAATGTGCT-1	Endo
TACATGGCAGGGCTTC-1	Fib
TGGTCCTTCTCGACCT-1	CM
GCAAAGGGTATATGGA-1	CM
TTGAGTGGTGAGGTCA-1	CM
TTCGATTGTTTAGACC-1	Fib
ATCCTCGGTACGTATC-1	Fib
CTCTAGCGTCAAACAA-1	Fib
ACCAAACAGCAATGTA-1	Myeloid
ACTGCAATCCTCCTGA-1	CM
AGGCGAAGTGGCCTTG-1	vSMCs
GAAACAATCGTTCTAT-1	Fib
TTAACGGAGGCAATTA-1	Myeloid
TCAGGTACACAATAAG-1	Fib
AATGGCTTCCGGACTG-1	Pericyte
TTACTTGTCTCGACCT-1	Fib
GAGGATGGTCCGTGCA-1	Endo
GCGCATGAGGATGCCA-1	CM
CAGTGTATCGAGGTAG-1	Endo
CCTTGCAGTCTTAGCA-1	Endo
CCGTAGGAGTCCCTCT-1	Fib
TTTGTGTAGTCTGTGT-1	Endo
CTCTCGACAATGTAAG-1	Endo
ACAAAGATCGATGCAT-1	CM
TATGTTCCAACGTCCG-1	Endo
CCCACATCACAGTTAC-1	Fib
AACTTGGTCGCCCTTA-1	Endo
CAGTGTATCCAACGCG-1	Pericyte
GATTAGCAGTGGGACT-1	Myeloid
CTCACCAAGAGCTGTG-1	Myeloid
GAAAGTAGTCAGGTGA-1	Fib
CTTTGCGAGCCATCAT-1	Myeloid
AACGAGGCAGGACTGA-1	Endo
CCCACATTCCCTACGT-1	Lymphoid
GCGCCAAAGGTCGGTA-1	Endo
TTACGGAGTAGCAGCA-1	Myeloid
TGGTCCTTCTTTGCAT-1	Lymphoid
AAACGAACAGGCATCC-1	Fib
TTACTCAAGGTGTTGG-1	Pericyte
TCAAGCATCCAAGTCA-1	Fib
ATCCAGATCGTTCCGT-1	Myeloid
GAAGTCTTCAATGCAC-1	Lymphoid
CTCGCTAAGCTACGTT-1	Endo
AGCCCGATCTTTGCAT-1	Fib
GCATTCCTCCGTGCAG-1	Myeloid
CCAGATAGTTTCTTAC-1	Myeloid
TCACTCGCAAAGACGC-1	Fib
GGCACGTGTTCCATCC-1	Fib
GCGGAAATCGCAACTA-1	Myeloid
CTCTCGAGTAAACGAT-1	Myeloid
CACATGAGTCATCGTA-1	Endo
TACTAGGGTTTAGAAG-1	vSMCs
GTGCTGGTCGCCAGAC-1	Fib
AAAGATGGTGAATGTA-1	Lymphoid
CACCACTTCCTGAAAC-1	Myeloid
TTCGATTGTGCGCTCA-1	Fib
TCGGGACTCCTCCAGT-1	Endo
AGCTGATCACGTTAGT-1	Lymphoid
AGTCAACAGTGCTAGG-1	Fib
GGATAGGTCCCGAAGC-1	Lymphoid
CCTTAATGTGTTTCTT-1	Lymphoid
TGGAAGGGTGCACATT-1	Endo
TCGAGCGCACCGATCG-1	Endo
CAGGGCTTCCAGGTCG-1	Myeloid
AATGGCTCATCATCGA-1	Endo
GAATCTGGTTAGCTCA-1	vSMCs
TTTGGCCCAGAGATGC-1	Endo
CTCTAGCCATGGGTGA-1	Fib
AAACGAATCTACTGCC-1	Myeloid
CGCAGGTAGTAGTTCC-1	Lymphoid
ACTGCAACACGCTAAT-1	Endo
ACTCGGGGTAGATGAT-1	Fib
TATGTTCGTCCCGAGT-1	Lymphoid
GTTATGGCAGTTAAAG-1	Lymphoid
CAGCTAAGTGTGAGGT-1	Myeloid
TCAAAGCGTTGGCTTA-1	Lymphoid
CCGCATTGTCCGCTTT-1	Lymphoid
TAGACTGGTCTAAGAA-1	Lymphoid
CTGCGTTGTGGTCGAA-1	Myeloid
TCACCACTCCCGGGTA-1	Lymphoid
CCGTAGGCATTACTCT-1	Lymphoid
TACGCCTCACTGTCAA-1	Endo
CGCGCAAAGTGATAAC-1	Endo
GGTAGGAGTACGGTTT-1	Lymphoid
TACCCTGTCCTATCCG-1	Lymphoid
ACAAACCCAACGTACT-1	Lymphoid
TCTCTGGGTAAACGAT-1	Lymphoid
CTCTAGCCACGAACGA-1	Myeloid
GAACCTACATAGCCGC-1	Fib
TTCGCGTGTCAACGGA-1	Lymphoid
CAGTGTAGTGGACTGA-1	Endo
AATGCCAGTAGGGTTG-1	Myeloid
GCACCTTCAGGGCTTC-1	Lymphoid
TTGCTTAAGCACACCC-1	Lymphoid
CTCTCAGAGCGGACAT-1	Lymphoid
TCAGGGCTCGCAGATT-1	Lymphoid
GCGAGTCCAGGCAAGT-1	Lymphoid
TGGAAGGGTAGGGTTG-1	Fib
TGCTTCGGTAAGGTCG-1	Lymphoid
AAATGCCCAGGATAGC-1	Lymphoid
ATGTCTTGTGGACTGA-1	Fib
AGTGCCGCACAATAAG-1	Lymphoid
GATCGTACACTTACAG-1	Lymphoid
AGGCGAAGTGCCAAGA-1	Lymphoid
TGGTCCTGTGAGGGTT-1	Lymphoid
CAGTATGAGTAGGAAG-1	Fib
CTTAATCCACATGATC-1	Myeloid
TCAGGGCCAACGGACA-1	Lymphoid
TGGCGCACACTGTTAG-1	Myeloid
AACAAAGAGGTGTTGG-1	Lymphoid
GTCTACCGTGTCCAGC-1	Lymphoid
TATGTTCAGGAAACTT-1	Lymphoid
GGCGTTGAGGCACTAG-1	Fib
CTTTGCGAGTCACACT-1	Endo
GAATCTGAGGTTCGTT-1	Endo
CAGTATGTCATTCATC-1	Lymphoid
TCGATTTTCTGCGTCT-1	Fib
AAATGCCCAGGTCTGC-1	Lymphoid
CGCTATCGTAACGGAC-1	Fib
AGCCTCTTCGACTATG-1	Lymphoid
TATTGCTAGAGTTTGA-1	Fib
AGTCAACAGCAACTGG-1	Myeloid
TTGACGAAGTTGCGCC-1	Endo
GCAACCGGTTCTACGA-1	Lymphoid
GCTGTTCGTAAACGGC-1	Lymphoid
TACCTCGCAGTATACC-1	Lymphoid
