Barcode	cell_type
AGCTGGCAGGCACCTC-1	Fib
TACATTCGTTCTTTCA-1	CM
TCAAGGTCACATCATG-1	CM
GTAGACTGTCCACCAG-1	Fib
TTACGGAGTAAGCCGA-1	Endo
ACTACCCCATCCCGGA-1	CM
CATGCCTAGTACCTCA-1	CM
TTGCAGATCACTGGTA-1	Fib
GTGACATGTGCCAAGA-1	CM
AACCTTTTCTGAACGT-1	CM
CACAGATTCTGGTACA-1	Pericyte
ATTACTCTCCAGGTAT-1	CM
CAAGAAACACTAAACC-1	CM
GACCAATCAGGATAGC-1	CM
CACCTGTGTGGACTGA-1	CM
ATAGGCTAGTGATTAG-1	Fib
GCACGGTAGGGTCTGA-1	CM
GAAATGACATGGTTTG-1	CM
ACAAAGAGTGTCCTTC-1	CM
CGCAGGTTCAAACCCA-1	CM
CACGTTCAGGTTAACA-1	CM
ACCCAAACAGGGTAAC-1	Myeloid
CCAGAATGTTGAATAG-1	CM
CTTGTCGGTTCTTAGG-1	CM
TAGCCCTGTCTGTTGA-1	CM
ACTAACGCAAGTTGCT-1	Fib
TGCTATTTCCTGGAAT-1	Fib
AGCGTATGTAACGGCA-1	CM
CTCAGCTAGGCCAGTA-1	Fib
AAATGCCCATGGGAAC-1	CM
ACAAAGATCCCAATAG-1	Fib
AACGTACTCTGCGTCT-1	Myeloid
CGTAAACGTTTGCATG-1	CM
AGCCCGATCAGTGTGT-1	Fib
TTCGATTTCGGATGTT-1	Fib
TCGTTCGAGCTCGTTA-1	Myeloid
CTGGCAGCATCGACGC-1	Myeloid
TGCGTAATCTCTTCCT-1	CM
ACTATTCAGTACTCTG-1	CM
CCTCCCTCAGTAACGG-1	CM
CATTGGAAGAGAGTAG-1	CM
GACCTTCGTCCGCTTT-1	Endo
ATCCAGACATGTGGGA-1	CM
GGGAACATCAAGGCAG-1	Pericyte
GGGTTATAGACCAATA-1	Endo
ACTAGGTTCTCCACTG-1	Endo
GGCATTATCTCGACCT-1	Myeloid
CTGCGTTTCTGACATG-1	CM
ACCGAATGTGAGGTCA-1	CM
AGATAGAAGCCTTTGA-1	CM
CAAGCTATCTTCATAC-1	CM
ACTACGAAGCCATCAT-1	Endo
CCAGATAGTTCACGTA-1	Pericyte
CCCAGAGGTAACATAG-1	Fib
TTACCGCGTAGGGTCA-1	CM
AACGTACCAATCAGGG-1	Myeloid
CAGTGTATCGTGGAAG-1	Pericyte
CCCGTTACACTAGGAG-1	Myeloid
ACTTTCAGTAGGGTCA-1	CM
CAAAGCTTCCTCTCTT-1	Pericyte
CTGGCAGCAGGATGTG-1	CM
GCTCGAGAGGCAATTA-1	CM
AACTTGGTCTTAAGCG-1	Endo
GGGTCTGGTAATGCAA-1	Myeloid
GTGTGATTCCTTTGAT-1	CM
CTAACTTCAAGGAAGA-1	Myeloid
TTGCACCAGCCTATAC-1	CM
ACGGATTGTACCTATG-1	Fib
CGTGGCATCTATGAGC-1	Myeloid
GGCATTACACGCTAAT-1	Myeloid
GCAGCCAGTCAGAAAT-1	CM
CCTTGCATCTATAGGC-1	Endo
CTCTCAGCAAAGGAAG-1	CM
GGTACCGAGGATATCA-1	CM
ATATTCCCAACTGCGC-1	CM
TGAATCGGTTTCGACA-1	CM
CTCAACCAGGTAAGCC-1	Fib
GCCCGAAAGTTGTCCA-1	Neuronal
GCGTTGGGTCTGGTTA-1	Fib
GTGTCAATCGATATGC-1	Myeloid
TTGCTTAGTGCGTCCA-1	Myeloid
GCACGGTCAAGAGCGT-1	Endo
ATCCCTGAGAAGCCGT-1	CM
ATGTCTTTCATTCTCA-1	Fib
GAGCGCTGTGTGTGTT-1	CM
ACGTTAGGTCGCTAGC-1	Pericyte
CACGTTCCACCTGTGG-1	CM
TTGAGTGTCGATGTAC-1	CM
ACCGAATAGTGTCCCG-1	CM
CGTAAACGTAGACGCA-1	Pericyte
TGGGTGCAGGCTAAAT-1	CM
AGGCGAAGTTCCGCGA-1	CM
ATTACCTTCTATCCTA-1	Myeloid
GAACGTTTCGCCACTT-1	CM
AGTCAACTCGAGTTAC-1	Myeloid
GTTCAAGGTTGGTAAA-1	Fib
CCGAAGCCAGTATACC-1	Fib
GCCTACTTCTGTTGCC-1	Myeloid
GTCACAACAACACGGA-1	Endo
CTTGTCGTCGCACAAT-1	Myeloid
GATGATCGTGGAAGCT-1	Endo
ACGGATTTCCATTGTT-1	CM
TCCCACATCGCGCTGA-1	Neuronal
TTCTAACAGAGAACCC-1	Fib
TCAGTCCAGTAGAAGG-1	Myeloid
GTGCCAGCACTAGGAG-1	Myeloid
CGTTCCACATTCTTTG-1	CM
TTTGCGCGTCTGGATT-1	CM
ATGTCTTTCCACGGCA-1	Pericyte
GCCTAGGGTATCATGC-1	CM
GGGTGTCGTCAGTGCC-1	CM
GATGGCCAGAACCATA-1	Myeloid
GGTACCGAGAGCTGTG-1	CM
CTGTATTGTTGTCGGC-1	Myeloid
GAGCATTTCCATCATT-1	CM
TTCGCGTCAGTTGCAT-1	Lymphoid
ACCGAATAGTCGCCTG-1	Pericyte
TTAGCTTCAAGCGTCC-1	CM
GAGACTTAGGGTCTGA-1	Endo
CCCTAGTTCAAGGCAG-1	Myeloid
CGCAGGTGTCCCGAGT-1	CM
TCTATTGCAATGAAAC-1	Myeloid
TACGGATTCAGTACAC-1	Myeloid
ATTGTGGGTCTCTAAG-1	Myeloid
TGTACAGAGGTTAGTA-1	CM
TTGTTGTTCCTAAAGC-1	Myeloid
TTGCGAAGTAGAGAGA-1	Pericyte
TTTGGCCCATGGATGG-1	Myeloid
GAATCTGTCCCATAGA-1	CM
TAGCATGTCAGCACGC-1	CM
TAGTCCCCAGACCTGC-1	CM
GGGACCTAGCCTCGCA-1	Pericyte
TGCCTCAAGGTACATA-1	Pericyte
GGAGAACTCGCACAAT-1	Fib
CAACCAAAGAGCTACG-1	Myeloid
TACTGCCAGGCTTTAC-1	Lymphoid
AGGACGACATGCCTTC-1	CM
GGTGAAGTCTGGCACG-1	Pericyte
GATGGCCGTTGGCGAA-1	Myeloid
GCGGGTTTCTTAAGCG-1	Myeloid
ACAGACTGTAGTTTGC-1	CM
CCGTAGGTCTGTGTCC-1	CM
TACTAGGTCGCACCTT-1	Myeloid
AGCTGATTCGGATAAA-1	Fib
TTAGGTGGTATTGTGC-1	CM
TTGCGGGGTCCGTAGC-1	CM
TAAACCGGTGCGTAGA-1	Pericyte
CTTGCTGCATGCACTA-1	Fib
ACTTTCACAATGTGCT-1	Pericyte
GGAGTAGAGTGATATG-1	Endo
ATTGTCTCACTCGGAC-1	Pericyte
TTTGGCCCAACGCACC-1	CM
GCGGTGTTCAACTTGG-1	Pericyte
TGCTTTAAGCTACGCC-1	Fib
TATCGAGTCCTAGAGT-1	Endo
TGTAAGCCACCTGAAT-1	Myeloid
GTTACTTAGGGTGTTG-1	Myeloid
TCGATTTAGGGTCCCT-1	Fib
GTTATGGGTGAATGTA-1	CM
TTAACGGGTCATCAAC-1	Endo
TAAGCCACACACATGT-1	Myeloid
CAGTGTATCACTAGCA-1	Fib
GCATGATGTTTCCACC-1	Endo
CTTGCTGAGTCTCGAT-1	Fib
AGCTATGGTGCCAAGA-1	Lymphoid
GCGCATGAGTTGCCGC-1	Myeloid
TACTGCCGTAAGGTCG-1	Fib
GATCGTAAGAGTTTGA-1	Pericyte
GCGTTGGCAAACAGTA-1	Myeloid
GTAGACTAGCTTACCA-1	Lymphoid
GATTAGCTCAGAGTGG-1	Lymphoid
AGTTACGTCCAGGCCA-1	Myeloid
CCATACCCAATTCGTG-1	Myeloid
ATTGTGGTCATTCTCA-1	Endo
ACAGAAATCAGATACC-1	Myeloid
TTCGGTCAGTTGCCGC-1	CM
GAACCGCCAAAGCTTC-1	Myeloid
TTTGTGTAGTAGGTCG-1	Endo
AGTTTGGAGTGATATG-1	Endo
TTACGTTAGCTCGGCT-1	Myeloid
ATCCCTGTCTCCTTGG-1	Pericyte
TGGCGCATCGACGGAA-1	Myeloid
GTCACAATCCACGGCA-1	Myeloid
ACCGGGTGTTTGTAGC-1	Fib
TTTGGTTTCTAGCAAC-1	Myeloid
ACGTGGCGTCAATACC-1	Myeloid
GCGGAAACAGGCATTT-1	Myeloid
TACCCTGTCCACCTAC-1	Myeloid
TGCGTAAAGGTCTTGT-1	CM
ACCAAACCACGGTTAT-1	Lymphoid
GTAATCGTCACGATTG-1	Endo
GAACCTAGTTCAGAAA-1	Myeloid
GAAAGTACACTACACA-1	Endo
GAGACTTGTGCAGACA-1	Myeloid
GGTAGGAAGTGAGTTA-1	Endo
GCAGATTGTAACGGAC-1	Endo
AGTCCGGCATGGTTTG-1	Endo
GGTACCGGTATCATGC-1	CM
AACTGGTCATATACGC-1	Endo
GAACGTTTCAGGGTTT-1	Myeloid
CATTCATTCCACGCTT-1	Myeloid
TGATTTCCAACGTCCG-1	CM
AACGGGATCGAAGCCC-1	CM
CATAACGAGGAAGAAC-1	Endo
GCCTACTGTGCATTGT-1	Myeloid
GAAATGAAGGAAACTT-1	Fib
TGCTCACGTACGGATG-1	Lymphoid
GCCAGCACACAGATGG-1	Myeloid
AGTGCGCAGAAGGGCG-1	Myeloid
TTGCTTATCTCTATCA-1	Myeloid
CCCAGAGGTCAATCCA-1	CM
AGTCCGGGTTCCGGCA-1	Myeloid
TTCGTTAGTGATGTGG-1	Myeloid
CTGGGACAGTACAACA-1	Myeloid
TCCATCGAGTCTTAGC-1	Fib
GGAACCCTCGATGCAT-1	Endo
GTGTGATGTAATGCCT-1	Myeloid
CACCACTGTAAAGGCC-1	Pericyte
GTCGTAAGTAAACGAT-1	Lymphoid
CTACTTAGTGCAACAG-1	Myeloid
AAATGAGCACTGTCGG-1	Myeloid
TAACTTCGTTACCACA-1	Myeloid
GTGCCAGTCGTTTGAG-1	Myeloid
TTCTAACTCCATATCT-1	Fib
TGGACATCATGCGACC-1	Endo
CTTAATCCACGCGACT-1	Pericyte
CATTGGATCGTTCCGT-1	Lymphoid
GATTGACTCCTGGAAT-1	Myeloid
CATTGGAGTTCCCGGA-1	Lymphoid
GTTACGATCCTATCAT-1	Endo
CAGCTGGAGGAGTAGA-1	Myeloid
GTCGTAAGTGCGTTTA-1	Fib
GTCACCTCATCTCACC-1	Endo
TACCTATTCTCTGTTA-1	Myeloid
GAAATGACACTGGGCT-1	CM
TACAGCAAGGGAGTTC-1	Myeloid
TAGGTCAGTTGCCTGG-1	Endo
TACCTCGTCACCCGGA-1	Endo
AGCGATTCATGGCCCA-1	Endo
TACCTATGTGTCTACA-1	Lymphoid
TTGCGAATCTGTGTCC-1	Myeloid
GCTCCTACAACTCGAT-1	Endo
CTTGTCGCATGCGTTA-1	Neuronal
CAGTGCGCAAGGCTTT-1	CM
CGCTATCAGGCGATTG-1	Pericyte
GGGACCTTCCGTACGG-1	Fib
CACCTTGCAATAGCGG-1	Myeloid
CTCTCGAGTGCGTAGA-1	Endo
TCAGTTTTCTCCCTTT-1	Endo
CAACGTAAGATGGCAC-1	Endo
GCGATTATCGCTCTAC-1	Endo
TCGGGACCAGCTGATT-1	Myeloid
GCTCACTTCCGCTATC-1	vSMCs
GTTATGGGTGATGTGG-1	Endo
AATGGCTCATTCTCGC-1	Myeloid
TGTACAGGTCATAGCT-1	Myeloid
CAGTATGAGTTCAGGG-1	Pericyte
CACTAAGGTCAACAGG-1	Endo
ACAAACCCATGTCCCT-1	Myeloid
GCTTGCTGTGCATTCA-1	Neuronal
CAGCCTTTCAAACCAC-1	Lymphoid
CTCAGCTTCTTCATAC-1	Myeloid
AACGTACCAATCACTG-1	Myeloid
AAGGTTCGTATGTCCA-1	Endo
CTGTATTTCGATCGCG-1	Myeloid
CTCAGAAGTCTGTGTA-1	Lymphoid
TTGCTTATCGCATACA-1	Endo
TACAGCACAACGAGGT-1	Myeloid
AGCCGCAAGCCTCGCA-1	Myeloid
TGATTTCAGTGTGTAA-1	Lymphoid
CACAGATTCCTTACGC-1	Myeloid
TACTGCCAGCTGCCAC-1	Myeloid
CCGTGAGAGAACTAAC-1	Lymphoid
CAGTGTAAGCTAGTTC-1	Myeloid
TGACAACCACGTGAAG-1	Endo
AAACTCGAGACAGTGC-1	Lymphoid
TATCTGTGTCTAACCA-1	Endo
GGTCATAAGTCTGCTA-1	Myeloid
TTGCTATTCGGATGTT-1	Pericyte
ACTCGGGTCACTCCCA-1	Myeloid
TTCATTGGTCACATTG-1	Myeloid
AACCGATCATGGATGG-1	Endo
CACTAAGGTAACGGCA-1	Myeloid
ACGGATTAGGGTGTTG-1	Pericyte
TGCCTGTGTTCTTATC-1	Myeloid
GAGAACGAGTCTTAGC-1	Myeloid
AAAGGGCTCGAGGTAG-1	Myeloid
GATCGTAAGGTGATGC-1	Endo
AGCTGATTCGGTACTA-1	Endo
CCAGATAAGCTACGTT-1	Myeloid
TACCCTGAGAGGCGGA-1	Myeloid
TTCATCATCATTCATC-1	Endo
AAGGAGCCAAAGCTGG-1	Endo
GCGTTGGGTTCTACGA-1	Lymphoid
GCTCCTACAGACCTGC-1	Lymphoid
GCGTAGCAGAGAATTC-1	Lymphoid
GGTGAAGGTTAGCTCA-1	Myeloid
GGAGAACGTTCTGATG-1	Endo
TATCTGTCAAGTTCGT-1	CM
TGTAAGCCAGATTTGC-1	Myeloid
TACCCTGGTTGCCGCA-1	Lymphoid
ACTGCGGAGGATGCCA-1	Myeloid
CCAGATATCAGTACAC-1	Myeloid
TTTGAGGAGAAACGCC-1	Myeloid
TGGAAGGAGACTTCCA-1	Endo
CCCGTTAAGACCCATT-1	Pericyte
TGTTAGGTCCGTCAAA-1	Myeloid
GCGCCAATCGTGGAAG-1	Lymphoid
GCGATTATCGTGATAC-1	Fib
ACAATCGCAAAGCATA-1	Lymphoid
CGGACTGAGACAGCTG-1	Myeloid
CCCAGAGCACTGTCGG-1	Lymphoid
ATAGGCTCATTAACGC-1	vSMCs
CCTGGGAAGTTAGAGT-1	Myeloid
GATGATCAGGATTTGA-1	Pericyte
ACGGATTGTTTGGATC-1	Lymphoid
TAATTCCAGTGTAATG-1	Myeloid
CGCAATAAGGGTATCG-1	Endo
CTACTTAAGGATCCTT-1	Myeloid
TCTCTGGAGCGAGAAA-1	CM
TGCATTTCAATGGTAA-1	Lymphoid
AACCTGAGTGATAACA-1	Endo
CGTTCCACATCATCGA-1	CM
CAACGGCAGAAAGCAG-1	Endo
TAGGAGGTCCGTTAGA-1	Lymphoid
TGCACCTAGGCAATTA-1	Myeloid
ATCCAGAAGCCGCAAA-1	Endo
TTGGTCCTCAGTAGTC-1	Myeloid
TCAGGTAGTTGCAGCC-1	Lymphoid
GCAGCCACATTAAGGA-1	Endo
CTGTTCGGTGTCTACA-1	Lymphoid
AGACAAACACCGATCG-1	Lymphoid
TCGCAGGTCCAACCTC-1	Lymphoid
TGACAACGTAAGTCTC-1	Pericyte
AACATCGCATCGCCTT-1	Myeloid
TTAACGGGTAACCCAT-1	Myeloid
GAGGATGTCGACTATG-1	Myeloid
GTTGGGCTCGTGGGTC-1	CM
ACTGCAAGTACGACCC-1	Lymphoid
AGCCGCACACATAAAG-1	Endo
ACATGCATCTCGACCT-1	Endo
GTCACCTTCGTAGCGC-1	Endo
AGGACGAGTATTGTGC-1	Myeloid
CCTGGGACAGCGTCGT-1	Myeloid
CGGTGCACAGGTCCTG-1	Myeloid
TTGTTGTGTCTGCGCA-1	Myeloid
