Barcode	cell_type
ATGTCTTGTTTGTACG-1	CM
TCGATTTTCGCTTGAA-1	CM
GTGTCAATCAATCGTG-1	CM
TGGTCAAGTAGCTGTT-1	CM
TGCCTGTCAGCTGATT-1	CM
GTAGACTTCACTCGGG-1	CM
GGGTGTCGTTCCAATG-1	CM
GAACCGCTCGTTGTAG-1	CM
TACTAGGCAAACCTAC-1	CM
CAGTGTAAGGAAGGTA-1	CM
TTCATTGGTACATGGG-1	CM
GCTCGAGAGACACGGT-1	CM
GGCGTTGCAAGAGATT-1	CM
GCTGAGCAGGCAGTAC-1	CM
GAGACTTCACTGATTG-1	CM
AGCCGCATCTCTCAAT-1	CM
GATTAGCTCGCGTTCT-1	CM
TATCTGTTCATCATGG-1	CM
TCGCCTATCCAGGTCG-1	CM
GCGGAAACATAGTCCA-1	CM
TACAGCACACGCGCAT-1	Myeloid
GGCACGTGTCGATAGG-1	CM
TGAGCCGGTTCTTTCA-1	Myeloid
TTTACGTGTGGCGCTT-1	CM
GGATGAGCAGAATGCG-1	CM
CAGGATTCACGAACGA-1	CM
GTGCTGGCATTGAACC-1	CM
TTGAGTGCAGGTCCTG-1	CM
GGAACTTAGCGCACAA-1	CM
TTCGGTCTCGGTTGTA-1	CM
GGTACCGGTCAACGGA-1	CM
TTACTTGTCTACATCT-1	CM
GTGTCCTGTCATAGAA-1	CM
ATTACCTAGTTAGAGT-1	CM
CGTTCCAAGTCCAGAG-1	CM
CATGCCTTCCCTACCA-1	CM
ACTGTCCGTCAGAAGC-1	CM
TAGGTGTAGTCGTGAG-1	CM
ACCAAACAGTAATGTG-1	CM
GACTAGTGTGTCGTGC-1	CM
TGGCGCAAGTCCGATT-1	CM
GATCATGTCACCCGGA-1	CM
ACTCGGGGTGAGTTGG-1	CM
TCAAGACAGGATATCA-1	CM
TAGACTGAGCACGTAG-1	CM
AACAAAGCAAAGGAAG-1	CM
CAGTGCGGTAGTTTGC-1	CM
TGACAACGTGGGTAGT-1	CM
TAGGTCATCGGTACTA-1	CM
CACCACTCAAGGGAGG-1	CM
GTGACATGTACGGATG-1	Fib
TCACCACTCACACGTA-1	CM
TCAAGACGTTCTGAGT-1	CM
CAGCCTTTCACGATTG-1	CM
TAATCGGGTGGACTGA-1	CM
AGATTCGCAGCAACAG-1	CM
GAACCGCCAGGCACAA-1	CM
ACCAAACAGGCCTCGT-1	CM
CTACAGAAGCCCATTA-1	CM
ATGCATGAGCTCGGCT-1	CM
GACCAATCAGGTGTCC-1	CM
TTCGATTAGGCCTAAG-1	CM
AACTGGTGTTGTGACT-1	CM
TAGCCGGCAATGTAAG-1	CM
GAGACTTGTACCGGCT-1	CM
TTGCGAATCCGATGCG-1	CM
ACTTCCGTCAAGGCAG-1	CM
TACGCCTCAAACTACC-1	CM
GTTGGGCAGTCTCGAT-1	CM
CAGTATGTCCGGCTGA-1	CM
GAAGTGGAGTAACTCC-1	CM
GGGACCTTCCCATAGA-1	CM
CAGTATGAGAGCGGTT-1	CM
TCACAGACACAAACAA-1	CM
TAATTCCTCTTACGGA-1	CM
TCCCACATCCACACCT-1	CM
GCTCAGGTCGACTCGG-1	CM
TGTAAGCCACCCTTTG-1	CM
TAACGGTGTCAGAGTG-1	CM
GTGTCAACAGAGCCAA-1	CM
CCGAAGCAGAGATTAC-1	CM
TTACCGCTCCAACAAC-1	CM
GAATCTGGTACATGGG-1	CM
AGTGCCGTCGCCACTT-1	CM
CAAGGCCCATTGTGAC-1	CM
AATGCCAAGTCTCTAG-1	CM
TATCGAGTCGTCGCAG-1	CM
TGGGTGCTCTTAATCC-1	CM
GGTTGCGGTCAGAGTG-1	CM
CTGTTCGGTCCAACCG-1	CM
CACCTTGCAGAGTCGA-1	CM
TTAACGGTCAGTACAC-1	CM
ATTGTCTTCCCGAAGC-1	CM
TTGCGGGAGTATACCC-1	CM
ACTAGGTTCTCTTAAC-1	CM
TAGCTTTGTGACAAGC-1	CM
GCTTTCGGTTAGTAGA-1	CM
GCAGATTTCGCACCTT-1	CM
CTGTATTAGGAAACTT-1	CM
ATATTCCGTTGAAGCG-1	CM
CCATACCAGAGGTGGG-1	CM
TCAATTCTCCGTGCAG-1	CM
AAGATAGCAAGTCTCA-1	CM
CCAATGATCAGGAATA-1	CM
TGCTTTATCTCTATTG-1	CM
GCCAGACAGCAGAAAG-1	CM
TAAGTGCAGGGTATCG-1	CM
AAATGCCGTAGCAGCA-1	CM
TGAGTCATCAGGAATA-1	Myeloid
AACATCGAGAACCCGA-1	CM
AGGCCCACATTTGGCA-1	CM
GACTAGTTCCTAAAGC-1	CM
CTGTTCGGTTCCGGCA-1	CM
GCATTGACAGAGAGAA-1	CM
CTTGCCATCTCGGCGA-1	CM
ACTACCCGTCTAAGAA-1	CM
GAGCGCTGTATCCTTT-1	CM
GTTCAAGAGTCTTAGC-1	CM
CATTGGAGTACGGTTT-1	CM
CTCAGAACATTCCCGT-1	CM
TGTGTCCTCGCGGCAT-1	CM
TACGCAAAGTGTAATG-1	CM
CGGACCACACCAAGGA-1	CM
TGATTTCAGGGAGATA-1	CM
GGTACCGGTGATAAGT-1	CM
TCAAGACGTTTCGTTT-1	CM
TGCCTGTCAGAATGCG-1	CM
ACCAAACCATAGTCCA-1	CM
TAGCATGAGGTTCTCA-1	CM
AACGAGGCAAGCAGGT-1	CM
CCATACCAGAAGGGCG-1	CM
CACCTGTTCGGCATAT-1	CM
ACAGCGCGTCAAACAA-1	CM
GCCATAAAGATGTTGA-1	CM
CATTGGATCGATCGCG-1	CM
ACAGAAACATTAGCCA-1	CM
TTACTTGAGTGAAGGA-1	CM
TAGCTTTAGAAGACTT-1	CM
TGTACAGGTCCAAGTT-1	CM
TGCCTGTCAACACGGA-1	CM
TTTACGTAGAAGACTT-1	CM
CGTAAACAGCACCATT-1	CM
GCGTAGCAGATGAGGA-1	CM
GCGAGAAAGTCCGATT-1	CM
CTGAATGCAACCTCCT-1	CM
GGGAACACATGGAGGT-1	CM
ATGTCTTAGAATATCG-1	CM
CTACAGACAGGGCTTC-1	CM
TCACCTGAGACCATAA-1	CM
AAAGGATAGTAGTGTA-1	CM
TAATTCCCAGAACGAC-1	CM
CTTTGCGAGTGAATAC-1	Fib
GGTAGGAAGAGAACCC-1	CM
AGCCCGAGTTTAGACC-1	CM
GATTAGCGTGCAAGAC-1	CM
AGCCAGCAGCGATACG-1	CM
TCAAGCACATCGTACA-1	CM
CTCACCAAGCGCACAA-1	CM
TTGCAGACAGGCTACC-1	CM
ATGTTTCTCTGCTACC-1	CM
CTCACCACAACGCACC-1	CM
ACTGTCCTCGGAGTTT-1	CM
TTGCGGGAGCGCCTAC-1	CM
GGAGGATCAGGTAGGT-1	CM
ACCCAAATCAGTACAC-1	CM
TATCTGTGTTGGGAAC-1	CM
TGGCAATAGTGAACCG-1	CM
AATGCCACATGGTAAA-1	CM
CGGACCACATAGCAGG-1	CM
GCTTAAGGTAGAAAGG-1	CM
CATGCCTCACTAGGAG-1	CM
TCGATTTTCGGTCTCT-1	CM
GCGGGTTGTTCAGAAA-1	CM
TGCTTTACATTCGTCC-1	CM
TTGACGACACTGTAAC-1	CM
ACAGAAATCAGGCCGT-1	CM
GGACACCAGGGTCTGA-1	CM
CCTATTACAAGCACTT-1	CM
TAGGAGGCAAGGATGC-1	CM
CCCGTTAAGGTTAGTA-1	CM
GTGGCGTCACAGCCAC-1	CM
TTACCCGTCCATACCC-1	CM
CGGTGCAGTAACATAG-1	CM
GCTCCTACAGGCACAA-1	CM
TGATGCAAGTCTGTGT-1	CM
ACATGGTCACCTGTGG-1	CM
AATACGCGTTGCCTGG-1	CM
TAACTTCCACCATTCC-1	CM
ACAGACTAGTGTGTAA-1	CM
GGTGAAGCAGGATGTG-1	CM
GATCGTACAATTCTCT-1	CM
CATTGGATCGCGCTGA-1	CM
TTACGGACACTTTGGA-1	CM
AAATGCCAGAGGTGGG-1	CM
CTGTTCGAGATGTTCC-1	CM
CTAGCGGAGGCCAATG-1	CM
GTGGCGTTCGCTATAG-1	CM
GCGAGTCGTTGGCGAA-1	CM
CTGCTCAAGACCAATA-1	CM
AATGTCGTCGAGTTAC-1	CM
AACTGGTTCCTGAAAC-1	CM
GGAGAACCAGGATGTG-1	CM
GTACTTTAGAATCAAC-1	CM
ATCCTGCAGGTTACAA-1	CM
GAATCTGCACCCATCT-1	CM
CCTGGGACAAGACTAA-1	CM
AACTGTGTCTCTTAAC-1	CM
TCAGGTATCGATCTTT-1	CM
ATGGATCCATAGTCCA-1	CM
TTGCGGGGTAGCGTTT-1	Myeloid
TGTGTCCAGCCATCAT-1	CM
GCGTAGCTCGCTCGGA-1	CM
CGCGCAAAGGCTTAAA-1	CM
GCTCACTCACGTTACA-1	CM
TTCATCAGTAGCTGTT-1	CM
CAAGAAAAGCTCGGCT-1	CM
AGCTGTAAGTCCCGCA-1	CM
GCACGGTCACTAGCCG-1	CM
TTCTAACCATTGATGC-1	Fib
AATGGCTAGTTAGCGG-1	CM
AGTGCGCGTAACCGAG-1	CM
CAGTGTACAGCGTCGT-1	CM
CAAAGCTCAAGTGGCA-1	CM
TCAGGTATCGGAGTTT-1	CM
ACTAGGTAGTCTCTAG-1	CM
TAGCCCTGTATCTAGC-1	CM
TTGTTGTCAGGTAACG-1	CM
ACTACCCCAAGCAATA-1	CM
GGATGAGAGCCTCGCA-1	CM
GGAACCCTCGTGGAAG-1	CM
GAGGTCCCACCGAATT-1	CM
CTTCTAAGTATTCGAC-1	CM
GAACCTAAGAGTAAGG-1	CM
TTCGCGTTCGATATGC-1	CM
TTGACGAGTGCATTGT-1	CM
AGTCCGGTCGCCACTT-1	CM
AGCTGTATCTCAGATG-1	CM
AGTGTACTCGCTATAG-1	CM
AAATGCCTCATGCTTT-1	CM
ACGGATTGTTGTGAGG-1	CM
CTAACTTAGACACAAT-1	CM
TACGCCTAGAGCTGTG-1	CM
TGATTTCCAGGCATTT-1	Fib
ACTAGGTCATAGTCCA-1	CM
GTAATCGGTAACTCCA-1	CM
CTCAACCTCTCGCGGA-1	CM
AACTTGGTCTCGGCGA-1	CM
GGTGCTGAGATTGACA-1	CM
CTTGTCGTCGGTAGGA-1	CM
GATTGACAGCTCGGCT-1	CM
TGATGCAGTTACACTG-1	CM
TCTCTGGTCTGTGTGA-1	CM
TGCTTCGCAATCAGGG-1	CM
GTTCAAGGTGGTTCTA-1	CM
TCCGACTGTAACTGAA-1	CM
TAACAGCTCTGTAGAC-1	CM
GTAGGAGGTGGACCAA-1	CM
GACCAATTCAATTGGC-1	CM
TGTGGCGGTTGGACGA-1	CM
TAGCGGCTCATACTTC-1	Pericyte
TCGAGCGAGTGTGTAA-1	CM
CATGTTTTCCCTACCA-1	CM
TGACAACCAAGCAGGT-1	CM
AGCCCGAGTTGGTAAA-1	CM
ACTACGAGTCAGACGA-1	CM
ATCCCTGGTTCCAGTA-1	CM
TACCTATCACAAGTGG-1	CM
CCACAGGGTCTAAAGA-1	CM
TTGAGTGAGAACAGGA-1	CM
GAATCTGGTATTCACG-1	CM
GCATTCCCAAGCGACA-1	CM
TATGTGGTCAGAATGA-1	CM
GGAACCCTCTGACTTT-1	CM
CGGTGCAGTAAACGAT-1	CM
AGTCCGGTCAAAGTAG-1	CM
TTTGGTTGTCTGGATT-1	CM
ACGTTAGAGGCAATTA-1	CM
GACTAGTAGATCGAGC-1	CM
CACAGATCACGTTGTA-1	CM
GAGCGCTTCGCTTGAA-1	CM
AGTGCCGGTTGAATAG-1	CM
GCCTAGGAGAGGTACC-1	CM
AACTGGTGTCAGACGA-1	CM
CCCAGAGGTTTAGACC-1	Endo
ATAGTCGAGGATCCTT-1	CM
CTACAGAAGACACAAT-1	CM
AGCCCGAAGTAACATG-1	CM
GTCGTAAAGCCGCAAA-1	CM
GGAGAACCAGAACAGC-1	CM
TATGTTCAGTTCGTTG-1	CM
CAGTATGGTCACAGGA-1	CM
GGGCCATAGAGTAAGG-1	CM
TGAGTCAAGTGCTCGC-1	CM
CACCTTGAGTACAGAT-1	CM
AGTGTACGTCAGGCTC-1	CM
TCAATTCAGAGCCTGA-1	CM
GCGCATGCACCAAGGA-1	CM
AATGGAAAGAGAGGTA-1	CM
GGAGTAGAGAGCAGCT-1	CM
GGTGCTGAGACCCTAT-1	CM
AGCGATTTCCAGGCCA-1	CM
GAGCGCTCAATCATCG-1	CM
AACGAGGCATAGCCAT-1	CM
TGAGCCGGTCCTTCAC-1	CM
TCTCTGGCAGGCATTT-1	Myeloid
CGGACCAAGTTCAAGA-1	CM
GCGAGTCGTGGTAGAC-1	CM
TCAGGGCGTTTCCACC-1	CM
CTCATGCAGAAAGGGT-1	CM
GAGTGAGTCGTGCTTC-1	CM
TATCTGTGTAGGTCTT-1	CM
AACTTGGGTAGAATAC-1	CM
AGCCTCTGTGCATTGT-1	CM
AGTCCGGTCCTATCAT-1	CM
TAGACTGAGCAATGTA-1	CM
TCAGGTATCCAGGTCG-1	CM
CGCAGGTAGGATATCA-1	CM
GAATCTGAGGCAATTA-1	CM
CCGCATTAGATCTCAC-1	CM
CATGTTTGTTGGCGAA-1	CM
ATGTCTTCAAACCGAG-1	CM
TTTGGCCAGCAGAGCT-1	Fib
CCCACATGTGAGTCGA-1	Myeloid
CCGTGAGTCTTCATAC-1	CM
ATTGTCTCAGCACATT-1	CM
TCCCACAGTCTGGATT-1	CM
TTAGCTTGTGCTGTGC-1	CM
CACAACAGTCGCGCTA-1	CM
ACTATTCCATAGCCGC-1	CM
CGCACAGTCCAGAATC-1	CM
TATCGAGCATCCATAG-1	CM
GTGTCAATCCAATCCC-1	CM
CATTGGAAGGTTCGAG-1	CM
GCACGGTTCTAAACGC-1	CM
CAACCAAAGTAATGTG-1	CM
TCGCAGGCATCGAGTT-1	CM
GTCTACCTCAATGCAC-1	CM
TCTCAGCTCGCGGCAT-1	Myeloid
TGGCGCAGTAGAATAC-1	Myeloid
TTACTCAGTGGACTGA-1	CM
TTGAGTGCATCGCCTT-1	CM
GGCGAAAAGATGTTGA-1	CM
ACTGCGGGTGCAACAG-1	CM
TTGCAGACAAAGCTTC-1	CM
TGAGCCGCACAGTAGG-1	CM
ACAAGCTCAACGACAG-1	CM
GCCAGCATCCATCGAA-1	CM
ACGTGGCGTGCAACAG-1	CM
GACTAACTCCGCTCTA-1	CM
CCTCCCTCAATGACTC-1	CM
CCACAGGTCTCAGATG-1	CM
AGGCGTCTCTCGGCGA-1	CM
GTTGGTACACTCAAGT-1	CM
GAGAACGGTAGAATAC-1	CM
TTACCCGGTTCCGGCA-1	CM
TCGAGCGCATTACCTT-1	CM
ATTTGTCTCGACTCGG-1	CM
TACTAGGCAACTGCGC-1	CM
GCCTAGGGTAGATGAT-1	CM
AGTTTGGCAGGACTGA-1	CM
TCAGGGCCATAGCCAT-1	CM
GGGCCATTCGTCTTAT-1	CM
TCTCAGCTCGTAGCGC-1	CM
CACTAAGGTGGAAGCT-1	CM
ATGCATGGTATGAAGT-1	CM
GTGGCGTTCTCATATC-1	CM
GCTCCTAGTAAACGTA-1	CM
CGCGCAACAGGTCTGC-1	CM
CTAGGGCCAGATGGCA-1	CM
GTGTCCTAGTAGTGTA-1	Myeloid
GCGAGTCCATCGTGAT-1	CM
GGTAGGAGTACCTATG-1	CM
GTCTACCCACTGTCGG-1	CM
TAAGTGCTCAGAGTGG-1	CM
TGGGTTAAGTACTCTG-1	CM
GAACCTACAGGGTAAC-1	CM
TGGAAGGGTCATTGGT-1	CM
TCGTTCGTCATTCTTG-1	CM
ACAGGCCTCAGATACC-1	CM
TGCACCTGTCAGGTGA-1	CM
ACGGATTAGTAATGTG-1	CM
GAAGAGCAGTGCACAG-1	CM
ACTATTCTCCGTACGG-1	CM
TGGTCAAAGACACTTC-1	CM
GCAACCGCAGGCACAA-1	CM
AGCCGCAAGGTTCTCA-1	CM
TGCGTAATCCCTACCA-1	CM
GCGGAAAAGACGTCAG-1	CM
GGTGCTGCAGTAAGCG-1	CM
GCGTAGCGTCAGAAAT-1	CM
CGCTAGGTCGAGAACG-1	CM
GCATTGAGTGATTCCA-1	CM
TTCTAACGTCGATAGG-1	CM
GAGAACGTCGCACAAT-1	Myeloid
GGGACCTGTAGAGAGA-1	Fib
TGGCGCACAGTCAGAG-1	CM
GACTAACTCCCTACCA-1	CM
TGCTCGTAGAAATTCG-1	CM
TTACCCGAGGAGTCTG-1	CM
ACAGACTGTGGAAGCT-1	CM
GAACCGCAGCGTTAGG-1	CM
CGAGTTATCAGAGTGG-1	CM
TAGGTGTCACATTCTT-1	CM
CTGGGACAGAGTTCGG-1	CM
GGATAGGGTCGAGGTA-1	CM
TGAATCGTCGGAGTTT-1	CM
TGCTATTGTCAACTGT-1	CM
TGCATGACAGTAAGAT-1	CM
GCTGCGATCGTGATAC-1	CM
GACCCAGAGCAGAGCT-1	CM
TGTGGCGTCGCGTGAC-1	CM
TGGAAGGGTAACAATG-1	CM
GTTACGACATCCGTAA-1	CM
TAGCGGCGTGCCCGAT-1	CM
CCATACCCAGGCATTT-1	CM
CACTGAAAGTGAGTTA-1	CM
TGGCAATCAGTAACTC-1	CM
GCGGTGTAGTACCTCA-1	CM
CCTATTACATTGTGAC-1	CM
GAAGTCTAGCGCACAA-1	Endo
GTAATCGGTTCCAGTA-1	CM
CAGTGCGCACAAGGGT-1	CM
AGATAGATCGTCCCAT-1	CM
GTGTCCTGTATCATGC-1	CM
GCCCAGATCGGATGTT-1	CM
CTTCCAGTCCGTTAGA-1	CM
TTCAACTGTCCATTGA-1	CM
CCGTAGGCATTACTCT-1	Fib
AGGCCTGAGGGTCCCT-1	CM
CAAGCTACAGCTTACA-1	Endo
CAGTGTAGTCAGGTGA-1	Endo
TTAGCTTTCAGGCGCT-1	CM
GCGTTGGTCATCGCAA-1	CM
CTCAGCTTCGTCAACA-1	CM
ACTGCGGTCTGATCCC-1	CM
GGCACGTCAAACTACC-1	CM
GGAACCCGTGCGTAGA-1	CM
GACCGACCAACGGGTA-1	CM
TCAAGCAAGTTAGCAA-1	CM
GCCATAAAGACACGGT-1	CM
ATGTCGATCGTTGTTT-1	Endo
CTCAACCGTTCTGAAC-1	CM
GCTTTCGGTCATTGCA-1	CM
TGTGACACAGCAACGA-1	CM
TACAGCAGTGGAAGCT-1	CM
TTAGCGAAGGCGACTA-1	CM
GCCATAACAGGTGTCC-1	CM
GCTGTTCCATATAGAG-1	CM
GAAACAAAGAGGAAGT-1	CM
TTTGTGTTCGGTCGAC-1	CM
GCATGATCAAGGGTAC-1	CM
AGCGATTGTTTGCCAA-1	CM
AGCTGTACATGCGACC-1	CM
CCTGCTAGTAAGCCGA-1	CM
ACAAAGATCTTACGGA-1	CM
TCACAAGCAGCAACAG-1	CM
AGTTTGGTCGGGAATG-1	Fib
GTGGCGTTCCCTATTA-1	CM
GCTTGCTTCTAGCTGA-1	CM
AGCCTCTAGAGGTCCA-1	CM
CTCTCGAGTAGAATAC-1	CM
GAACCGCAGAACGACC-1	CM
TTTGTGTCAATCATCG-1	CM
CTCCCAAGTAGTTTGC-1	CM
CTGGCAGCACCCTTTG-1	CM
TAGCACAAGTGAACCG-1	Fib
AGCCCGACATGGTATC-1	CM
CGTGGCACAGGGTAAC-1	CM
GCAACCGAGTTCCCGG-1	CM
GCCATAATCTCGTAGA-1	CM
TAACTTCCACTGCTTC-1	CM
TCCAGAAGTTGGCTAT-1	CM
TGGAAGGCATCGACCG-1	CM
CGCTATCCATTTGTTC-1	CM
GAAATGAAGTGCTGAG-1	CM
ACGTTAGAGTAGGAAG-1	CM
TGCCTGTGTAGCGAGT-1	CM
TTACCGCCATAGATAG-1	CM
TTTACGTCAACTGCGC-1	CM
ACTATTCTCCCGATTC-1	CM
TCCATCGGTGAATCAA-1	CM
TCAGTCCGTAGAGAGA-1	CM
CAGCTAACACCGTTGG-1	CM
TTGAGTGTCCTGTAGA-1	Pericyte
TTACGGACAACGTCCG-1	CM
CAAAGCTCATAGCCAT-1	CM
AACTGTGGTTTCCACC-1	CM
TTGAGTGAGAGCTGTG-1	CM
GCCCGAACACAGATGG-1	CM
CTTGTCGAGTTCAGGG-1	Myeloid
GATCGTACACACACCG-1	CM
ACCGGGTAGGAACCGT-1	CM
AGCGTATTCCAATAGC-1	CM
AAATGCCCACCTGGTG-1	CM
GACCAATTCTCTATTG-1	CM
AAACGAATCGGTCTCT-1	CM
TTCGTTAAGAAATACC-1	CM
AAGGAGCAGGCTCCTG-1	CM
GTCACGGCAATTCGTG-1	CM
AGCGATTGTCGATAGG-1	CM
ATCCCTGCAGGGAGTT-1	CM
CAAGGCCCAGGTGGTA-1	CM
TAGTCCCGTTACGGAG-1	CM
GAGCGCTGTTACCCAA-1	Endo
CTTAATCAGAGTTCGG-1	CM
TGCACCTGTAATGCAA-1	CM
CTTGAAGGTGGTACTT-1	Myeloid
TTGCTTAAGACTTCCA-1	CM
CAGTGTAAGTACAACA-1	CM
CAGTATGAGTGCTGAG-1	CM
GCAAAGGGTATTCTCT-1	CM
ACGGATTCACATGATC-1	CM
GCGGAAATCGACTCGG-1	CM
TTGCAGAGTGAATGTA-1	CM
GCATTGACAACATAAG-1	CM
TAAGTGCGTGCAAGCA-1	Pericyte
TCTCAGCGTTCCGCGA-1	CM
CTTCTAAAGCGGACAT-1	CM
TTAACGGTCCCACGGA-1	CM
CTTGCTGTCCAATAGC-1	CM
CCCTGATAGAGCGGTT-1	CM
GGTGCTGTCTTACTCA-1	CM
CAGCTAAAGGACCGAT-1	CM
CGGTGCAAGTCTGGGA-1	CM
TCAGCTCGTAGACACG-1	CM
GGCGAAACAGTATACC-1	CM
GAGGCTCCATGTGAGG-1	CM
ATCCCTGCAATGGTCT-1	Pericyte
GGACACCCACACACAT-1	CM
GGCATTACAAGACTAA-1	CM
GGATAGGTCACTTACT-1	Fib
AGCTGGCCAAGCACTT-1	Myeloid
CGTTCCAGTTCCCTTG-1	CM
CCGAAGCCATATTGGC-1	CM
CCACGTTCACCTATTT-1	CM
TGTAAGCCACATAAAG-1	CM
TTGCAGACAAGCTTTG-1	CM
TGCACCTTCGTTCCGT-1	CM
TCCATCGTCGGCATAT-1	CM
CCACAGGAGGTTCTCA-1	CM
TGCCTCACAGAGAGAA-1	CM
CGAGTTATCAAACCAC-1	CM
CGGACTGGTGGCATAG-1	CM
GTCCATCTCAAGGCCC-1	CM
TGCTTCGTCCGCGATG-1	CM
ACTTCCGAGTACGCGA-1	CM
AACATCGCATTACCTT-1	CM
ATTACCTAGTGTTCCA-1	CM
AGGACGAAGTCCGGAA-1	CM
GAGACTTCAGGATGTG-1	CM
CAACGGCGTCACCCGA-1	CM
GTGCACGCATTACTTC-1	CM
GTGGATTGTCGCTAGC-1	Myeloid
GATTAGCTCGCTTGAA-1	CM
TTTGAGGGTGCTTGAT-1	CM
GATTGACCATGTGAGG-1	Fib
TGCATGACACGACGAA-1	CM
GCGGTGTCAGGACCTC-1	CM
GTCACGGTCGTCCCAT-1	CM
GGTGAAGTCCCACGGA-1	CM
CCTTAATAGTCTGGGA-1	CM
CCTTGCACACAGCCAC-1	CM
GCACGGTCACAGAAGC-1	CM
ATGTCTTCATACTGCA-1	CM
TCTCTGGCAAAGAGAG-1	CM
CTCTCGAGTTTCCGGG-1	Fib
TTGCGAAAGACCCATT-1	CM
ACAATCGGTGAATCGG-1	CM
GCAGCCAGTAGGGTCA-1	CM
CTTTGCGGTGTCCTTC-1	CM
TCAATTCTCAGTGTGT-1	CM
GTGTCCTCAACGTACT-1	CM
GCACGGTCATGATCGT-1	Endo
TTACGTTTCATCGCCT-1	CM
GCACCTTAGAGGTACC-1	CM
ATGCATGAGTCTTAGC-1	CM
GGTGAAGCAAGGGTAC-1	CM
AACAAAGCAATCAGGG-1	CM
ACTGCAAAGGGTTCCC-1	Fib
ACAAAGATCAGGCCGT-1	CM
TTAGCGATCACTACCC-1	CM
GTACTTTCACCACAGC-1	CM
GATCGTATCTTGTCAT-1	CM
CACATGACAGGGAGTT-1	CM
CCGTACTAGTACTCTG-1	CM
GGAGTAGGTCAGCTTA-1	CM
TCAGCTCGTAGCCATT-1	CM
GTGTCCTCATCGTACA-1	CM
GTACTTTTCAACTTGG-1	Pericyte
GCGCCAAAGACTTCCA-1	CM
GTAGACTTCAAGAGGC-1	CM
AACGTACCACTACACA-1	CM
CCAGAATCATCTCACC-1	CM
AAATGAGTCTTGTACT-1	Fib
AAAGGGCGTCTGTTGA-1	CM
TACGCCTAGTCGATAA-1	CM
CCCTAGTAGGAGACTC-1	CM
AGCGATTTCGCAGATT-1	CM
CTCAGCTCATCCGTGG-1	CM
TAGACTGGTGTGACCC-1	Pericyte
TCGGGACCAATGAAAC-1	CM
CTGGCAGAGTGTCCCG-1	CM
ATGTTTCAGAGGCGGA-1	CM
TAGCGGCAGAAATGGG-1	CM
CTGCTCACATAGACGG-1	Fib
ACATGGTGTCAGTGTT-1	CM
GACCTTCTCTCTGAGA-1	CM
TTAGGTGTCTTATCAC-1	CM
TAGTCCCAGCCGCTGT-1	CM
CACGTTCCATAGACGG-1	Myeloid
AACGAGGGTCTCTAAG-1	CM
TTTACGTTCTATCTCA-1	Fib
CAAGCTACACAAACAA-1	CM
ATGTCGATCCAGGCCA-1	CM
AGCCTCTAGTGATTAG-1	CM
TAGGAGGTCTCCTTAA-1	CM
ACTTCCGCACAACGGA-1	Fib
GTGATCATCTTCCAGC-1	CM
GGGTTATAGTATGGGC-1	CM
GGGCCATAGAACCCGA-1	CM
GGGAACAAGAAAGGGT-1	CM
TACTAGGTCTCTATCA-1	CM
GATTGACTCGCTTCAC-1	CM
CTCTACGAGGTCCTCG-1	CM
TAACGGTTCACTCGGG-1	Fib
AACTGGTGTCGTAGTT-1	Myeloid
CAAGGCCAGCCTATAC-1	Pericyte
TGATTTCCAGCAACAG-1	CM
AGATTCGGTATTGTCG-1	Fib
AAAGATGTCAAGAGGC-1	CM
CGCGCAAGTATCCCTC-1	CM
GAACCTATCGCACCTT-1	CM
ACTGCGGAGGTGAACC-1	CM
AGACAAAGTTCACGTA-1	CM
ATGCATGTCTGGCACG-1	Fib
ACTACGATCTCCTTGG-1	Fib
GGTGAAGAGCAACGGT-1	CM
GTGCACGAGGCTAAAT-1	CM
TATCGAGCAGGCATCC-1	CM
CCCACATGTGCATCAT-1	CM
CCAGAATAGGCTTTAC-1	CM
ATCCTCGGTGCATCAT-1	CM
GTGCTGGTCTATCCTA-1	Fib
GAGATTCCACGGCCAT-1	CM
TTGCCCAAGTATAGTG-1	CM
TAGCTTTAGTGATATG-1	Myeloid
CCTCCCTTCGATGCAT-1	Fib
GGGTGTCTCTGGCGCA-1	CM
TTACGTTGTCAGCTTA-1	CM
GTTCAAGTCGTCGCAG-1	Fib
ACTATTCTCCATTGAG-1	CM
CACATGACACCGTCTT-1	CM
TAAGTGCGTTACGAAA-1	CM
GACCGACGTGGAAGCT-1	CM
ATCCAGAGTTCCCGGA-1	Fib
ATGCATGAGATGTTCC-1	CM
GAACTTGGTGTCCTTC-1	Fib
GAGTGAGGTACTATGC-1	Fib
GCCATAAGTAAGTGCG-1	Myeloid
GTGTCCTGTAGACGCA-1	Fib
TAGCATGTCGCGGCAT-1	CM
AACGGGAGTACTTCGA-1	CM
CGCTAGGGTCTGCGCA-1	CM
ACCCAAAAGTGAGTGC-1	CM
GTGTGATCACAAACAA-1	CM
AAACTCGCATCGAGTT-1	CM
CTGAATGCAACCTCTC-1	CM
TACTAGGGTAGGTAAT-1	CM
TCGTTCGCAAGGAGGG-1	CM
CACTGAAGTCGGCTGT-1	CM
AATGTCGAGGGTTCCC-1	Fib
ACTAACGTCCAACCTC-1	CM
GAGCGCTCACTCGGAC-1	CM
AAATGCCCAAAGGTCG-1	CM
GCACCTTGTAGGGTTG-1	CM
CTAGGATGTGGACCAA-1	CM
TTGCCCAGTGGATTCT-1	CM
CCATACCTCAGGATCT-1	CM
TCAATTCGTTCTTAGG-1	CM
TTTACGTCATTATGGC-1	CM
GACCTTCAGAGAGGTA-1	CM
ACGTTAGGTGCGACCT-1	Fib
ACTACGAGTATTTGCG-1	CM
CTCACCACATCCCGGA-1	CM
TGTGTCCCACCGTCTT-1	CM
TCGAGCGAGGCCAATG-1	Endo
TATGTGGTCAGTCTTT-1	Myeloid
TTGCGGGGTGTGTGTT-1	CM
TCGTTCGAGACACTTC-1	CM
GACCGACCAATGCATC-1	CM
AGGCCTGTCACTGATG-1	CM
GTGATCATCAAGGCAG-1	Fib
ACCAAACAGATGTTGA-1	CM
ACCGGGTCATGCCTTC-1	CM
CGCAGGTAGTCTCTAG-1	Fib
CACAACAAGGTGTTGG-1	CM
AGGACGATCTATTTCG-1	CM
AGTGCGCCATGCACTA-1	Fib
TGATGCATCTTTCGAT-1	CM
GGAACCCAGAGAGTTT-1	Fib
TACATTCCACAATAAG-1	CM
GCAGATTTCGTCTTAT-1	Endo
ATATTCCAGCAATGTA-1	CM
CTGTATTAGTTGCGCC-1	CM
AGTGCCGTCACCACAA-1	CM
CCTTGCAAGTTCGACT-1	CM
TTGAGCAAGAGGAAGT-1	Fib
AACTTGGAGAGCCACA-1	CM
TCGATTTCAACACGGA-1	CM
TCGCCTACAGAACAGC-1	CM
AGCGATTCAACGGGTA-1	CM
CTAGCGGGTGTACGCC-1	CM
GTGGATTTCGTTTGAG-1	CM
GCTTAAGTCGTGTGCG-1	CM
AATGCCACAAGGATGC-1	CM
GGTGTCGTCGTTGTAG-1	Fib
CTCAACCGTAACTCCA-1	CM
TCGATTTAGAAAGGGT-1	Fib
TACTCGCCAATTCAGC-1	Fib
GCAAAGGCACAAACAA-1	Myeloid
CATGCCTAGAACGTTA-1	Fib
GAGCATTTCGTCTTAT-1	CM
GCGCATGCACAGGAAC-1	Neuronal
GGTGCTGCAACTAGAA-1	CM
AGCTGGCTCTACCCGT-1	Myeloid
ACAAAGAGTAACCCAT-1	CM
TATGTGGGTCGCTACG-1	CM
GGAGGATTCCTCCAGT-1	CM
TTGCACCCACACATTG-1	CM
GCTGCGAAGATATGTG-1	CM
GGATGAGAGCTGCTCG-1	CM
AACAGTCGTACTTCGA-1	CM
CTTTGCGCACACACCG-1	CM
CGCTAGGCAGATGGCA-1	CM
CAGCTAACAACTAGAA-1	CM
AGGCGTCGTTGGCGAA-1	CM
CACCTGTAGATTACGA-1	CM
GGGTTATAGACGCCCT-1	Fib
AACGAGGGTAACATAG-1	CM
CGCAGGTCAGGCAGAT-1	CM
GTGGCGTTCCAAGTCA-1	Pericyte
GCTCAGGTCTGAACGT-1	CM
CTCTAGCGTGCTTTGA-1	Endo
ACCGCAGAGTAGAAGG-1	CM
TGAGTCACAATTGGCT-1	CM
AGCTGGCGTGACGCAA-1	CM
AGGCGTCGTTGCCTGG-1	CM
CAAGCTACAAGTCTCA-1	Fib
GTAGTACAGGACCGAT-1	CM
TGTGGCGCACGCTAAT-1	CM
ACATGGTTCGCACAAT-1	Fib
GCGTAGCGTCAGCTTA-1	CM
TGAATCGAGAGCTCCC-1	CM
CTTCCAGAGGGAGTTC-1	Fib
CCCACATGTGTCGTGC-1	CM
GCGATTACATTACCTT-1	CM
ACGGATTAGATCGAGC-1	Myeloid
TCTAGTTCAGCCGAAA-1	CM
TTACGGAAGCTTTCCC-1	Pericyte
CAAGAAACATGGGACA-1	CM
CCCTAGTTCTCTATTG-1	Fib
TGGCAATCACTCCCAT-1	Fib
CTGCGTTGTCTGCACG-1	CM
ATTACTCTCAGCACTA-1	CM
AACTGTGCATCGTACA-1	Myeloid
AGTTACGTCCATAGGT-1	CM
CACATGATCCTAGAGT-1	Myeloid
TTTGAGGAGTGTTCCA-1	Endo
ACGTGGCTCAATTGGC-1	CM
GTGTGATGTACCCACG-1	CM
ATAGTCGAGTACGACG-1	CM
ATGTCGATCTTCTTCC-1	CM
GGCACGTTCCCTACGT-1	CM
GAACTTGAGGTCTTTG-1	CM
TGTGACACAGTAGTCT-1	CM
AGGCCCAGTAGCTGTT-1	CM
TGTACGAGTTCTTTCA-1	CM
GCTTTCGGTAGCAGCA-1	Fib
GCGATCGCAAACCTAC-1	CM
GTGACATCATTTGGCA-1	CM
GTGGATTCACCGATCG-1	CM
CCACGTTCATGCACTA-1	CM
CAATCCCCACCACAGC-1	Endo
CCCGTTAGTAACACTC-1	Neuronal
AGCGTATAGGTCGTTT-1	CM
AACGTACCATGATTGC-1	CM
TCCGACTCATGCCTTC-1	CM
TAGCTTTGTGCTAGTT-1	CM
ACCTGCTTCAGTTGAC-1	CM
TCGCAGGTCTTGTGCC-1	CM
CTAGCGGGTATTCTGG-1	Myeloid
ACGGATTAGAAATGGG-1	CM
GTCACCTGTGTGCTTA-1	Endo
GAAGTCTAGAGTCCGA-1	Endo
TGTAAGCCACTGTTAG-1	Fib
TTGAGTGAGTTCGTTG-1	Myeloid
TGAGCCGTCACAAGCT-1	Fib
TAGGTCACATCAGAAA-1	CM
GATCGTACATTACCTT-1	CM
AGCCAGCAGTGATCTC-1	Myeloid
GCGAGAAGTTTGCATG-1	Fib
AAACTCGTCGCATACA-1	CM
TGATGCATCCTGGGAC-1	CM
AGCTATGGTCAATCCA-1	CM
CCTTGGTTCCAAGTCA-1	Fib
CTTGCTGAGTGCTGAG-1	Endo
CTCTCAGTCCGAGAGA-1	Neuronal
CCTAAAGCAAGAAACT-1	Myeloid
ACTGCAATCAAACCAC-1	Myeloid
TCGATTTGTCACATTG-1	CM
GGAATCTGTTAGCTCA-1	CM
GGATAGGAGGAGAACA-1	Pericyte
TTCATTGGTTTGTACG-1	CM
GCTCAGGTCCATCTAT-1	Myeloid
GGGTCTGCACCTGAAT-1	Fib
CTAACTTGTGCTTACA-1	CM
AGATAGATCAGAGTGG-1	CM
GGTCATACACGTTAGT-1	CM
CAGCCTTCAAGGTTCT-1	Endo
TTAACGGCAATTGTGC-1	CM
GGAGGATGTAGGTAAT-1	CM
GCAAAGGCAGATTTGC-1	CM
AATGGCTTCCACGAGC-1	CM
CGCAGGTAGTGATATG-1	Fib
CCCTCTCGTGTCTCGG-1	CM
CTTAATCTCCGTACGG-1	Fib
TGTGACATCACGATTG-1	Endo
GAACGTTGTCCGTGCA-1	CM
CCCTAACGTTACGAAA-1	Endo
TTATGTCTCGGTACTA-1	CM
TGACAACTCCGGACTG-1	CM
AAACGAATCTGGCCAG-1	Pericyte
CTCACCACACTGCTTC-1	Endo
TGACTCCCAGTAAGCG-1	Pericyte
GTCACCTGTGACCAGA-1	CM
TGGTCCTGTGCTGAAG-1	CM
GTAGGAGAGAAGCCGT-1	Myeloid
CCAGAATTCTATCTTG-1	CM
GATCATGTCAAGGCCC-1	CM
AACGAGGGTCCCTTTG-1	CM
AGCCTGGAGGAAGGTA-1	Endo
ACTGCGGCAAGGATGC-1	CM
GAACCTATCTAAACGC-1	Myeloid
TAAACCGAGGTCTTGT-1	CM
ACCATCCGTAGTCCAT-1	Fib
TGGCAATAGTTCGTTG-1	CM
CACCTGTTCGGTGATT-1	CM
GCAGATTCACGATTAC-1	CM
GCCTAGGAGTTCCAGT-1	CM
TACAGCACAATGCATC-1	CM
GAAATGACAGAGCCAA-1	Fib
ACTGCAAGTGCTTGAT-1	CM
TTGCAGACATTTGGTG-1	Fib
GTGCTGGTCGAGAAGC-1	Fib
AGCGTATGTGCTTACA-1	CM
CTGAATGTCGTTTGAG-1	Endo
CTTGTCGCAGCGTCGT-1	Pericyte
GCGAGTCGTCAACTGT-1	CM
CCCTAGTTCCATTGTT-1	CM
TTGAGTGCAGGTGGTA-1	Pericyte
AAAGGATGTATCCTTT-1	CM
GGATGAGCAGCGTACC-1	Endo
ACTATTCCACTGTCAA-1	CM
GTCACTCAGACCCATT-1	Fib
ACTACCCGTCACAGGA-1	Fib
TTGTTCAAGAGGTACC-1	CM
TATCTGTGTTCAGTAC-1	CM
CGCTATCAGTGTGTAA-1	CM
GGGAACAGTTTCGTTT-1	vSMCs
CTCAGAAGTCCGGTAC-1	CM
TTCGCGTCATGGTAAA-1	CM
CGCTGGATCGGTACTA-1	CM
CAGGATTAGACGCCCT-1	CM
CCGTGAGGTCTGGTCG-1	vSMCs
GAGGCTCAGAGCCTGA-1	CM
GCAGCCACATTTCACT-1	Fib
GCGAGAAGTGGAGTGT-1	Fib
CCATACCTCAGTCAAC-1	Fib
GATGATCGTGCGTAGA-1	Fib
ATAGTCGTCAAGAGAT-1	Pericyte
CCATACCTCTACATCT-1	Pericyte
AAACTGCCAGCTATAC-1	Pericyte
TCTATTGGTAGACGCA-1	Myeloid
TACAGCACACAAGGGT-1	CM
CTCAGAAGTTGGAGGT-1	CM
TTACTCAAGAACTAAC-1	CM
CGCTATCCAAGTCCTA-1	CM
AATGGCTGTTAGCTCA-1	CM
GTTCAAGGTCTAAGAA-1	Myeloid
TTGTCTACAACAAACA-1	Fib
TCGAGCGTCTCTGCAC-1	CM
AGTTACGAGGCTAAAT-1	Myeloid
TGACAACCACCGAAAG-1	Myeloid
ACAATCGAGTAGTGTA-1	Pericyte
TACCTATAGTAGGTCG-1	Myeloid
GCCATAAGTATCTAGC-1	Fib
CAACGGCAGCCTCGCA-1	CM
GCCCGAAGTATTCTCT-1	Fib
CAGCTGGGTGAATGTA-1	CM
GGATGAGAGTGAGTGC-1	CM
GGAGAACTCCGAGGAA-1	CM
CAAGCTATCTGTTGCC-1	CM
GGGACCTAGGAATGGA-1	Endo
CCCTAGTTCGGTCAGC-1	Fib
TGAATCGTCGACTGGC-1	Myeloid
CCCACATCAAGTCTGT-1	Pericyte
CTACTTAGTCGTAATC-1	Myeloid
TTGCCCAAGCTTACCA-1	Fib
GATCATGTCACTTACT-1	Myeloid
GATGGCCTCCGGCGAT-1	CM
TCAATTCTCATGAACC-1	Fib
GTGTCAATCTCTGCAC-1	CM
TTCGATTAGAACGTTA-1	Myeloid
GATTGACGTCTGGATT-1	CM
GCTCACTGTTTGTCTT-1	CM
TTACCCGAGACGAAAG-1	CM
CTGGGACCAGCTGATT-1	Fib
AAACGAAGTTGCAGAG-1	vSMCs
ATCCAGATCTTGCGCT-1	Pericyte
TGAGCCGTCCCGATTC-1	CM
GAACCGCCATGCCTTC-1	CM
ACTGTCCTCTGTTGCC-1	CM
GGACACCAGAAGCCGT-1	Fib
TTTACGTAGTACAGAT-1	Myeloid
AGCGATTCAAATGCTC-1	CM
GACTAGTCAAAGCTGG-1	CM
CTTTGCGCAAGAAACT-1	CM
AAATGCCTCGTCCCAT-1	Fib
TGGTCCTTCCAGAATC-1	CM
CACCTGTAGTGAGTGC-1	CM
AACTGTGAGTTTGGAA-1	Fib
CTTAATCTCGCTTACC-1	CM
ACTATTCTCTCTTCCT-1	Fib
CCCTGATTCCTCCCAA-1	Endo
CCCTAACCATTAAGGA-1	Pericyte
TTGGTCCGTCCAGACC-1	Fib
AGGCCTGAGGTAGGAA-1	Myeloid
AGCTATGGTCATGAGG-1	Myeloid
CACCTGTAGACAGTGC-1	Pericyte
CGGTGCAGTTTCGTTT-1	Pericyte
TCTATTGCATCAACTG-1	CM
CCGAAGCAGCAGAAAG-1	Endo
GAATCTGAGCTCGTTA-1	Myeloid
TAACAGCAGCCTCGCA-1	Fib
CTTCTAATCTCTATCA-1	Myeloid
GGTAGGATCTGGACAT-1	CM
TGCACCTCAACCTCCT-1	CM
CACTGAAAGTGGGACT-1	Fib
CTCACCATCGACTGGC-1	Pericyte
GTAATCGAGGCTAAAT-1	Pericyte
TTACTTGAGTAGAAGG-1	Pericyte
AACTGTGTCGCTATTT-1	Endo
CGTGGCATCTTCCGTG-1	Pericyte
CTCTCAGCAATTCTCT-1	Myeloid
CCTTAATGTTCCCTTG-1	Fib
CAGCCTTAGAGCCTGA-1	Fib
TAATTCCTCTAGCAGT-1	CM
GGGTTATAGAACGTTA-1	Pericyte
TCTATTGTCACCGCGA-1	CM
GTTACGATCTAGTCGA-1	Endo
TGTTAGGTCTGGAAGG-1	Myeloid
CAGTATGTCTAAACGC-1	Endo
TTCATTGAGATGGGAA-1	Fib
ATGTCTTAGAGTTCGG-1	Fib
CTTGTCGTCGCCGAAC-1	CM
GTGGATTAGGGTGTTG-1	Myeloid
TTCGCGTAGCGTCTGC-1	CM
TTACCGCCAGTAGTTC-1	CM
ATCGAGTAGTCCGTGC-1	CM
TTGAGCAGTCCTTATT-1	Fib
AATACGCGTTAGTAGA-1	Myeloid
TAACGGTAGTACAACA-1	Endo
TACGCAAGTTGGCTAT-1	Endo
CAATCCCGTGGGTAGT-1	CM
GTACTTTCAAGACACG-1	CM
GAGGTCCGTAGTGATA-1	Fib
CTACAGAAGTGAAGGA-1	CM
TCAAAGCCACTGTTAG-1	Fib
GTGGCGTTCAGTGTGT-1	Neuronal
GATGGCCGTAAAGCTA-1	Endo
GCTTAAGCACATTCTT-1	Pericyte
ATCCAGACAGGCACAA-1	Endo
ACTGCAACACAGTTCA-1	CM
AACTTGGCATGCCTTC-1	CM
GGAACCCGTTTGTCTT-1	Myeloid
GCGAGAAAGATTAGAC-1	CM
AAACGAATCTATCTCA-1	Fib
CAAAGCTTCCAGGTCG-1	Myeloid
CACCTTGTCCTGTAGA-1	Pericyte
TCTAGTTAGTGCACAG-1	Endo
AACTTGGCAACGTACT-1	Pericyte
CGGTGCAAGTCCGTGC-1	CM
TTCGTTAAGACGCCAA-1	Fib
ACTCGGGCACGCGACT-1	CM
AGTCCGGTCAGCACGC-1	Myeloid
CAAAGCTAGGGTAATT-1	Myeloid
TGTGTCCTCTCTCAAT-1	Pericyte
CTCCCAAGTCAAACAA-1	Pericyte
GAGACTTGTACAACGG-1	Myeloid
CAAGGCCGTAGCAGCA-1	CM
CTCTACGTCAACGTGT-1	Myeloid
CACTGAACAAGATGCG-1	Pericyte
AGCCTGGAGGTGTTGG-1	Pericyte
AGCCTGGCATTTCTTG-1	CM
ACGGATTAGGGTATCG-1	Pericyte
ACCATCCGTAGTGATA-1	Endo
TGCCTGTCAACGTAGG-1	Myeloid
AAACTCGCATAAAGTG-1	Endo
CTCAGAATCGTGGTAT-1	CM
TAAGTGCCAAGTAATG-1	Myeloid
GTCACAACATCACAGT-1	Pericyte
TATCTGTCAATCACTG-1	Fib
TTGCAGAGTGCTTTGA-1	CM
TCAGGGCGTGTGTGTT-1	Endo
TTCGTTAGTTTGGATC-1	CM
GCGGAAAAGCGTGTTT-1	Fib
CAAGCTACATCATAGC-1	Pericyte
ACTATTCAGTCGAGCA-1	Neuronal
GGGAACAAGGTTGTTC-1	Fib
CTCACCAAGGCGTAGT-1	Fib
TAGCATGCAACGTACT-1	Pericyte
AGCTGTAGTGTCGTCG-1	Pericyte
CAATCCCGTGGACAGT-1	Endo
CAAGAAACATTACTCT-1	Pericyte
GGAGAACAGTCTTAGC-1	Endo
TCGGGACAGTAGTTCC-1	Fib
GCCTACTAGACTAATG-1	CM
CAAGGCCCACCGTCTT-1	CM
GGTGAAGCACAGGAAC-1	Fib
TGTACAGAGGCGTCCT-1	vSMCs
ACCGAATTCGTGGCGT-1	Endo
GGTGAAGTCCATGTTT-1	Pericyte
TGCCTCATCTTTCGAT-1	Myeloid
GAAACAAGTATTCTTC-1	CM
GATGATCAGTTGGAAT-1	Endo
TGGAAGGGTCATGAGG-1	CM
CTCTACGCACGTTACA-1	Fib
CCCTCTCGTCGATTAC-1	Fib
TTAACGGTCGCAACTA-1	Endo
TTCTGTAGTTCCCGGA-1	Myeloid
CTGAATGCACTCCCAT-1	Myeloid
TGTAGCAAGACGACTG-1	CM
GACCGACAGCGTCAAG-1	Fib
GCGATCGGTATCTCAG-1	Endo
GTGACATTCCTAGAGT-1	Pericyte
TTCTAACGTACGTATC-1	CM
TAGCATGAGGAGTACC-1	Endo
TACTCGCCACAACGGA-1	Pericyte
AGCTGATGTTGGCTAT-1	vSMCs
TCCATCGCATTCACGA-1	Fib
TTACCGCTCGCAAACT-1	Fib
TCAATTCTCTATCCTA-1	Pericyte
TCACAAGCAAATAGTG-1	Endo
GTTATTCCAACGCACC-1	Pericyte
TTCTAACAGAGCAGCT-1	Myeloid
CACCACTAGGCAATTA-1	Myeloid
CTCACCAAGGCACTAG-1	Myeloid
AACGGGAAGAAGACTT-1	Myeloid
CTCAGCTCAACCTCTC-1	Endo
AGCTGTAGTACTAGAA-1	Myeloid
GAAACAAAGTGATAAC-1	Fib
GGTCATATCGCCAGAC-1	Endo
GAACTTGCAATCAGGG-1	Pericyte
GCTGCGATCTGAGTCA-1	Fib
CACCTTGGTGCGACCT-1	Myeloid
AACTGTGTCGGATGTT-1	Endo
GCGCCAACATGTCCCT-1	Endo
TCGATTTAGGCAATTA-1	CM
CACCTGTAGGTTGTTC-1	CM
AGTTACGCATCCCAAA-1	Endo
TGGGTGCTCACTTACT-1	Pericyte
ACCTGCTCATGTAGAA-1	Pericyte
TAACAGCAGTAGACCG-1	Endo
CCCACATTCTGTTGCC-1	CM
CCGTACTCAATTCGTG-1	Endo
TCAGTCCGTAACAATG-1	Myeloid
TGAATCGGTCTCAAAC-1	CM
GTCACGGCACCTGAAT-1	Endo
GCCAGCAGTATTCGAC-1	Myeloid
TATGTTCGTTACCCAA-1	Pericyte
CGGTGCATCGTGCTGG-1	Fib
AATGGAAGTTCCGGCA-1	CM
TTTGAGGGTTAACCAC-1	Endo
CAAGGCCGTGTCCAGC-1	Endo
GTTATTCTCAAATGGA-1	Myeloid
CCTAAAGTCTTGTACT-1	Pericyte
ATTCGTTCACAAGGGT-1	Myeloid
AGCGATTTCCTAGAGT-1	Pericyte
CCGAAGCAGTGATAAC-1	Pericyte
CCTTAATGTGAGGGTT-1	Pericyte
TAACTTCAGGTTCGAG-1	Pericyte
GCCCAGACAGGTTATC-1	Fib
ACAGGCCTCATTGCCC-1	Endo
ACCGGGTGTCATAGAA-1	CM
CCAGATACAGAAGTGC-1	Endo
GCGAGTCAGCGCATTT-1	CM
AGTGCCGCAGCAACCC-1	Pericyte
TAGCTTTGTTTAGAAG-1	Pericyte
AGTGCCGTCTGGTACA-1	Pericyte
GGAGAACTCCAGTTAG-1	Pericyte
GTCACGGCATTCTCGC-1	CM
CCCTAGTGTCTGTTGA-1	CM
ACTAGGTAGAGAGGTA-1	Fib
ACATGGTTCTCTGTTA-1	Endo
AAACTGCCAGTTGCAT-1	Fib
CGATGATTCGTCAACA-1	Pericyte
CAGCCTTGTGCTGGCT-1	Endo
GTGACATAGGGAAGCG-1	Pericyte
GTGTCCTTCTCTGCAC-1	Fib
GCTTGCTAGCTAGCAG-1	Pericyte
TAGCCCTTCTAGCAGT-1	Pericyte
GCTTGCTTCCGCGATG-1	CM
GAAGTGGTCTTACCTA-1	Lymphoid
TGAGCCGCATGGTTTG-1	Pericyte
GAACCTAGTCATGAGG-1	Fib
ACCTGCTTCACATTCT-1	Pericyte
GTCTACCTCCATACCC-1	Myeloid
TTAGCGAGTGCACATT-1	Endo
GTGGCGTGTTTGCATG-1	Endo
ACTTTCAAGCACCATT-1	Pericyte
GGAGGATCAGGGTACA-1	CM
ACTTCCGAGTAGAAGG-1	CM
GAAAGTAAGATCTCAC-1	Pericyte
AAAGATGTCACTAGCA-1	Pericyte
TAACAGCCACGTTACA-1	Pericyte
CTTTGCGCACATTGCA-1	Endo
CAGTGTAAGCTGCCAC-1	CM
AATGTCGGTGCAGACA-1	Fib
TCAGGTAAGTAGTTCC-1	Endo
GTCCATCAGTGCCCTG-1	Endo
GTGGCGTTCCGTGCAG-1	Pericyte
ACTGCGGCAGTTACAC-1	Endo
CTCAACCTCGTGAACT-1	Pericyte
TCCAGAAAGGAACCGT-1	Endo
TTGAGTGTCCTAGAGT-1	Fib
CTTGAAGTCCTTTGAT-1	Endo
AACCTTTAGACTCGGA-1	Fib
CCTGCTAGTCTGATTG-1	Endo
TTAGCGACAGCACATT-1	Pericyte
TATTGCTGTGCAACAG-1	Endo
TTGCCCAGTAACCCAT-1	Pericyte
GAATCTGGTCTGTTGA-1	Endo
ACTTCCGCAAGCGTCC-1	Pericyte
CCACAGGTCTGATCTT-1	Endo
ACAAAGAAGACAACGC-1	Pericyte
TGTAGCAGTGCGTTTA-1	Pericyte
GAATCTGTCCGTACGG-1	Pericyte
CAACGGCAGTGCTCGC-1	Pericyte
GACTAACCACGCTAAT-1	Pericyte
TGCCTCAGTGACCAGA-1	Endo
CAGTGTAGTGCGACCT-1	Pericyte
TGGGTGCGTATGCTAC-1	Myeloid
ATTACCTAGAGCTGTG-1	Myeloid
GAAGTGGGTGTGTGCC-1	Myeloid
GCGAGAACATTACACG-1	Fib
TATGTGGAGCATTGGG-1	Pericyte
ACAAGCTAGCCATTCA-1	Pericyte
TGCTATTTCGGTAGGA-1	Fib
TAACGGTCAGTTAAAG-1	Pericyte
GGTGCTGCACTGTAAC-1	CM
TCAAGGTAGAGTCCGA-1	Pericyte
AGATTCGTCTTTCGAT-1	Myeloid
GAGTGAGTCACCCGGA-1	CM
TGGGTGCTCGCCAGAC-1	Endo
GAGCGCTCACAGTTAC-1	Pericyte
CTAGCGGAGCCTCGCA-1	Lymphoid
CTCAGAAGTGATAACA-1	vSMCs
CATTGGACATTAAGGA-1	Endo
GTGTGATCAATTCGTG-1	Endo
TAATCGGTCGATGAAA-1	Pericyte
CCTTAATCACTAGCCG-1	Pericyte
GCCCGAAAGAGAGTAG-1	Pericyte
TACTAGGTCAGCCGAC-1	CM
AGTGCGCCAGGACTGA-1	Pericyte
ATCCTGCTCTATCTCA-1	CM
CCCTGATGTGCAAAGC-1	Lymphoid
AAAGGGCAGTCTGTGT-1	Myeloid
GTCACCTAGAATATCG-1	Neuronal
CACTGAATCCCGATTC-1	CM
TTGCTTAAGTGCTCGC-1	Myeloid
TCCATCGTCGAAGCCC-1	Endo
TGGACATCATTACCTT-1	Pericyte
TGTACGAGTAGATGAT-1	Fib
TGATGCACAATGCATC-1	vSMCs
CTCAGAATCTGAGTAC-1	Endo
GCCTACTCACTGCTTC-1	Pericyte
CCAGAATAGAGGAAGT-1	Pericyte
AACTGGTGTTTGCATG-1	Endo
GTAGACTGTATCCCTC-1	Endo
ATCCTGCTCGTGTGCG-1	CM
GCGCCAAGTACGTAGG-1	Endo
GATCATGAGCGGACAT-1	Pericyte
GCCTACTAGTGAGCAC-1	Endo
CTTTGCGGTCCCTTTG-1	Pericyte
TACCCTGTCGATAGGG-1	Pericyte
TTACTCACACGGTTAT-1	CM
TTGCAGATCGACTTAG-1	Pericyte
TTGGTCCCAGTAGTTC-1	Fib
CCTATTATCCTGACCT-1	Pericyte
TTACGTTCACTCGTGG-1	CM
TTTGGTTCACGTTACA-1	Pericyte
AACCTTTAGCTGGAGT-1	Lymphoid
ATAGTCGAGTCATCTG-1	CM
CTACAGACATAGATAG-1	Pericyte
AGGCGAATCAGTCACA-1	Endo
AAACTCGAGTGTAATG-1	Fib
ACAGACTCATTTAGGC-1	Pericyte
TTTACGTAGCGTTAGG-1	Pericyte
GTCACGGAGGTCACTT-1	Pericyte
AATACGCAGTCTAGAA-1	Pericyte
CACTAAGAGCGCAATG-1	Endo
GCTCACTAGCGAATAT-1	CM
GCAAAGGAGTTCCAGT-1	Endo
CGCGCAAGTCAATCCA-1	Fib
ACTTCCGAGTTCCCGG-1	Endo
CAACGTAGTGGACAGT-1	Endo
CTCTCGATCCAACAAC-1	Endo
AGCCAGCAGTCGACCC-1	CM
TAACGGTAGGATTAAC-1	Pericyte
CCATACCCAAATTGAG-1	Pericyte
ATGCATGAGGATCCTT-1	Pericyte
AGCTATGCAAGTCCTA-1	Pericyte
CTGGGACTCAGGAAGC-1	Pericyte
GTCACGGAGATCGATA-1	Endo
AAGGAGCAGTTAGCAA-1	Pericyte
GTAATCGCAATGCACT-1	Endo
CAACCAAGTATCTGCA-1	Pericyte
CGCTAGGAGTGAAACT-1	Endo
CTGTATTAGTTCAAGA-1	Pericyte
TAACGGTTCCTAAGTG-1	CM
TAAGCCAAGGAAGACA-1	Endo
CGCAATATCGTGGCGT-1	Endo
CGCAATATCAGCCGAC-1	CM
CTCAGCTTCCTGACCT-1	CM
GACTAGTCAAACCCTA-1	Pericyte
CCTTGGTAGATTCCGT-1	Pericyte
GGTGAAGCAATAGTGA-1	Endo
CATTCCGGTCACAGTT-1	Myeloid
GAGCGCTTCAATCGTG-1	Endo
TACCTATAGTGTGTAA-1	Endo
GGAATCTAGCATGATA-1	CM
AAAGGATGTCTGTTGA-1	Myeloid
GCCTAGGAGGCAAGCT-1	vSMCs
CCGTACTTCACGATTG-1	Pericyte
GGAATCTGTTAGGCTT-1	Pericyte
CGCAATACAGCGTAGA-1	Pericyte
GCTCCTAGTTACCCAA-1	Endo
GCAAAGGCACAATAAG-1	Endo
ATTACTCAGTAGTGTA-1	Endo
TAGTCCCAGACAACGC-1	Pericyte
AGCTGGCCAACAAACA-1	Fib
CCTGCTATCGACTTAG-1	CM
AAACGAACAAATGTCC-1	Pericyte
TGGTCCTCATGGGAAC-1	Endo
CGTTCCACACGATATC-1	Fib
TTGTCTAAGGCTGGAT-1	CM
AGCCTTCAGTCAGGAC-1	Pericyte
TCTCAGCGTCATGAGG-1	Pericyte
TATCGAGCAAGGCTTT-1	Pericyte
GAACCTAGTCTGAGCC-1	Endo
AGGCGAACATTATGGC-1	Pericyte
CGCACAGGTGCTTACA-1	Fib
CTCTCGACATTATGGC-1	Pericyte
GTAGACTGTCGACTGC-1	Endo
GCATTCCCATCGCTAA-1	Pericyte
TGCTCACGTGGGTAGT-1	CM
GCATTCCGTTTAAGCC-1	Fib
TAGGTCATCCTTGACC-1	Pericyte
CTCTACGAGAGGCGGA-1	Pericyte
TTCGTTAAGATGCGAC-1	Pericyte
AATGCCACACCGTCTT-1	Pericyte
CCTTAATCACTAGGAG-1	Pericyte
TTACTCACAAAGGCCA-1	Pericyte
TTCATTGTCTATACCT-1	Pericyte
TTGCCCAAGGACCGAT-1	Lymphoid
TTAGCGACAGCGTCGT-1	Pericyte
TGCACCTGTAGATGAT-1	Pericyte
GCCTAGGTCTCTCAAT-1	vSMCs
AGGCCCAGTTCTCGAA-1	Endo
TCACCTGTCCACCTAC-1	Myeloid
CTACTTACATCCGTGG-1	Myeloid
GCAAAGGAGGGCGAAG-1	Fib
CGCTGGAGTCTAAGAA-1	Pericyte
GGGTTATTCGTTGTTT-1	Pericyte
CAAGAAAGTGGATTTC-1	Endo
TCTATTGTCCCGTATC-1	Endo
GCTCCTACAAGGCGTA-1	CM
GCATGATCATAGCCGC-1	Fib
CTGAATGTCTTCCAGC-1	Pericyte
TTTGCGCCAGGCTACC-1	Pericyte
AACTGTGAGGAAACTT-1	Endo
TCCCACAGTGATCAGG-1	Endo
GAAAGTATCGTCTTAT-1	Endo
CTGGGACGTAGTGATA-1	Pericyte
ATTGTCTAGGGCTCTC-1	Pericyte
TTTGAGGTCGCGTTCT-1	Pericyte
CACTAAGTCGCAGATT-1	Endo
TGCCTCATCGCACCTT-1	Endo
AGATTCGCATAGGCGA-1	Pericyte
TTCATTGAGCACCATT-1	Endo
CAAGAAAGTCAGAAAT-1	CM
AGGCCTGCATAGTCCA-1	Pericyte
GTTCAAGAGTCTCGAT-1	Pericyte
TATGTGGGTGTAGGAC-1	Pericyte
AAAGGATTCAGAATGA-1	CM
GCGATTAAGTTCCCGG-1	Pericyte
CCTGCTAAGGGTAATT-1	Pericyte
TTAACGGTCTTGTGCC-1	CM
GCATTGAAGGTTCGTT-1	Myeloid
GATGGCCGTAGAAAGG-1	Pericyte
GAACCGCAGTTCGTTG-1	Pericyte
AGCTGATCAGGCATTT-1	Pericyte
AGCTGGCGTGTGCTTA-1	Fib
TTGCGGGCAAGGCGTA-1	Endo
GGAGAACGTCTGGGCT-1	Neuronal
TTACCCGTCACTGATG-1	Pericyte
GCTTTCGTCACGATTG-1	CM
TGAATCGAGGATGCCA-1	Pericyte
GGGTCTGCATTTCACT-1	CM
GTGTCCTAGAGCACTG-1	Endo
TACTAGGGTACGCAAG-1	Fib
TAAACCGCATTATGGC-1	Pericyte
GAATCTGTCTACCCGT-1	Neuronal
GCGAGTCCAGTGCGAA-1	Pericyte
AACTGTGTCGATGAAA-1	Endo
TGGGTGCAGAGTAAGG-1	Endo
TTACTCACATAAAGTG-1	Endo
TGTAAGCAGGAAGAAC-1	Endo
CCCTAGTAGATGAGGA-1	Endo
TCACCTGCAGTGGTCC-1	Myeloid
GAGAACGTCGCTATAG-1	CM
GGAGTAGCATCGCCTT-1	Endo
ATTACCTCATTCGTCC-1	Lymphoid
TACTAGGGTGGCGCTT-1	Endo
GAGATTCGTGAATACA-1	CM
ACGGATTTCTGGCGCA-1	Endo
GTGTGATGTATCGCGC-1	Pericyte
TTGCTTATCTTCATAC-1	Endo
TCTAGTTGTGCAGACA-1	Pericyte
TGGACATGTCCAAGTT-1	Pericyte
AATACGCAGCAACGGT-1	Endo
GTCCATCGTTTCTTAC-1	Endo
AACCTTTGTTAGGCTT-1	Endo
GTTCAAGTCAGTGTGT-1	Endo
TAGCTTTCACGCGCAT-1	Endo
ATCCAGAAGGCACCTC-1	Pericyte
TCGGGACCACCATTCC-1	Fib
TGAGTCACAACGTACT-1	Pericyte
GGCGTTGGTCGAGAAC-1	CM
CTGGCAGGTAGAAGCC-1	CM
TGTGGCGAGGTGATGC-1	Pericyte
CAGCTGGGTACGACCC-1	vSMCs
GTGGATTCATTTCACT-1	Myeloid
ACGTGGCAGGCCAATG-1	Myeloid
AAGGAGCTCGCACCTT-1	Endo
TGCCTCAAGTCACGCC-1	Myeloid
ACAAACCGTGGCATAG-1	Myeloid
GAACGTTTCTATTTCG-1	Fib
GTCACTCGTCGATAGG-1	Myeloid
CCTTGGTAGACACAAT-1	Pericyte
CGGACCACACTTTGGA-1	vSMCs
GCTGCGATCCAGGTAT-1	Fib
CCACGTTTCGAGGTCC-1	CM
TGTTAGGCAATTCAGC-1	Myeloid
TAGACTGGTTTAGGAA-1	Pericyte
ATTCGTTCATGTGGGA-1	Endo
GGGCCATGTTCCAGTA-1	Myeloid
GCTTAAGAGCATACCT-1	Fib
CATTCCGAGAGATTAC-1	Endo
GCGGTGTGTCCCGAGT-1	CM
CACCACTAGCCTTTGA-1	Fib
CCATACCTCCTTACGC-1	Endo
CTGGCAGAGGTCCTCG-1	Endo
AGACAAATCGATAGGG-1	Endo
GAGAACGGTGATAGAT-1	CM
TACCCTGGTTGGAGGT-1	Myeloid
CAAGGCCCAGGATAGC-1	Endo
GGATGAGGTCTCTGGG-1	Endo
GAGCATTTCTTCCAGC-1	CM
CACGTTCGTAGACGCA-1	Endo
TCTCTGGAGTACCACT-1	Endo
CTAACTTGTTTAGACC-1	CM
GACCCAGCATCCCTCA-1	Endo
CACATGAGTATCCCTC-1	Myeloid
TGGTCAAGTGTCTACA-1	Pericyte
TAAGCCAGTTTAAGCC-1	Endo
CTAGGGCAGTCCGATT-1	Pericyte
GGCGAAATCGTCCCTA-1	Pericyte
AGGCCCAGTAAACGGC-1	Pericyte
AACTGGTAGCGTTAGG-1	Endo
ATTTGTCAGAGCTACG-1	Pericyte
TGTAAGCAGTGTCCCG-1	Endo
CCGTGAGTCCAGCACG-1	Endo
CGCGCAATCTGCCGAG-1	CM
TTATGTCCAATACTGC-1	Endo
GTGACATGTAGTTTGC-1	Pericyte
GGTTGCGAGCGGACAT-1	Myeloid
CGCTGGATCGTTCTAT-1	CM
AGGCGTCCAGTAAGCG-1	Endo
TCGATTTTCCACGGCA-1	Pericyte
CACATGACACAGCCAC-1	CM
CCTCCCTTCTTCTCTC-1	Pericyte
CTCCCAAAGTCGTACT-1	Endo
TACTGCCTCTGTAGAC-1	Endo
ATGTCGATCTTATCAC-1	Endo
TAGGTCATCTTACTCA-1	Pericyte
CTCTCAGTCCATGACA-1	Endo
AGACAAATCCTCCTGA-1	Lymphoid
TTACTTGCATTTGTTC-1	Lymphoid
GCATGATGTAGGTGAC-1	Lymphoid
GTACTTTGTGTACGCC-1	Endo
AGCCTGGGTAGGTAAT-1	Endo
GTGTGATAGATGCGAC-1	Pericyte
TCAAGACAGTGTCACT-1	Endo
GAGCATTTCTTACGGA-1	Fib
AATGTCGGTAGAAGCC-1	Pericyte
TTCAACTTCCACCTAC-1	Pericyte
CGTAAACCACTCCTCA-1	Pericyte
TCCAGAACACCGATCG-1	Endo
CCGTAGGTCTTAGTGG-1	Endo
TTACGGAAGTCTCTAG-1	Pericyte
TTTGGTTTCCATGTTT-1	Fib
TTACTCACATACCCGG-1	CM
TTGCACCGTATCTCAG-1	Pericyte
TCAAGACCAATGGTAA-1	Lymphoid
TTTGGTTAGAGCTCCC-1	vSMCs
GGAGGATTCTCATCCG-1	Pericyte
ACTGTCCTCGTGAACT-1	Endo
TAAACCGAGAACGTCG-1	Endo
CATTGGATCGCAGATT-1	Endo
GAGTGAGTCGTTCAGA-1	Endo
TTGACGAAGGGTCTGA-1	Pericyte
ACCGAATCAAACGTTC-1	Pericyte
TCAATTCAGTCTCGAT-1	Endo
TAATCGGTCGAGGCTC-1	Endo
CACTAAGAGGGTAATT-1	Pericyte
TTGTCTACACTGATAC-1	Fib
GGCGTTGAGTCTTAGC-1	Fib
CGAGTTAAGTATCTGC-1	Endo
GAAGTCTAGTCGATAA-1	Endo
GGGTTATTCGATATGC-1	Pericyte
AACAGTCTCGCAACTA-1	Pericyte
ACAAGCTCACTGTCGG-1	CM
CCGTGAGTCGCAAACT-1	Endo
TAACTTCAGTCAACTC-1	Pericyte
AAACTCGGTAACGGTG-1	Pericyte
TATCTGTCATCGGCCA-1	Myeloid
GGGCCATTCGCCCTTA-1	Neuronal
CATTCATAGAAACGCC-1	Endo
TACAGCATCCAAGAGG-1	Endo
ATCCTCGTCTTTCGAT-1	Myeloid
TGTGTCCGTAGTCCAT-1	Pericyte
ACTATTCAGTCACGCC-1	Pericyte
CAGGATTCACGCTGTG-1	Endo
GAAAGTAAGTCGATAA-1	Endo
TGGAAGGTCTGTTGCC-1	Endo
AGGCCTGTCGGTCTAA-1	Pericyte
ATGTTTCCAAACCGAG-1	CM
TGGCAATAGATTAGAC-1	Endo
GTCCATCAGAGGAACA-1	Endo
AAATGAGAGTCACGCC-1	Pericyte
ACCGGGTGTTAGGAGC-1	Endo
TTACGTTAGGCACCTC-1	Endo
TGATGCACAACATAAG-1	Endo
AAGGAGCTCCATCATT-1	Lymphoid
CCCTAGTAGTGGACGT-1	Endo
CTCAACCGTGTACGCC-1	Pericyte
GCTGCGACACGTACAT-1	Fib
CGGACCAGTGAATCGG-1	Endo
GCAAAGGGTGAATCGG-1	Endo
TTGACGAAGGACTTTC-1	Pericyte
ACCGAATCATTTGGCA-1	Pericyte
TACCCTGCATAGGCGA-1	Lymphoid
TTACGGACACAGCCAC-1	Myeloid
GCCAGCACACTCGGAC-1	Pericyte
CATTCCGTCGCTATAG-1	Endo
TCAGTTTTCTATTGTC-1	CM
GGAGAACCATCGTGAT-1	Endo
ACGTGGCTCTATACCT-1	Endo
TACCTATCAATGTGCT-1	CM
TTCATTGTCAGCCGAC-1	vSMCs
GCATTCCTCGCGTTCT-1	Endo
CGCTAGGAGAAACGCC-1	Neuronal
GCCTACTAGTTGCCGC-1	Endo
TCAGCTCTCACTCGTC-1	CM
TGATCAGTCTAAGGTC-1	CM
GCAAAGGCAATGTGTC-1	CM
AACGTACTCATAGGTC-1	CM
