Barcode	cell_type
TGTGTCCGTGCACCCA-1	Fib
TTACGTTAGGCTTAAA-1	CM
GCGTTGGCAATCACTG-1	Fib
TTGCTTATCGGTCTCT-1	Fib
ACTAACGCAGAACAGC-1	CM
AACTTGGTCAGGCCGT-1	Fib
AGCCTTCAGAGGCCTA-1	CM
TGAATCGCAATGATGA-1	CM
TTAGCGAGTCAGGTGA-1	CM
TGAGTCAAGCACGTAG-1	Endo
GATGATCGTCATAGAA-1	Fib
TCAAGGTAGTTGGAAT-1	Fib
TAGGTGTTCCAACGCG-1	CM
TAACGGTAGTATAGTG-1	Fib
TAATTCCGTCAACGGA-1	CM
GCGGTGTCATCGGCTG-1	Fib
CATTGGAGTAGCATGG-1	CM
CGTTCCAGTTCTCGAA-1	Endo
GTGCACGGTTGGAGGT-1	Endo
ATGTCGAAGTAACATG-1	Endo
AACTGGTGTTCCAATG-1	Fib
GATGGCCGTGCATTCA-1	CM
TCAAGACTCCGATTGA-1	Endo
AAAGGATGTTTAGACC-1	Fib
AACTGGTCACGCGTTG-1	Fib
GGTCATAGTAAGCCTT-1	Fib
TCAGTTTGTTGAATAG-1	Fib
CACAACAAGTCATCTG-1	CM
TGCGTAATCTGGTACA-1	CM
TTCATTGGTGGCGCTT-1	Fib
CGGTGCAAGTAGGAAG-1	Myeloid
ACTAGGTAGTCGTGAG-1	Pericyte
TTCATTGAGGTAGGAA-1	CM
TCGCCTACACAAACAA-1	Pericyte
ACGTTAGAGGAACCGT-1	CM
CGTACAAAGAGCAGCT-1	Endo
TGCACCTAGACACAAT-1	Endo
AACCTGAGTGTGAGGT-1	Fib
GAAACAAAGGAAGACA-1	CM
ATCGAGTAGTCGAGCA-1	Fib
TACTGCCTCATCGCAA-1	Pericyte
TGGAAGGCAGGTGGTA-1	Lymphoid
GTGGATTTCGACTCGG-1	Fib
CCGTAGGCAATAGTGA-1	Endo
AATGTCGGTACGGTTT-1	Fib
ATCGAGTCATTAGCAC-1	Fib
TACGGATGTTTCCTAT-1	Fib
TAGCCGGGTACGTAGG-1	CM
ATTTGTCAGGTCTTTG-1	Fib
TTTGTGTCATCTCTCG-1	CM
GAACGTTAGTGAAGGA-1	CM
TTACTCAAGCTCGGCT-1	Fib
ACTTTCAAGCAATGTA-1	Fib
TCACTCGGTAGATGAT-1	Fib
CCAGAATAGGCTTCGC-1	Fib
GCGTAGCTCGCTAGTA-1	Fib
TCACTCGCATCATAGC-1	Myeloid
TACATTCTCCCAGTAA-1	Endo
AGCCTCTGTCAATCCA-1	Pericyte
AGCTGATAGTTGCTTG-1	Fib
ATAGGCTTCGACTTAG-1	CM
GTTCAAGCAGCAAACG-1	CM
AAACGAAAGCAACGGT-1	Fib
AACGTACAGCAGGAGG-1	Endo
ATCGAGTCAATTGCCA-1	Fib
CCAGAATTCGACGGAA-1	CM
TTCGATTAGCCATGGA-1	Fib
ACGGATTCAAGGAAGA-1	Endo
TCAGCTCGTTGCTTGA-1	Fib
TAAGCCAGTATCCTTT-1	Fib
AACCGATTCGTTGTTT-1	Myeloid
TGGGTTAGTAAACCCT-1	Endo
CGGACCAGTAGCATGG-1	Fib
GTAGTACAGTGTCGGA-1	Fib
CTCTACGGTGACCAGA-1	Fib
CTCACCAGTTTGCGAT-1	Fib
TAGCATGTCAGAATGA-1	Fib
GGCGTTGAGACCCTAT-1	vSMCs
GTTGGGCTCGGATAGG-1	Myeloid
ACTCGGGCAACTCGAT-1	Endo
TATCTGTCACGCGTTG-1	Endo
GAGTGAGTCACCACAA-1	Fib
ATAGTCGTCGGGCTCA-1	Myeloid
TATTGCTCATTGTTCT-1	CM
GCGATCGGTCAAGACG-1	Endo
AAACGAAGTACAAATG-1	Fib
ACGTTAGAGTAGTTCC-1	Endo
GACCGACAGCCTGTAT-1	Fib
CCTCCCTAGCGTTAGG-1	Endo
ACTACCCGTCGCGCTA-1	vSMCs
TTACTCACACCTCGTT-1	Pericyte
GTCTACCAGAATGCTA-1	Endo
TCACAAGCACAAACGG-1	Endo
TTCATCATCACTCCCA-1	Fib
CATTGGAGTGGTCGAA-1	Fib
GCGCCAACAAGGAGGG-1	Myeloid
CTACTTATCGATATGC-1	Endo
GGTGCTGAGACCAATA-1	CM
GGGACCTTCGTGAGTT-1	Pericyte
GAGACTTCAGCAACCC-1	Fib
GCGTAGCTCGGATAAA-1	Endo
GGTCATAAGCTTACCA-1	Endo
ATCGAGTTCTATATCC-1	Fib
ACGGATTCAGGCAAGT-1	CM
AGTTTGGTCCGGGCAT-1	Fib
GGGAACATCCGTTAGA-1	Fib
TCCAGAAAGGAAACTT-1	Myeloid
CATTGGAGTACTTCAG-1	Fib
AATACGCAGGTACACG-1	Myeloid
GGCGTTGAGTGATATG-1	Fib
AGCTATGCACGTGAAG-1	CM
ACTGCAAAGACTCGGA-1	Fib
TGAGTCATCTCTGTTA-1	Fib
TGCATTTCATGGTATC-1	CM
CCCTGATAGTGGTGTG-1	Fib
CCACGTTCACAACGGA-1	CM
ACAAAGAGTTTCTCTA-1	Fib
GTTATGGAGTGGGACT-1	Fib
TGTACGAGTATTCTCT-1	Pericyte
GTGGATTCAAGTCTCA-1	Pericyte
GTGGATTAGTACAGTA-1	Fib
TACATGGAGTGAGCTG-1	Fib
GCTCAGGAGTGATCTC-1	vSMCs
TGGAAGGAGCGTTAGG-1	Endo
TTGGTCCTCATTCTTG-1	CM
ACCATCCTCTCTTCCT-1	Myeloid
TAGCGGCTCTCGTGAA-1	Endo
CCTTGGTTCTTCCGTG-1	Fib
TACGCAATCCATTGAG-1	Fib
GGGCCATGTGATAAGT-1	Endo
GAGGATGAGGGTATCG-1	Pericyte
TTGAGCAAGTACTCTG-1	Neuronal
CCAGAATGTGTCGTCG-1	Fib
TAGCCGGTCGATGTGT-1	Myeloid
CTCGCTACACATCATG-1	Pericyte
CCCACATGTGAGTTGG-1	Myeloid
AGTGCCGGTACTTGAC-1	Endo
CTAGCGGGTGTTGTTG-1	Fib
CTTCTAAAGCGAGCTA-1	Pericyte
ATTGTGGAGAAGAGTG-1	Fib
ACTGTCCCACTGCTCT-1	CM
GGGTGTCAGGGCTCTC-1	vSMCs
GTCGTAAAGAACTAAC-1	Fib
GAAGTGGCAACGTCGC-1	Fib
GTTCAAGCAGAAAGAG-1	CM
CCACAGGAGGCCTAAG-1	Pericyte
CCCTCTCAGTCAGGAC-1	Fib
TTCGTTAGTCTGGTTA-1	Pericyte
TTTGCGCTCGGGATCC-1	Myeloid
CATTGGATCTATTTCG-1	Fib
ATTCGTTCAATGCACT-1	Fib
ACCAAACCAGATACAA-1	CM
TAGACTGAGATGGCAC-1	Fib
CCAATGATCAGAGTGG-1	Pericyte
GTCGTAAAGAACCCGA-1	Endo
CTTCCAGGTAACCCAT-1	vSMCs
TAATCGGAGATTAGAC-1	Fib
ATTACTCTCCAACGCG-1	vSMCs
GGATGAGCAACTAGAA-1	CM
TAGACTGAGAGCACTG-1	Fib
AAGGTTCTCTCCTTAA-1	vSMCs
GGCGAAACACCGTCTT-1	Fib
ATGTTTCCAGAACTTC-1	Fib
CCTGCTAAGTTTGGAA-1	Fib
ATAGGCTAGTAACACA-1	CM
TAGGTGTTCTCATCCG-1	Myeloid
CTGCTCATCGCTTACC-1	Fib
TACATTCGTGAATCAA-1	Endo
TGCTCACGTCATCAAC-1	Endo
GACCTTCCATCCCTTG-1	CM
TAGCTTTCAGCAAACG-1	Fib
CTCACCACAACGGACA-1	Fib
GAAGTGGTCTCCAACC-1	Fib
CATGCCTCAATTCTCT-1	Fib
TGCTATTCATCATGTG-1	CM
TACGGATAGTTACCAC-1	Fib
TGCCTGTGTTTGTCTT-1	Fib
CATGTTTTCCTATCAT-1	Myeloid
TAGCCGGAGGTTCTCA-1	Endo
TACTAGGAGTTACACC-1	Fib
CGCTGGACATGCGTTA-1	Fib
AAGATAGAGTCTGGGA-1	Fib
AGGCGAAGTATTCACG-1	Fib
CACTGAAAGGTTAGTA-1	Fib
CACTGAAGTGGGTAGT-1	Fib
AAGATAGCAAGGCGTA-1	Myeloid
CCATACCTCAATCGTG-1	CM
GTTACTTTCGGATAGG-1	Endo
CCGAAGCCAAGGAACC-1	Endo
GAGGCTCAGCAGGAGG-1	Fib
AACCTTTCACCTGGTG-1	Myeloid
TTCATCAAGTTCGACT-1	Fib
CCGAAGCAGCTGATTC-1	CM
AGTTACGTCTTGTCGC-1	Fib
TTGGTCCCAGTGCGAA-1	CM
TAGTCCCGTGCGCTCA-1	Fib
GTGACATTCCTCCCAA-1	Endo
GCACCTTTCACTACCC-1	Lymphoid
GCTTTCGAGGGTAATT-1	Endo
AACATCGAGCACCATT-1	Fib
ACTTCCGTCTGGCACG-1	Fib
GTGATCATCGCACAAT-1	Pericyte
CGTACAAGTAGAAAGG-1	Endo
TCTCAGCTCGCACCTT-1	Fib
TGCTTTATCGTCTTAT-1	Fib
GGAACCCAGACACAAT-1	Lymphoid
TAAGCCATCGTGTGCG-1	Myeloid
GAACCGCAGTCGATAA-1	Endo
TGAGCCGAGTGATAAC-1	Endo
CAGTATGCAGATTTGC-1	Endo
GAAAGTATCCATCTAT-1	Fib
AACGAGGAGTGCACAG-1	Myeloid
GCACGCATCGCTCGGA-1	Endo
ATGCATGGTGGACAGT-1	Endo
CCACGTTTCCTGGGAC-1	Fib
GCGTTGGGTCGAGGAT-1	Fib
TTCATTGAGAGAGTAG-1	Pericyte
ACGGATTGTAAAGGCC-1	Endo
TCAGCTCTCATACTTC-1	Fib
GGTGAAGAGCTACGCC-1	Pericyte
ACATGGTGTTATAGAG-1	Endo
GCTGTTCTCACTAGCA-1	Fib
AAACTCGAGGCTTCGC-1	CM
TTGCTTAGTTGAATAG-1	Fib
GGCGTTGTCTTTCGAT-1	Fib
TGACAACAGGGAGATA-1	Myeloid
AGCCAGCCAAGCTTTG-1	Fib
TGGTCCTCAAGGAAGA-1	Myeloid
TCAGTCCGTAACCGAG-1	Endo
TGTAAGCGTGAGGGTT-1	Fib
ACATGCAGTTCTCGAA-1	Fib
GCAGATTTCCAACCTC-1	Endo
GATCATGCACCACAGC-1	Fib
GTGGCGTAGTGTCACT-1	Endo
GGACACCGTGAGCTAG-1	Neuronal
GTAATCGCAGCAACAG-1	Pericyte
GATCATGCATTCACCC-1	Myeloid
GCTGCGAAGTGATATG-1	CM
TAAGCCAAGGAGTAGA-1	Endo
TGATTTCAGGCTGGAT-1	Fib
CTTGTCGGTGTCTACA-1	Fib
GGAACCCGTACCAAGG-1	Fib
TTACCCGAGCTACGTT-1	Pericyte
AACCTGATCACCCTTG-1	Fib
GGTAGGAGTAGAATAC-1	Endo
TGCGTAAAGTATACGA-1	Myeloid
ACGTTAGAGTCGTACT-1	Fib
ACTTTCACAACCTCCT-1	Fib
TTAGCGAAGTGATAAC-1	Fib
TACCTATCAGAGATGC-1	CM
GGGAACAAGCTATCCA-1	CM
AGCGATTAGTGAAGGA-1	Myeloid
TAATTCCTCGGTCTAA-1	Endo
GGGCCATCAAGCAATA-1	Myeloid
ACGGATTTCCGTGCAG-1	Fib
GCTCACTTCCAGGTCG-1	Pericyte
CGCTGGAGTCCGTGCA-1	Fib
GCCCGAATCTTAAGCG-1	Pericyte
GCCCGAAGTCCGTCGA-1	Fib
ATGTCTTGTATCCTTT-1	Fib
TTGCCCAGTACTTCAG-1	Lymphoid
GGTACCGAGGCATGCA-1	Fib
CTCAACCAGTACGACG-1	Fib
GTGCCAGCACTGTCAA-1	CM
CCTCCCTCAGGCTACC-1	Endo
CCGAAGCTCAAAGTAG-1	Myeloid
GAACCGCGTCCGTCGA-1	Myeloid
GGAATCTAGGTAAGCC-1	vSMCs
GCAACCGGTAACGGAC-1	Fib
GTTGGTATCTTTCGAT-1	Endo
CCCAGAGTCCCAATAG-1	Fib
AGCGTATCAATGGTAA-1	Endo
GTTCAAGAGACCCTAT-1	CM
AGGCCTGTCCGGAAAG-1	Fib
TATCGAGCAAGTGGCA-1	Myeloid
GTGCCAGGTGGAAGCT-1	Myeloid
AGATTCGTCCCAATAG-1	Myeloid
CAGCTAAGTAAAGCTA-1	CM
TGGCGCATCCCGATTC-1	Endo
CTGTATTTCACATTCT-1	Endo
TTTGCGCTCATCGCCT-1	Endo
GCGTAGCCACTGTCGG-1	Fib
CGCAGGTTCCCACTAC-1	Fib
GCGGTGTGTGGCCTCA-1	Lymphoid
CAGCCTTAGTTCAGGG-1	Endo
CTTGCCAGTCGGCTGT-1	Fib
GACCTTCCAAGCACTT-1	Myeloid
GAGACTTGTGTTGGTT-1	Pericyte
GGGCCATTCGTGGAAG-1	Fib
CTAGGATCATTGCGAT-1	Fib
GACCCAGCAGAACGAC-1	Myeloid
CACATGATCATGAACC-1	Fib
GAAAGTAGTGCCCGAT-1	Fib
TGTACGACACGCGCAT-1	vSMCs
AGCCCGAGTAGGGTTG-1	CM
TACTCGCCACCTCGTT-1	Fib
TTGCGAAAGACACGGT-1	Pericyte
GAAGAGCAGTTGGAAT-1	Pericyte
CATTGGAGTCACATTG-1	Endo
GACCGACAGTATACGA-1	Pericyte
CTGTTCGCAACTAGAA-1	Endo
GGTCATAAGTTCCAGT-1	Myeloid
CTAGGGCCAGGTGGTA-1	Myeloid
AGCTGGCTCTTAGTGG-1	Fib
GTGTCCTGTATCATGC-1	Myeloid
CACAGATAGTTAGCGG-1	Endo
GGGAACACATCCGTAA-1	Myeloid
TACCCTGGTGTACGCC-1	Fib
TGACAACTCCAATCCC-1	Myeloid
TCTATTGGTTCTTAGG-1	Fib
TATCGAGAGACTTGAA-1	Endo
TTTGCGCAGGTGATGC-1	Endo
TACGCAACAGTAAGCG-1	Myeloid
GAGGTCCCATCCCTTG-1	Myeloid
CAGCTAAGTTCTTATC-1	Fib
TCACTCGAGGTTCGTT-1	Endo
GGTGCTGCATAGCCAT-1	Fib
ATGCATGTCGCTCGGA-1	Fib
GTGTGATCATTCTTTG-1	Myeloid
CCAGATAAGATCGAGC-1	Endo
GGAACTTTCATACTTC-1	Endo
CGTACAAGTCCGTGCA-1	Myeloid
GCACCTTCAACTACTG-1	Fib
TTCTGTATCCAAACCA-1	Endo
CTAGGATTCGCAGATT-1	Fib
GCAGCCAGTTACGCTA-1	Endo
CGTACAAAGCCGCTGT-1	vSMCs
GATGGCCAGTAGTGTA-1	Fib
GGAGGATCACGTTAGT-1	Endo
GCATTCCCACAAACAA-1	Endo
TAGTCCCTCCATTGTT-1	Endo
CGGTGCATCTCTTAAC-1	Endo
CTGCGTTGTGGTCGAA-1	Endo
CATTGGAGTACTAGAA-1	Myeloid
AACGGGATCGTTCCGT-1	Endo
ATTTGTCCACCAAGGA-1	Fib
CGTGGCAAGCCCATTA-1	Myeloid
TACCTATTCTGATCTT-1	Fib
GGTGTCGAGTCGAAAT-1	Lymphoid
TGGCGCAAGTCCCGCA-1	Endo
CCTAAAGTCTCTATTG-1	Endo
GGGAACAAGATTCCGT-1	Myeloid
GCAACCGTCACGTGTA-1	Fib
CAATCCCAGCACACCC-1	Endo
CAACGGCCAGGGTAAC-1	Pericyte
ATGTTTCCATTAACGC-1	Endo
GTTCAAGCACTAAACC-1	Endo
AATGGAATCGAGAACG-1	Pericyte
AGGCCTGGTTCCCGGA-1	Endo
TGATCAGAGCTGAAAT-1	Fib
ACTTTCACACTTACAG-1	Endo
ACAATCGAGGTACTCT-1	Endo
TACTCGCTCACATCCC-1	Pericyte
ATTACCTCAACGTCGC-1	Fib
ACTAGGTTCGCTGATA-1	Endo
TACAGCACAACGTCGC-1	Myeloid
TTCATTGGTATGTCCA-1	Endo
TAGGAGGAGAATATCG-1	Myeloid
CTCATGCGTCCAACCG-1	Myeloid
AGCCTGGCAGATTAAG-1	Myeloid
GCAGCTGAGACTAGGC-1	Fib
TCGATTTGTGAATGGC-1	Fib
CGTAAACTCTCATCCG-1	Fib
CCGTAGGGTGGACAGT-1	Endo
ACGTTAGTCGCACCGA-1	Endo
TTTGAGGTCAAAGTAG-1	Myeloid
TTGAGTGTCGCACAAT-1	Myeloid
AAGATAGAGATCACCT-1	Fib
CGGTGCAGTTTCCACC-1	Fib
GATGATCCAGATGGCA-1	vSMCs
ACCCAAATCCAGGTAT-1	vSMCs
ACTTCCGCATTTGGTG-1	Fib
TGTAAGCCACTGAAGG-1	Myeloid
TAAGCCATCGGGAAAC-1	Myeloid
GGTGCTGGTCAAATCC-1	Endo
TGCTATTTCTCATCCG-1	Myeloid
AACTGTGAGTCTTAGC-1	Lymphoid
GTGCACGGTATGGATA-1	Endo
TCGATTTTCAGTTGAC-1	Endo
GGGTGTCTCGCGCCAA-1	Myeloid
GGACACCGTCCACCAG-1	Fib
ATAGGCTCAAGCGTCC-1	Fib
CCTCCCTCAATGGTAA-1	Pericyte
GGGTTATGTAAGCCGA-1	Fib
GGGCCATAGGCACCTC-1	vSMCs
TTCGTTAGTTCCCTTG-1	Lymphoid
GTGTCCTCAACTCGAT-1	Endo
AAGGTTCCACCGAAAG-1	Myeloid
TAGTCCCGTCCAACCG-1	Myeloid
GTGGCGTAGGGCTTCC-1	Endo
TAGCTTTGTCCCTAAA-1	Fib
TGCTTTAGTAGGGTTG-1	Pericyte
GGGTGTCGTCAGAGTG-1	Myeloid
AACCAACTCCTCCAGT-1	Endo
GGGCCATGTCAGGTGA-1	Endo
GAACTTGCACTTACAG-1	Lymphoid
GACTAACCAACTCGAT-1	Endo
TAGCTTTAGAAAGGGT-1	Fib
AGGACGAAGTCATCTG-1	Fib
GGCACGTGTGAATACA-1	Fib
GACTAGTCACTCCCAT-1	Endo
TCAGGGCCATGGTTTG-1	Lymphoid
AACAGTCAGGATATCA-1	Pericyte
TGTGACAAGTTCGCGC-1	Fib
GCGTTGGTCAGCACGC-1	Lymphoid
GTTGGGCAGGCTTAAA-1	Myeloid
GATTGACGTAAGGTCG-1	Myeloid
TTCTGTATCTAGCAGT-1	Fib
TATTGCTTCTATATCC-1	Myeloid
CAACGGCAGCTACGCC-1	Myeloid
AGGCCTGGTGATAACA-1	Myeloid
TTTGAGGTCTCCTTAA-1	Myeloid
AATGGCTCATAGAATG-1	Myeloid
ATTGTGGTCGGTGATT-1	Endo
GCAGCTGGTGTCTACA-1	Myeloid
GCTCCTACATGCGTTA-1	Pericyte
TCACCTGCAGCAAACG-1	Myeloid
CTCAGAACATGTGAGG-1	Pericyte
TACCTATTCACGTGTA-1	Fib
ACTGCAATCCATACGA-1	Myeloid
TGTAGCAGTGGACGAT-1	Endo
CCTAAAGCATTGAACC-1	Fib
ATGCATGTCGAGGCTC-1	Myeloid
GTGCCAGGTCCTTATT-1	Endo
AGCGTGCAGCTCCATA-1	Endo
GTACTTTAGAAGAGTG-1	Endo
GTTACTTTCGCTACCT-1	Endo
TTCGCGTTCGTCTAGA-1	Endo
ATCCTCGTCGAGAAGC-1	Myeloid
AGCTATGTCCGGGCAT-1	Myeloid
AACTGTGGTACATGGG-1	Pericyte
ACTGCGGTCGTCTAGA-1	Fib
TAGCCCTCAATGGCAG-1	Myeloid
AACCGATAGAGGTACC-1	Endo
TCGAGCGCAAGTTGCT-1	Myeloid
GTTACTTAGGCTCCTG-1	Myeloid
CAGTATGTCAGTTGAC-1	Myeloid
TGCACCTCATTCGTCC-1	Pericyte
TAACAGCTCGAGGTCC-1	Lymphoid
GAACGTTTCAAACCAC-1	Fib
GTTACGACACTCCCAT-1	Endo
CTGCTCATCGTATAGC-1	Pericyte
CGATGATGTCCCGTGA-1	Fib
GAACCTAAGTGAAGGA-1	Endo
AACCTGAGTACAAGCG-1	Myeloid
TGTACAGCAAACGTTC-1	Endo
CTACAGAGTGAATGTA-1	Endo
TTGACGATCTTGCGCT-1	Pericyte
CAAGAAAAGTCATACC-1	Myeloid
CTGAATGGTATTCACG-1	Pericyte
TTGTTGTAGCCATCAT-1	Fib
CCCAGAGTCATCGCAA-1	Pericyte
GTGCCAGGTTCAGTAC-1	Pericyte
TGTACAGCACCACGAC-1	Endo
TTCGATTTCCGGACTG-1	Pericyte
CAGGATTGTTATCGAC-1	Fib
AGCCAGCCAGAACAGC-1	Fib
TTAGCTTGTATCACAC-1	Pericyte
TGCCTCAAGCTGAATA-1	Pericyte
CACAACAAGGGAGATA-1	Pericyte
CCCTAGTTCCCACTTG-1	Fib
CCCACATCATTAAGGA-1	Myeloid
GGAGAACTCCGGCTGA-1	Myeloid
CCGCATTTCGTTCCGT-1	Pericyte
GATGATCCATTTGGTG-1	Endo
GATCATGAGTTAGAGT-1	CM
CTCTCGAAGCTTACCA-1	Endo
TGATCAGGTGTCGTGC-1	Myeloid
GCCTAGGAGAACGTCG-1	Fib
TACATTCAGATGGGAA-1	Endo
CTGCGTTGTTCCAGTA-1	Myeloid
TTTGTGTCAGAATGCG-1	Myeloid
CAGCTGGGTAACTCCA-1	vSMCs
TACATTCAGTTAGCGG-1	Endo
TAGCCCTGTCAAGACG-1	Endo
TCACCTGCATCGTGAT-1	Endo
CGTAAACCACCCATCT-1	Myeloid
CAGCTAAGTCAGCAAG-1	Fib
GCCCGAAGTGTCTCGG-1	Fib
GTGGCGTTCTGGTACA-1	Pericyte
GGTAGGAGTATTGTGC-1	Endo
TCAAGCATCCGAATTG-1	Endo
CACGTTCTCGGATAAA-1	Myeloid
ACAAGCTCAATGCACT-1	Endo
TACGCCTGTAGGTAAT-1	vSMCs
TGAATCGGTCACCCGA-1	Fib
TCGAGCGAGGCTGGAT-1	Myeloid
TTACCGCAGAGGAAGT-1	Endo
AGGCCTGGTCAGAAGC-1	Pericyte
GATTGACTCCATACGA-1	Endo
CAGCCTTGTACGGAGT-1	Endo
ATCCTCGTCTGTCGGG-1	CM
ACTGCAATCTGGGCGT-1	Pericyte
GAACGTTCAGATTTGC-1	Endo
TCAAAGCCACGTTACA-1	Fib
TGCTTTATCTGGCTAA-1	Pericyte
TTACGGAGTATGGGTG-1	Myeloid
GTCCATCCAGAATGCG-1	Endo
GTGCCAGGTTACACTG-1	Endo
TGAGCCGGTATCAGCT-1	Endo
GAACCTACAGGACTGA-1	Pericyte
TGGTCCTTCCGAGAGA-1	Myeloid
GGGTCTGGTTTCGATG-1	Endo
CAAGAAAGTCAATACC-1	Endo
AAAGATGTCGTTTGAG-1	Lymphoid
AATGTCGCAAGTCTGT-1	Endo
CCAGATAGTACCAAGG-1	Myeloid
TGGGTTACAAGGACCA-1	Myeloid
TTCGCGTTCCAGTACA-1	Myeloid
TTTACGTGTCCTCAGG-1	Endo
GGTCATAAGTACCTCA-1	Pericyte
AGCGTATCAGACTAAA-1	Myeloid
TTCTGTAAGGCTCAGA-1	Myeloid
TCTATTGTCCCAGCAG-1	Myeloid
GGGCCATCAACTACTG-1	Endo
AACCGATAGGATTTGA-1	Endo
CGGACCACAAGCAACG-1	Lymphoid
TAACAGCCACTCCACT-1	Lymphoid
GATGGCCCATTGCGAT-1	Myeloid
TTGGTCCAGTCTGCTA-1	Endo
TAATTCCCAGGCAGAT-1	Endo
TATGTTCTCGGGCTCA-1	Fib
ACTACCCTCTCGCGTT-1	Myeloid
AAGGTTCGTCATTGGT-1	Endo
CGCTAGGAGGGAAGCG-1	Endo
TTGACGATCAGGCGCT-1	Fib
AAACTCGTCCGAATTG-1	Myeloid
GCACCTTTCCTCCAGT-1	Pericyte
TTCGTTAAGGACCGAT-1	Endo
GAGACTTGTTTGAAGA-1	Pericyte
TAGCACAAGTCGTACT-1	Myeloid
TACCCTGGTCTGTTGA-1	Fib
GAAGAGCAGCATGATA-1	Pericyte
CAGTGTAAGGCAGTAC-1	Fib
AACCAACAGATTGACA-1	Myeloid
AAGGAGCTCCAGCACG-1	Myeloid
GTGCTGGCAAGTCTCA-1	Endo
ATCCTCGGTAACATAG-1	Lymphoid
TGGGTTACAGATTTGC-1	CM
TCAGTCCAGCAGTAGC-1	Endo
CAAGGCCGTGATGCTT-1	Fib
GCTTTCGAGTTCGCGC-1	Myeloid
TGGCGCAGTTAAGGGC-1	Pericyte
CTTGCTGAGACTAATG-1	Fib
GTGGCGTAGACGCCAA-1	Myeloid
TGCTTCGTCGTCGCAG-1	Myeloid
CTCTACGCAGAGAGAA-1	Endo
GTTGGTAGTGCTTCCT-1	Endo
CTGCGTTCAATTGTGC-1	Myeloid
CACTGAATCTTTGCAT-1	Myeloid
TGCACCTAGCTTCAAC-1	Fib
TAACAGCCAACAACTC-1	Pericyte
CAAGAAAGTCGATTAC-1	Endo
CGCTGGACAAGTGGCA-1	Myeloid
GCTCACTCATCTCTCG-1	Endo
TACATTCAGAGCAGCT-1	Endo
GCAAAGGCAATCACTG-1	Pericyte
GTAGGAGCATGTATCG-1	Myeloid
TGTGGCGGTTCCAATG-1	Myeloid
AGCTATGTCCATCGAA-1	Myeloid
GACCGACCACTGGGCT-1	Myeloid
CACAGATCAATTGTGC-1	Endo
ATCCCTGAGGGTTCCC-1	Myeloid
TGAGCCGTCCGGCTGA-1	Lymphoid
GTTACTTGTGTAGGAC-1	Endo
TTGCACCCACCTGGTG-1	Myeloid
TGAGTCAAGCGTTAGG-1	Myeloid
GGGACCTCAGCAGGTA-1	Myeloid
CTCAGAACATCATGTG-1	Lymphoid
GTAATCGAGCTCCATA-1	Lymphoid
AAAGGGCGTCAGGTGA-1	Endo
ATGTTTCCAGTATCTG-1	Endo
GAACCGCGTTAGTAGA-1	Myeloid
ATGGATCGTTTCTCTA-1	Lymphoid
TTGAGTGGTATTCTCT-1	Myeloid
GATTAGCAGAGAGGTA-1	Lymphoid
CAAGAAAGTGCACTTA-1	Endo
TTCTAACGTGATGCGA-1	Myeloid
GGTGCTGAGCCTGTAT-1	Lymphoid
CCCAGAGGTACGTATC-1	Fib
AGATTCGCAGCAACGA-1	Myeloid
AGACAAATCCATCTAT-1	Myeloid
ATTTGTCAGCGAGCTA-1	Endo
TTGAGTGCAATTCGTG-1	Myeloid
TTTGAGGCACAGGAAC-1	Myeloid
CACCTGTAGTTCGTTG-1	Myeloid
ACAGGCCCATAAAGTG-1	vSMCs
GAACCTACATGTGGGA-1	Fib
GGTACCGTCATGTTCT-1	Myeloid
ACCGGGTGTCTCTGGG-1	Myeloid
TTACTCAGTACGGTTT-1	Lymphoid
TTACCGCCATAGACGG-1	Myeloid
ACCTGCTGTGGCCTCA-1	Endo
CCGCATTTCCAACGCG-1	Lymphoid
GTTGGGCAGTACTCTG-1	Myeloid
TTGACGAGTAACTCCA-1	Myeloid
ATTTGTCTCGTGCTGG-1	Fib
GTTCAAGGTATGAAGT-1	Fib
GAACCGCTCGTGAGTT-1	Fib
CTTGTCGAGGCTAAAT-1	Myeloid
ATTTGTCAGAGTGGAA-1	Lymphoid
AATGGCTTCTGGACAT-1	Endo
CTCAGCTGTTCCAATG-1	Endo
CTCTACGCACTGGGCT-1	Lymphoid
AGCGATTCAAGTGGCA-1	Myeloid
TCAGGGCGTTCTTTGT-1	Lymphoid
ATAGGCTCAAGTTCGT-1	Myeloid
TACCCTGGTGTGTGTT-1	CM
AAAGGATCACAACGGA-1	Myeloid
TCAAAGCAGAGCTCCC-1	Endo
TTGTTCACAAGGCTTT-1	Myeloid
TCCCACATCCGGAAAG-1	vSMCs
TTACTCAGTTATCGAC-1	Endo
CTAACTTAGACCAATA-1	Myeloid
CACTAAGTCAACGTGT-1	Myeloid
TTGAGCAGTATATGGA-1	Myeloid
CAGTGTAGTGCACCCA-1	Myeloid
CACAGATCATGATCGT-1	Lymphoid
TTGGTCCTCTTTCGAT-1	Myeloid
CAGCTAAAGATGGCAC-1	Myeloid
AAACTCGTCGAAGCCC-1	Myeloid
CACCTTGCAAGCCCTG-1	Endo
TCAGTCCTCGTTGTTT-1	Myeloid
CGCGCAAAGGTTGTGG-1	Myeloid
CGCACAGTCCGGGCAT-1	Lymphoid
ACTGCAACAGGTCCTG-1	Endo
TAAGCCAGTGAGTCGA-1	Pericyte
GCTTAAGCAAATAGTG-1	Endo
TTCAACTTCCCACGGA-1	Lymphoid
TTCGTTATCAAGAGAT-1	Lymphoid
TGTAAGCCAAGTCCTA-1	Myeloid
TGGCAATCAAGGTCGA-1	Myeloid
GACCTTCAGTTGCTTG-1	Endo
AGTGCGCCAATGTGCT-1	Myeloid
GTCGTAAAGGATGTAT-1	Endo
ACATGCATCGAAGCCC-1	Pericyte
ATTACCTTCCGGAAAG-1	Fib
TCAGTCCGTAGCGGTA-1	Lymphoid
CTCAGAAGTTTCTTAC-1	Myeloid
GATTAGCTCCAACGCG-1	Myeloid
CCCTAGTTCTCGCGGA-1	Lymphoid
CGCAGGTGTATATGGA-1	Myeloid
TGCTCGTGTGATAACA-1	Endo
TGGGTGCGTGCACCCA-1	Myeloid
TCAGGGCAGCGAGCTA-1	Myeloid
TTGTTGTAGCAATGTA-1	Myeloid
AGTGCCGGTCTAAGAA-1	Lymphoid
GCCCAGACATCTCACC-1	Endo
GGATAGGTCCCTACCA-1	Pericyte
TTAGCGAGTGTACGCC-1	Fib
GCTCACTTCCGGACTG-1	Endo
CGCGCAAGTGGAAAGA-1	Myeloid
CCCTAACGTGCAAAGC-1	Myeloid
GCGCATGGTAAGTCTC-1	Myeloid
CATGTTTCATGTGAGG-1	Myeloid
CAACGGCAGTGTGTAA-1	Endo
CAGCTAAGTATGTTCG-1	Myeloid
GCACGGTTCGACTGGC-1	vSMCs
CAAAGCTCAAAGGTCG-1	Myeloid
GAGACTTGTCATTGCA-1	Pericyte
TTACCGCAGTGAGTGC-1	Myeloid
CATGCCTAGGCACCTC-1	Pericyte
GAGATTCGTGTCCCAG-1	Neuronal
CACAGATGTCCGTCGA-1	Myeloid
GGGACCTAGTGGACGT-1	Endo
CTGTTCGCATGTAGAA-1	Myeloid
GATCATGGTACATGGG-1	Lymphoid
AATGGCTGTTTCGACA-1	Pericyte
TTTGCGCAGTCTCCAA-1	Endo
AGCTATGGTGCAACAG-1	Lymphoid
TGGTCCTAGCGTCTGC-1	Myeloid
TTCGGTCCACAGAAGC-1	Pericyte
TGTGGCGCAGTCAGCC-1	Lymphoid
TATCGAGTCGTGCTTC-1	Myeloid
TCAGCTCTCGATCTTT-1	Endo
ACAAGCTTCACTACCC-1	Pericyte
TGCTCGTGTAACCATC-1	Neuronal
TACTAGGCAGCAACCC-1	Endo
TGAATCGAGTCCCTCT-1	Pericyte
GGTGAAGCATGGTATC-1	Endo
CCTGCTATCGCATACA-1	Myeloid
GTACTTTAGAACTCCT-1	Lymphoid
ACTATTCCACGCTGTG-1	Fib
GCCCGAAGTAGGGTCA-1	Pericyte
ACAATCGAGCCCATGC-1	Myeloid
TTACCCGAGGCGTCCT-1	Endo
CTCAGCTTCCTGGAAT-1	Myeloid
GGGTGTCTCCGGCTGA-1	Myeloid
TGTTAGGCAACGGACA-1	Lymphoid
TTACGTTAGCCCATTA-1	Myeloid
AACGGGACAGGCAGAT-1	Myeloid
ACGTTAGGTGCAAGAC-1	Myeloid
CGTACAATCCGTTTCG-1	Lymphoid
GAGGATGAGGCCAGTA-1	Pericyte
ATCCCTGTCGCACCGA-1	Endo
ACTATTCGTGCTGAAG-1	Fib
TCCATCGCAGGGAGTT-1	Myeloid
TGGAAGGAGTTACCAC-1	Lymphoid
AAACTCGGTCAACTAC-1	Myeloid
CTCTACGAGGCAAGGG-1	Lymphoid
GGGTTATGTTGAAGCG-1	Myeloid
ACCCAAATCGCGGCAT-1	Lymphoid
TAGGAGGTCATGTTCT-1	Myeloid
CTAGGGCGTGTTAGAA-1	Myeloid
TCCGACTTCAGTCACA-1	Endo
TGCTATTGTTTAAGCC-1	Myeloid
AAAGATGCACTGATTG-1	Lymphoid
TACAGCACATGGTAAA-1	Endo
ATTGTCTCACTTGCGG-1	Lymphoid
AACCGATAGGCTTTAC-1	Myeloid
CTGTATTAGTAGGAAG-1	Myeloid
TGCGTAAGTGCAAAGC-1	Myeloid
GTGGCGTGTTAACCGT-1	Lymphoid
TGTGTCCCAGATTTGC-1	Endo
ACGTTAGCAGCCACGT-1	CM
TGGGTGCTCCTGTAGA-1	Myeloid
TACCCTGTCGCTATAG-1	Lymphoid
TATCTGTTCTTCAGAG-1	Endo
CTTAATCCAAAGGCCA-1	Lymphoid
GCGCATGAGAAAGGGT-1	Myeloid
CAGCTGGTCGCCGAAC-1	Endo
TAGGTCATCTTCCACG-1	Endo
TATCGAGAGATCCGAG-1	Lymphoid
ACAGACTAGCTTACCA-1	Myeloid
TCTAGTTCATTAAGGA-1	Endo
AACGTACCAATTCGTG-1	Lymphoid
AAAGATGTCTCTATTG-1	Myeloid
ACAGAAACATCTCACC-1	Myeloid
GTTCAAGAGCTTCAAC-1	Myeloid
CTCACCAAGTACGACG-1	Fib
CATTGGAAGAGCAGCT-1	Endo
TTCGATTGTTCTACGA-1	Myeloid
CCTAAAGCATCGACGC-1	Endo
GCATTCCGTATCTAGC-1	Myeloid
CCCTGATGTCCACCAG-1	Lymphoid
CCCTCTCCAGCGTCGT-1	Myeloid
GTTACGAAGGAAGGTA-1	Myeloid
GCTGCGATCTCTTCCT-1	Endo
ATATTCCCAAGATTAG-1	Myeloid
CTCATGCTCCACGCTT-1	Endo
TACCTCGAGCTAGTTC-1	Fib
CAAGAAAGTATGCTAC-1	Lymphoid
ACTGCGGAGTACCTCA-1	Myeloid
GGCGAAAAGAGTAAGG-1	Lymphoid
CCTATTATCAGGAAGC-1	Fib
TTCGTTACAAATGTCC-1	CM
GAACGTTAGGTTGTGG-1	Myeloid
ACGTTAGGTATCTCAG-1	Endo
CCGTGAGCACCACAGC-1	Endo
CTGGGACGTGCATCAT-1	Fib
CGCAGGTTCACCGCGA-1	Myeloid
CACTGAAGTGATGTGG-1	Lymphoid
ACCGCAGCACATATCG-1	Endo
AGCTGTAAGCTACGCC-1	Endo
TTCTGTAAGGGCTTCC-1	Lymphoid
TGGCGCAAGGTAAGCC-1	Lymphoid
TGAGCCGGTGCATTCA-1	Myeloid
CCTAAAGGTCCTATTT-1	Myeloid
ACTGCGGTCCCACTAC-1	CM
CGCGCAAGTAACGTAA-1	Lymphoid
CTAGCGGGTGCGCATC-1	Myeloid
TTCGTTACAATGGTCT-1	Myeloid
TGTACGAGTGCTTACA-1	Myeloid
CAACGGCTCGGTCGAC-1	Pericyte
AGCGATTCAAGGGTAC-1	Endo
GAAAGTACATTACCTT-1	Endo
TGCTCACCAAGGAAGA-1	CM
CCAGATACAATGCATC-1	Lymphoid
AGGCGAATCAATCGTG-1	Myeloid
TAACGGTTCCTCCCAA-1	Lymphoid
TGTACAGTCGTCAACA-1	Myeloid
CCCTCTCGTTACGGAG-1	Myeloid
GTAGACTTCTTTCGAT-1	Lymphoid
GTACTTTAGAGAACCC-1	Myeloid
ACTATTCTCATACTTC-1	Lymphoid
GGAACCCTCGCGTTCT-1	Myeloid
TGCACCTTCCTTCGAC-1	CM
ATGCATGTCAGTACAC-1	Myeloid
TTGCTATAGGCAGTAC-1	Myeloid
TAAGTGCTCAAAGTAG-1	CM
ATCCAGATCAGTCACA-1	Myeloid
TGTAAGCGTCCCGTGA-1	Myeloid
GGAATCTGTCCGTCGA-1	Myeloid
AGCTGGCTCGGTCGAC-1	Lymphoid
TAGCTTTTCATTCATC-1	Lymphoid
GTGCCAGCAGGACCTC-1	CM
TGCCTGTCATATAGAG-1	CM
GGAGAACCAGAGCCAA-1	Myeloid
TATGTGGTCGAGTTAC-1	Lymphoid
CCGTAGGCACGTTGTA-1	CM
GGAGAACGTTAACTCG-1	CM
AGTGCCGGTTCCTATT-1	Endo
AGGACGAGTTACCACA-1	Endo
CTGCTCACACATATCG-1	Myeloid
GCCAGACCAATAGTGA-1	Endo
TGCCTCACATAGAATG-1	Endo
GTCACTCGTGGACCAA-1	Myeloid
AAACGAAAGTTTGGAA-1	Myeloid
TTCTAACCAGATGGCA-1	Lymphoid
CACAACATCCGCGATG-1	Myeloid
TGGTCCTTCCTTTGCG-1	Lymphoid
TTACCCGCAAGATTAG-1	Endo
CGTGGCACACTTTGGA-1	vSMCs
TTACGTTCAGGGTAAC-1	Myeloid
AACTGGTAGCTGCTCG-1	Myeloid
TTAGGTGAGCTGCTCG-1	Endo
GTGGATTTCGTTACAG-1	Myeloid
ACTTCCGAGTCTGCTA-1	Myeloid
ACTCGGGTCAGTAGTC-1	CM
AACATCGTCGTGGCGT-1	Myeloid
TAGCCGGAGGATGTAT-1	Endo
TACGGATGTACGGTTT-1	Lymphoid
TTTGAGGCACCACGAC-1	Lymphoid
GTCGTAAGTGTGAGGT-1	Endo
GCAAAGGTCCCAATGA-1	Lymphoid
GGTCATAAGGGTCCCT-1	CM
TGGACATAGTGCTCGC-1	Myeloid
ACTGCGGCACAGGAAC-1	CM
TCGTTCGTCCGGCGAT-1	Lymphoid
GGAGTAGCACCCTTTG-1	Myeloid
GCACGGTAGAGTTTGA-1	CM
TACGCCTTCAGCCGAC-1	Endo
GACCGACCAGGACCTC-1	Fib
CCCTCTCAGTGCACAG-1	CM
CCTGGGACACAGCTTA-1	CM
TACGCCTTCCGGCGAT-1	Lymphoid
GAAGTGGCATTGCCTC-1	Lymphoid
TTCGCGTCAAGGTCGA-1	Lymphoid
ACCGCAGGTGCAGACA-1	Lymphoid
AGCCTTCTCCAGGGAA-1	Fib
CACAGATTCAATGCAC-1	Myeloid
CCTCCCTAGTCTCTAG-1	CM
ATTCGTTAGCTATCCA-1	CM
TATCGAGAGTTCGACT-1	CM
CATTGGACACACATGT-1	CM
ACTATTCCACTCCTCA-1	CM
CTTGCCAAGAGAGTTT-1	Lymphoid
GCGTAGCTCTATTGTC-1	Fib
TGGCAATCAATGGTAA-1	Myeloid
CTAACTTCAAAGGTCG-1	CM
TAACAGCTCAGTTGAC-1	Myeloid
AATGCCATCGTCTAGA-1	CM
GTCTACCTCCACGGCA-1	Pericyte
GCACGGTAGTGAATAC-1	CM
ATGTCGAGTTAACCAC-1	CM
CTGTTCGGTAGACACG-1	Myeloid
