Barcode	cell_type
TGTGGCGGTAAACGTA-1	Endo
GGGAACACATGGCCTG-1	CM
CAAGAAAGTCAGAAAT-1	Fib
ACCATCCGTTTAGACC-1	Fib
CACTGAACAGTAAGAT-1	CM
TTGCCCACAAGCAGGT-1	Endo
ATCGAGTGTCAATCCA-1	Fib
TTTGGTTCATACAACC-1	CM
TCGAGCGCAAGAGATT-1	CM
GAGAACGGTCGATTAC-1	CM
GTGGCGTTCCAACGCG-1	CM
GCATGATAGGTCACTT-1	CM
AGTTACGGTGGCCTTG-1	Fib
AAAGGATTCGATTACG-1	CM
AAATGCCAGTATCTGC-1	CM
TTTGTGTCATTTGGTG-1	Fib
CAGTGCGCAATGTGCT-1	Fib
AGTGCGCGTAACAATG-1	CM
ATAGTCGCAGTAGGCA-1	Fib
TTAGCTTAGAGAGTTT-1	CM
CCTATTATCGGGATCC-1	CM
AACAGTCAGACTAGGC-1	CM
TAGCGGCGTCGACTGC-1	CM
GGATAGGAGTACCACT-1	Myeloid
TAGCATGTCTATGAGC-1	Fib
GGTAGGAAGTAATCAG-1	Endo
TTGAGTGTCAGATACC-1	CM
CTACAGATCTGAAAGA-1	CM
GTGCACGCAACGCACC-1	Fib
AGTTACGGTGTCGTCG-1	vSMCs
TACTCGCGTGCAGACA-1	Fib
CAGTATGAGCATTCCA-1	CM
TCAAAGCTCACCGCGA-1	CM
GACTAACAGAGCAGCT-1	Fib
CGCGCAACACCAAGGA-1	Fib
TTACTTGGTAAGTCTC-1	Endo
CAGCCTTGTGAAACAT-1	Pericyte
CGCTGGAGTCTCTAAG-1	Pericyte
CCTTGCAGTTTGAAGA-1	CM
TCAGTTTGTGTCCAGC-1	CM
GGAACCCTCTCTGTTA-1	CM
CTAACTTGTAGATTAG-1	Fib
TTACGGAAGTGCTAGG-1	Myeloid
CCCTGATGTACATGGG-1	Endo
ACCGGGTCAAGCAACG-1	Fib
GCGGGTTGTATGGGTG-1	Endo
CACAACAAGACGAAAG-1	Pericyte
ACAGAAACAGCGTACC-1	CM
CCGCATTAGTCGCCTG-1	vSMCs
TTCATTGAGATGGCAC-1	CM
GCACGGTGTACCTATG-1	Myeloid
GCCAGACTCAGAATGA-1	vSMCs
TTCATCATCTGTTGCC-1	CM
GTTATGGTCTCTGCGT-1	Fib
GCGGGTTCAATGGCTT-1	Endo
TCGCAGGCAACTTGGT-1	CM
TGAGTCATCGCACCGA-1	Pericyte
CTCATGCCAGGCATTT-1	CM
GGTCATAAGTGTCGGA-1	Fib
ACCATCCGTTGTATCG-1	Endo
ACAATCGCAGGCTACC-1	CM
CGTTCCACAAGCAGGT-1	Fib
CAGGATTCATGCCCTT-1	Pericyte
ACCCAAAAGAGATTAC-1	Fib
CATTGGAGTACGGTTT-1	Fib
GTGGCGTAGTAATGTG-1	CM
AGACAAAGTACTTGAC-1	Fib
GTCCATCTCCAGGTAT-1	CM
GGTTGCGAGTATCTGC-1	Fib
GTAGACTGTGAAACAT-1	Endo
CCCTCTCAGAGCTGTG-1	Fib
GCTGTTCTCCAGCACG-1	CM
AACTGGTAGAGGCGGA-1	Fib
TTGTCTACATAGACGG-1	Fib
GCCTAGGTCTCTGTTA-1	Fib
CTTGCTGCACTGTAAC-1	Fib
CCATACCCATAGAATG-1	Pericyte
GGTAGGATCGTCAACA-1	Fib
ATGCATGAGAAGAGTG-1	Fib
TAGCATGAGGCTCCTG-1	Fib
GCGGTGTCAAGTGGCA-1	Endo
TCCATCGGTACGCAAG-1	CM
TTATGTCTCGCTATAG-1	Fib
GGCACGTCAGGTGTCC-1	CM
CAAGGCCTCGGTCAGC-1	Fib
AACGAGGGTGGACAGT-1	Fib
GTAGTACAGAGATTAC-1	Pericyte
GTTGGTATCTCCCTTT-1	CM
ACTGCAAGTAGTCTGT-1	Endo
TCAATTCCAAATTCCG-1	Fib
ATTTGTCTCCAGGGAA-1	CM
CCCAGAGAGCGCACAA-1	Fib
CCAATGATCTGGCCAG-1	Fib
TTTACGTGTGCAACAG-1	Fib
AAAGGATGTTGGTAAA-1	CM
CCCAGAGGTTGGCGAA-1	Fib
ACGTGGCAGACGTCAG-1	Fib
TCCCACATCTGAACGT-1	Fib
ACTACCCAGGCAGTGT-1	Pericyte
ATGGATCGTGACCAGA-1	Fib
CAGGATTTCATCGCAA-1	Endo
CAACGGCAGGCAGTGT-1	Fib
TCGAGCGTCCATACGA-1	Fib
TACCTCGAGTACAGTA-1	Fib
TGTGGCGGTAACACTC-1	Myeloid
TCGATTTGTTGGCTAT-1	Fib
GCATTCCTCACTGATG-1	Endo
GCAACCGGTCATGAGG-1	Fib
GGACACCCAACAAACA-1	Fib
GAACTTGAGTATACCC-1	Fib
TATCGAGTCGTCGCAG-1	Myeloid
GCACGCATCAGGATCT-1	Fib
AGCTGATGTCTGGATT-1	Endo
TGGCGCATCTGCTACC-1	Fib
TCCATCGTCGCATACA-1	Fib
GTTGGTAGTGGTACTT-1	Myeloid
TTAGCGATCTGAGTAC-1	Endo
GTTGGTATCTCGCGGA-1	Fib
AGGACGAAGTCTCGAT-1	Fib
AGTGCGCGTCCGTAGC-1	Lymphoid
TTAGGTGAGTAGACCG-1	Fib
AGGCCCATCGGTTAGT-1	Lymphoid
GCCAGACGTCGTAGTT-1	Fib
TAGACTGTCGATGTAC-1	Endo
GCCAGCACACTGTAAC-1	Endo
TAGCACACATGGGAAC-1	Endo
AACCGATCACAGTTAC-1	CM
ACAATCGCACAAACAA-1	Fib
CCTCCCTTCTTCATAC-1	Fib
CTACTTAAGTCGCCTG-1	Fib
GTAGACTAGTAGAAGG-1	Fib
GCGGTGTGTTTGCCAA-1	Fib
TCTCAGCGTTGCTTGA-1	Fib
TAATTCCAGGAATGGA-1	Fib
AAACTCGAGTGAGTTA-1	Myeloid
TTTACGTGTTGGAGGT-1	Fib
ACGTTAGTCGGGACAA-1	Fib
GCTCAGGTCGGCTATA-1	Endo
GAAATGAGTACGCAAG-1	Fib
TAGTCCCTCTCTATTG-1	Fib
TGCATTTGTTGAATAG-1	Fib
TTGCACCTCCGAATTG-1	Myeloid
CGTAAACGTTTAGGAA-1	Fib
GGTCATATCGCTCGGA-1	Endo
ATTGTGGGTTGGCGAA-1	Fib
AGCTGATTCCCTACGT-1	Fib
TCGATTTTCCCAGCGA-1	Myeloid
GCAAAGGGTGACAAGC-1	Fib
AACCTGATCAGTACAC-1	Fib
AACTGGTCAACATAAG-1	Fib
TTGCTATGTTTCGATG-1	Fib
ACATGGTAGTCTCTAG-1	Fib
ATCCTCGTCTATATCC-1	CM
TACGGATTCTTCACTA-1	CM
ACGTGGCCACTGGGCT-1	Endo
GTTACTTCAGAACAGC-1	Fib
GCTGTTCTCTGGTACA-1	Fib
TATGTGGGTGCGTAGA-1	Fib
CAGTGCGTCGTCCCTA-1	Endo
GATCATGTCAAGTTGC-1	Fib
TTCATCAGTCTGGTTA-1	Fib
TTCTGTATCGTATAGC-1	Fib
GCAGCCAGTAGAACGC-1	Fib
TAGCATGTCTTGTCAT-1	Fib
GCCCAGAGTCATAGCT-1	Fib
GCTCAGGCATCCTCGT-1	Fib
ATTACCTCAAGGAACC-1	Fib
CTAGGATCACCAAGGA-1	Endo
CCTGGGATCCGGCGAT-1	Fib
GTCCATCGTATGAAGT-1	Fib
GTCACGGAGGTTGACG-1	Fib
CCTGCTACAGAGCCAA-1	Fib
CCACAGGCAACAACTC-1	Pericyte
ACCCAAACAAGACTAA-1	Fib
GTCACAAGTAACAATG-1	Endo
TACAGCACAGTAACGG-1	Fib
GGTCATATCAAATGGA-1	Fib
TACATGGCAGTAACCT-1	Myeloid
GTGCCAGGTTGGCTTA-1	CM
CACGTTCGTTAACTCG-1	Fib
GTAGGAGGTGAATCGG-1	Endo
TGGCCTTAGCAACTGG-1	Fib
AGCCCGAAGTAACTCC-1	Fib
CAACGTACACATAAAG-1	Fib
CCACAGGAGCGTTAGG-1	Fib
GTGGCGTAGGATGTAT-1	Fib
TTAGCGACAGCAACCC-1	Fib
AGATAGAAGCTGCTCG-1	Fib
CTCTCAGGTAATGTAG-1	Fib
GACCTTCCATTCGTCC-1	Fib
GTACTTTGTGCAGACA-1	Fib
CCAGAATCAGTAACCT-1	Endo
TGTACGAAGTGAAGGA-1	Myeloid
TGCTTTAGTCCACCAG-1	Myeloid
ACAAGCTAGGCCTAAG-1	Myeloid
ACTATTCGTATCAGCT-1	Myeloid
CAGTGCGGTATCACAC-1	Fib
GGTGTCGGTTCTACGA-1	Fib
GAGACTTTCGTGAACT-1	Fib
TAGCGGCAGACTCGGA-1	Myeloid
GGGACCTCAGGCTACC-1	Fib
GAGCGCTAGAGCAGCT-1	Fib
TCAGGGCTCGGTCCGA-1	Fib
TCAAGGTGTTCCCGGA-1	Myeloid
TGCTTTATCTAGCAAC-1	Fib
CCACGTTTCTGTAGAC-1	Fib
CGCTGGACACAGGAAC-1	Fib
CAGCTGGTCGTAGCGC-1	Fib
GGGCCATGTGAGTAAT-1	Fib
TCGATTTTCCGAGGAA-1	Endo
TACAGCATCGTGAGTT-1	Fib
CGTAAACAGAGACTCG-1	Fib
GATTGACCATTTCACT-1	Pericyte
CAGTGTAGTAAGTGCG-1	Lymphoid
TTCGATTAGCAGTAGC-1	Fib
AGCCTGGCAACAAACA-1	Endo
TGCCTCAAGCTAACAA-1	Fib
CTTGCCAGTTCATTTC-1	Fib
GATCGTAAGACCAATA-1	Endo
ACAAGCTGTGTTGTTG-1	Myeloid
TCTATTGGTCCTCAGG-1	CM
CAATCCCTCTTAAGCG-1	Fib
GCTCCTATCCGGACTG-1	Myeloid
GCTGAGCTCCTCATTA-1	Fib
AACTGGTAGGATATCA-1	Fib
TACATGGAGGCTCAGA-1	Myeloid
AGCTGATCAGTGCGAA-1	Fib
TCCATCGGTAAACCCT-1	Fib
AAGGAGCTCTGACTTT-1	Myeloid
TCACAGATCGTTTGAG-1	Fib
TAATTCCTCCATAACG-1	Endo
ATCCTGCTCTAGCTGA-1	Fib
GACTAGTGTCTGTGTA-1	Myeloid
GTCTACCGTGCGTAGA-1	Fib
GAGATTCTCGGTCTAA-1	Myeloid
AGCGTATTCGGACGAA-1	Fib
TTTGGTTGTTACTACG-1	Fib
ACTTTCAAGGCACTAG-1	Fib
CAACCAAGTAACATAG-1	Myeloid
ATGGATCAGTCGTACT-1	Fib
CACCACTTCCTCCATG-1	Fib
AACCTTTCAACTAGAA-1	Myeloid
TTCGCGTGTACCCATA-1	Fib
TAACAGCCACCTATTT-1	Myeloid
AGTCCGGTCGAGTGTT-1	Myeloid
ATTGTGGTCTATCCTA-1	Fib
CCCTCTCAGAGAGTTT-1	Myeloid
ACGTTAGCAGTCAGCC-1	Pericyte
ATGCATGGTAGACACG-1	Myeloid
TTGTTGTAGCTATCCA-1	Myeloid
AAGGTTCGTTAGGAAT-1	Myeloid
GGGTGTCAGATATGTG-1	Myeloid
TCAGGTACAAGATGCG-1	Myeloid
TCCGACTCAGAGAGAA-1	Fib
ACTATTCAGGTTCTCA-1	Pericyte
TTCGATTTCAGGTCTA-1	Fib
CCGTACTTCCCTATTA-1	Fib
CTAGGATTCAGGATCT-1	Fib
CACCACTTCTCTGTTA-1	Myeloid
GGAACTTAGCTATCGT-1	Fib
GCTGAGCCACAGTTCA-1	Fib
TCCATCGTCAACACGT-1	Fib
GGTCATACAGCCACGT-1	Fib
TATGTTCCATTAACGC-1	Endo
TTCAACTCACCGATCG-1	Fib
CCTTGGTGTCCAAGAG-1	Endo
AACTGTGCAAGAAACT-1	Pericyte
GGAATCTGTAATGTGA-1	Pericyte
AACCTTTCACCTCGTT-1	Pericyte
CAAGAAATCCCGAAGC-1	Endo
CGGACCATCGGATGTT-1	Lymphoid
TGACAACTCACCACAA-1	Myeloid
TCCGACTTCCAAGTCA-1	Fib
GCGCATGAGGCAATTA-1	Fib
GAAGTCTCATAGCCGC-1	Fib
AACCAACAGGCTTTAC-1	Fib
TCAGTCCGTTGCAGAG-1	Myeloid
GGCGAAAAGTCTAGAA-1	Pericyte
GCGAGTCCACCGTCTT-1	Fib
AAACGAATCATCGCAA-1	CM
CCTCCCTAGTGCTGAG-1	Fib
TAAACCGAGCGAATAT-1	Endo
GTCTACCCATGGAGGT-1	Fib
GAGCATTGTAACGGCA-1	Fib
GCTCGAGCAATCCATG-1	Fib
TGAATCGAGGGTAATT-1	Myeloid
TGCACCTCAGAAAGAG-1	Myeloid
TGTGTCCCACGATATC-1	Fib
AATGCCAAGAGAGTAG-1	Myeloid
AGGCCCATCTTGGCCT-1	Lymphoid
TCTCTGGGTATTCTCT-1	CM
CTGGCAGGTGAGTCGA-1	Lymphoid
AGTTTGGTCCAACAAC-1	Fib
TCTATTGAGCATTGGG-1	Fib
CTCTCGATCTACCCGT-1	Myeloid
GTACTTTGTAGTGATA-1	CM
TCTCAGCGTGAATACA-1	Myeloid
ACAAAGAGTACGCCCA-1	Fib
CTTTGCGTCAGGCGCT-1	Fib
ATCCCTGAGCCCATTA-1	Myeloid
TACTCGCGTCAAACAA-1	Fib
GCTCAGGCAATGTAAG-1	Myeloid
GTGTGATCACTAGCCG-1	Myeloid
TAACAGCAGCGAGCTA-1	Fib
AACGAGGTCCTCCAGT-1	Fib
GAAATGATCGTGCTTC-1	Fib
ACATGCAAGATGAGGA-1	Myeloid
GTTCAAGGTAATGCCT-1	Fib
CAAGCTATCGAGTTAC-1	Myeloid
CCTGCTACACTCCCAT-1	Fib
ATCCTCGCAGCAGGTA-1	Myeloid
TCACCACGTGTTGGTT-1	Fib
ACTACCCAGTCAGCCC-1	Pericyte
CAGGATTGTGGAGTGT-1	Endo
ATTACCTTCGGCTATA-1	Fib
GGTCATAGTAGCGAGT-1	Pericyte
GTTATTCTCACAAGCT-1	Myeloid
CAGCTGGTCGGATGTT-1	Myeloid
ACCAAACGTCTGGGCT-1	Endo
GAGACTTCATCGACCG-1	Myeloid
GCCTAGGGTTAACCAC-1	Pericyte
GAAGTCTTCGATCGCG-1	Lymphoid
GTAGTACTCAGTCAAC-1	Endo
TTGTTGTAGTGAGTTA-1	Myeloid
TACGCCTGTAGGGTTG-1	Endo
CGCTGGAGTCACATTG-1	Lymphoid
TACCTATAGATAGGTT-1	Myeloid
CAACGGCCAGGTAGGT-1	Endo
TTGGTCCTCGTGCTTC-1	Myeloid
GGCGAAAAGATCTAAG-1	Lymphoid
CAACCAAGTTTCTTAC-1	Endo
GCGTTGGAGAGTCCGA-1	Fib
ACAAACCGTGCAACAG-1	Fib
TGCTTTACAGAGATGC-1	Pericyte
ATCGAGTTCGATGTGT-1	Fib
CCAATGATCTCTTAAC-1	Myeloid
CATTGGAGTGTTGGTT-1	Endo
CTTTGCGTCTCCTTAA-1	Fib
GATTGACTCGCTACCT-1	Fib
CAACGTACAGGGTAAC-1	Fib
TCAAGCACATGCCCTT-1	Fib
ACGTGGCTCTTCCAGC-1	Fib
CCGCATTAGTTAGCAA-1	Endo
TGCTATTAGATCGATA-1	Myeloid
ATGTTTCAGTCCTTCC-1	Myeloid
GGGACCTCACGTACAT-1	Myeloid
AACTGTGTCTTCATAC-1	Fib
CACGTTCAGTGATAAC-1	Endo
GATCATGCATGGCCGT-1	Endo
TTGACGATCGTTGTAG-1	Myeloid
AGACAAAAGTCGTGAG-1	Fib
TGGCCTTTCAAACCAC-1	Endo
CTGCGTTAGGACTAGC-1	CM
ACTGTCCTCGAACCGC-1	Myeloid
CCGTACTGTATCATGC-1	Fib
GCGATCGCACATTGCA-1	Lymphoid
GAAGAGCGTAACACTC-1	Fib
CACCTGTGTTTGCATG-1	Myeloid
GCGCATGAGCTAACAA-1	Fib
GCGTTGGTCGATAGGG-1	Fib
TAGGTGTTCAGTCTTT-1	Endo
ACCGCAGGTAGCGAGT-1	Fib
GCTGCGATCAGGATCT-1	Fib
GTCACCTCACAGGTAG-1	Lymphoid
CACTAAGGTCATAAGA-1	Myeloid
ACCATCCCATTGCCTC-1	Endo
GCATTCCAGGATGCCA-1	Myeloid
TAGACTGTCACCACAA-1	Endo
TCAGTTTGTATATGGA-1	Pericyte
CCCGTTAGTTTGATCG-1	Fib
GAGTGAGAGCTAACAA-1	Myeloid
TCCGACTCATTAGCAC-1	Fib
AGCTATGTCAAAGTAG-1	Fib
CCTATTACATAGAATG-1	Lymphoid
GAAGTGGAGCTACGTT-1	Endo
TGGGTTACATCAGCTA-1	Endo
TATCTGTAGAAGCCGT-1	Endo
CCAGAATAGCAGGACT-1	Fib
GAACCTAAGCTAGCAG-1	CM
GAGATTCCATGGGACA-1	Fib
ATGTACGTCTGTTGCC-1	Endo
ACTACCCAGCAATGTA-1	Myeloid
GGAACTTCAGGTAGGT-1	Endo
TAGCCCTAGCCTCGCA-1	Fib
TCAGTTTAGTTTGGAA-1	Myeloid
CTCGCTATCACAAGCT-1	Lymphoid
TTGTCTACACTAGGAG-1	Myeloid
GTCACAACAGATTAAG-1	Endo
AGACAAAAGCGGACTA-1	Endo
TGCTTTATCCTGTAGA-1	Lymphoid
TGCATTTAGTGTCACT-1	Myeloid
TTTACGTGTGCCAAGA-1	Endo
AGGACGACAATTAGGA-1	Endo
AGCGTGCTCACCCGGA-1	Myeloid
CTTGCTGGTAACAATG-1	Endo
CAACCAACAATGGTCT-1	Endo
ACAGACTTCTATCTTG-1	Pericyte
TCCCACAAGCCGCAAA-1	Lymphoid
GAACGTTTCCCAATGA-1	Endo
TTCGCGTTCGGCAATT-1	Endo
GAACGTTTCATCGCCT-1	Myeloid
TCAAGGTTCGAGGTAG-1	Endo
GCATGATGTTTAGACC-1	Endo
CTGCGTTAGAATACTG-1	Myeloid
TCTCAGCTCTGACTTT-1	Myeloid
TTTGGCCAGGCAAGGG-1	Myeloid
TCAAAGCCATCCCGGA-1	CM
TAACAGCCAAGTTCGT-1	Endo
CCAGATAGTGATAAGT-1	Endo
CCTTAATTCATTCTCA-1	Myeloid
CTCAGAACAGATACAA-1	Myeloid
GAACCGCGTTCCGGCA-1	Myeloid
GAAGTCTAGGAAGAAC-1	CM
GCTTAAGAGTCCGATT-1	Myeloid
CCTTGCATCGAACACT-1	Myeloid
ACTTCCGGTATGCTAC-1	Endo
GAAGTCTGTCCTTATT-1	Myeloid
AAACTGCCAAACCTAC-1	Lymphoid
CCATACCGTAAGTCTC-1	Fib
AGTGTACGTAATGCAA-1	Lymphoid
ACAAACCCAGCGTCGT-1	Myeloid
GAAGAGCAGGCTAAAT-1	Myeloid
CGGACTGCAAACCGAG-1	Fib
GCCAGCATCGGTCTCT-1	Myeloid
GATGGCCAGAGCCACA-1	Myeloid
TTGCTATGTAGGGTCA-1	Endo
CTCAACCGTACCTATG-1	Myeloid
CTCACCAAGCTGAAAT-1	Fib
GGGAACACACAAGTGG-1	Endo
ATGCATGCAAAGGCCA-1	Endo
GCTCACTCAGTTGCAT-1	Myeloid
ACATGGTGTAGCGTTT-1	Myeloid
TAGCCGGAGGCTTTAC-1	Myeloid
AGCCTTCGTCCATTGA-1	Fib
GTCACAATCGCTGATA-1	Myeloid
TCACTCGCATTCACGA-1	Myeloid
GCATTGAAGTTAGCAA-1	Myeloid
TGGACATCAATGCCAT-1	Myeloid
TTGAGTGAGGTAAGTT-1	Endo
CTCGCTAAGCCTTTGA-1	Myeloid
GCTCGAGAGTTAGCGG-1	Lymphoid
GAGGCTCCACGATTAC-1	Myeloid
TCGTTCGTCTGATCCC-1	Pericyte
CTCAGAAGTAGTGATA-1	Endo
TGCATTTCAGTTACAC-1	Neuronal
TTTGAGGAGAACAGGA-1	Myeloid
CCGCATTCAGGTTATC-1	Fib
ACCGGGTAGACACGGT-1	Myeloid
GTCACCTAGTCTCGAT-1	Myeloid
GAACTTGTCTCCTTAA-1	Endo
AGCGTGCGTACGCCCA-1	Fib
GTTACGACAGATACAA-1	Myeloid
CCGTACTTCCAGGCCA-1	Myeloid
AAACTGCGTACTTCAG-1	Myeloid
CAGCTGGTCAGGCCGT-1	CM
TGACTCCTCATACTTC-1	Myeloid
TACGCAATCTGTTTAC-1	Lymphoid
ATAGGCTCATGCGACC-1	Endo
ACTAGGTGTTCAGTAC-1	Myeloid
TACTCGCCAGTGCGAA-1	Myeloid
TGCTTTAGTCAGACGA-1	Myeloid
ACCGAATAGGCGTAGT-1	Myeloid
GCGTTGGCAAAGAAGG-1	CM
ACTATTCGTTAACTCG-1	Endo
CAATCCCTCAGTACAC-1	Endo
TTCATTGTCCACCTAC-1	Myeloid
CTAACTTTCACAACAC-1	Myeloid
TACGCCTAGCTAACAA-1	Myeloid
GAAGTCTAGGTTGTGG-1	Myeloid
TTAGCGATCTCCAACC-1	Endo
GAACGTTAGTGGACGT-1	Fib
CACAACATCTCGCGGA-1	Myeloid
CTACAGACATACTGCA-1	Myeloid
GCTCACTTCTCCTTGG-1	Myeloid
TTGTCTATCCGTGCAG-1	Myeloid
GGAGTAGGTTGCTTGA-1	Lymphoid
ATAGTCGAGTCGTACT-1	Myeloid
TCAGGGCGTATTGTCG-1	Myeloid
GTGACATGTGTCTACA-1	Myeloid
TTTGCGCTCCAGGTCG-1	Lymphoid
CCTTGCATCGGGATCC-1	Fib
CCCTGATCAAGCGTCC-1	Endo
GCAGCCACACTCAAGT-1	Pericyte
TCTCTGGAGATCTAAG-1	Endo
CTTGCTGGTGGAAAGA-1	Fib
CAACGTACATGGCCTG-1	Myeloid
TGACAACGTTAGTAGA-1	Myeloid
TCCCACACACTCGGAC-1	Myeloid
CTAGGATCATTGCCTC-1	Fib
ACGTTAGGTAGCAGGT-1	Myeloid
TACCTCGAGACCAATA-1	Endo
CTCTCAGGTCGAGGAT-1	Myeloid
TCAAAGCGTTCTACGA-1	Fib
TCACCTGCACTGTTAG-1	Myeloid
TACCCTGAGAGGTCCA-1	Myeloid
CTCGCTACAGTAGTCT-1	Lymphoid
GCAACCGTCCCGATTC-1	Myeloid
ACAGGCCTCTCGACAA-1	Fib
CTGCGTTCAAGCTTTG-1	Myeloid
TGCTCACGTAAAGGCC-1	Myeloid
GGCGTTGTCTGTAGAC-1	CM
GATGGCCCAGTGGTCC-1	Myeloid
CGCAGGTAGATCACCT-1	Lymphoid
ACAAGCTAGAAGCCTG-1	Myeloid
GTGACATCATATACGC-1	Endo
CTCTCGATCGAACACT-1	Lymphoid
TAAGTGCGTTCCCAAA-1	Myeloid
GTGTGATTCCGTGCAG-1	Lymphoid
TTTGAGGGTAATGTAG-1	Myeloid
CCACAGGTCTCATCCG-1	Lymphoid
CTGAATGAGCGCCTAC-1	Endo
GCATGATGTGGTTCTA-1	Myeloid
AGCTGTAAGAGGCGGA-1	Myeloid
CACTGAAGTGTCCCAG-1	Myeloid
TGCTTTACACGTTAGT-1	Myeloid
ACGTGGCCAACGTACT-1	Myeloid
GAAAGTAAGCTATCCA-1	Pericyte
AATGGAACAACGACAG-1	Endo
AGCTGGCGTAGTAACA-1	vSMCs
CAATCCCTCGAACACT-1	Myeloid
AGCCTTCTCGTGAGTT-1	Lymphoid
CTCTACGCATTGCCTC-1	Lymphoid
AAAGGGCCAGCGCGTT-1	Myeloid
CATTCCGCATGGGTGA-1	Myeloid
GGAACCCAGAGATTAC-1	Myeloid
GCTCACTCACTGCTTC-1	Myeloid
ATCGAGTAGTGAAGGA-1	Myeloid
TGATGCAAGAGAGTTT-1	Myeloid
AACGTACTCGGGACAA-1	Endo
GCTTTCGGTACGGATG-1	Myeloid
GGTTGCGCAAGCGACA-1	Lymphoid
GTCACCTTCAGCACGC-1	Myeloid
AATGCCACATCAGAAA-1	Myeloid
GTAGTACAGCATGATA-1	Fib
TCCGACTGTTCCAGTA-1	Lymphoid
CAGCCTTCACACACCG-1	Endo
TTACCCGTCCAATAGC-1	Lymphoid
GCTGTTCGTAAAGGCC-1	Endo
CAGCTGGTCGTATAGC-1	CM
CTCGCTAAGTCTCCAA-1	Myeloid
TTCGATTCACAAGGGT-1	Endo
TACAGCAAGGCAGATC-1	Fib
TGGGTTATCAAACCCA-1	Myeloid
CTTTGCGGTGCAAGCA-1	Lymphoid
ACCCAAAAGACCGCAA-1	Lymphoid
CTCGCTACAAAGACGC-1	Fib
GTTACGATCTGATCCC-1	Myeloid
CGATGATGTGCATCAT-1	Myeloid
TCACAAGGTCCTTCAC-1	Myeloid
ACTTTCACACAGGTAG-1	Endo
CTAGCGGTCGCATAAC-1	Pericyte
AAAGATGCAGGGAGTT-1	Lymphoid
ATCCTCGTCTGTTTAC-1	CM
TGATTTCCAGGCATTT-1	Lymphoid
TTGACGAAGTTCGACT-1	Fib
TCTCAGCGTTCAGAAA-1	Endo
CAACGTAAGTGCTAGG-1	Lymphoid
GTTATGGCATGGTAAA-1	Endo
TACATGGTCAAGTTGC-1	Myeloid
TATCGAGAGCCCATGC-1	Endo
CGGTGCATCTCTTCTC-1	Lymphoid
CTCAGCTTCTTCCACG-1	Myeloid
TCAGGGCAGCAGAGCT-1	Myeloid
AGGCCTGGTTGGCTTA-1	Lymphoid
AGCGATTCAACGCACC-1	Myeloid
CTTCCAGTCGGTACTA-1	Myeloid
ACCGAATAGGTTTCTG-1	CM
AATACGCCACAGGTAG-1	CM
AATGGAAGTGGTGGTA-1	Endo
GTTATTCTCGTGGCGT-1	Endo
GTGTGATGTTTCCGGG-1	Lymphoid
GTGCACGAGGGCATTG-1	Myeloid
CTGTTCGGTTGCCGCA-1	Fib
TTTGCGCCACTTACAG-1	Lymphoid
CTGCGTTTCTCCTTGG-1	Lymphoid
TGTGTCCTCAGGAATA-1	Myeloid
AACGGGACACCTGTGG-1	Myeloid
GAACCTACATTACTCT-1	Myeloid
GCAACCGCATGCGTTA-1	Fib
AAGGAGCGTGAGTTGG-1	CM
TCACCACAGTAGTTCC-1	Myeloid
TTTACGTCAGAGCCAA-1	Lymphoid
GAACTTGTCATGTTCT-1	Myeloid
TACTCGCAGAGAGGTA-1	Fib
TATGTGGCAGATTAAG-1	Lymphoid
GGAGGATCAATTCAGC-1	Lymphoid
CTTGTCGTCCCTATTA-1	CM
ACCAAACTCACTGGTA-1	CM
GCTGAGCGTGTCCAGC-1	Fib
TAATCGGCATATACGC-1	Myeloid
CCAATGATCTCGTAGA-1	Myeloid
AGCCCGACAGCGTAGA-1	Myeloid
AGCTGTAAGGTCGTTT-1	Lymphoid
TTTGAGGCAAAGAGAG-1	Lymphoid
GCGATTAAGGGCTTCC-1	Lymphoid
ATGTCGACATATAGAG-1	Fib
CTCTACGAGCCATGGA-1	Myeloid
AGTCCGGAGTAATGTG-1	Endo
GTCACCTGTACCCATA-1	Myeloid
AACGAGGGTTGTATCG-1	Endo
TGTACAGTCAGTGTGT-1	Myeloid
CTCAACCAGTCCCTCT-1	Myeloid
TTTGTGTGTACCCACG-1	Endo
GCATTCCTCTGCTACC-1	Myeloid
AAATGCCGTGAGGGTT-1	Myeloid
ACAGACTTCGTCGCAG-1	Lymphoid
AGGACGACATCCCAAA-1	Myeloid
TTACGTTTCCATGACA-1	Endo
TAATTCCAGTAATCAG-1	Lymphoid
TTGTTCATCATCGCTC-1	Pericyte
TTAACGGAGGCTCCTG-1	Endo
CGCAATACAGTTGGAG-1	Myeloid
CTGCGTTCACCTACCT-1	CM
CAATCCCAGGGTAATT-1	Lymphoid
TTAGCGAGTGCCAAGA-1	Myeloid
TACTGCCTCGGTCAGC-1	Endo
CAGTGCGTCCTCCTGA-1	Endo
TCAAAGCGTGTCTCGG-1	Myeloid
ACTTCCGTCTTGGCCT-1	Myeloid
GCCCAGACACACATGT-1	Lymphoid
GCGTTGGTCCTCTCTT-1	Lymphoid
GAGACTTAGTGCCCTG-1	Pericyte
TGACTCCCATTTGGTG-1	CM
AAACGAACAATTGTGC-1	Lymphoid
CGATGATAGCTGCCAC-1	Myeloid
TAATCGGAGGTTTCTG-1	Endo
GGAGGATGTACGACCC-1	Endo
GAAAGTATCCATAGGT-1	Endo
AATACGCGTAGAGAGA-1	Lymphoid
CTGGCAGAGCTAGCAG-1	CM
TAAGCCAGTAGACACG-1	Endo
GGCATTACACGCGATC-1	Myeloid
ACATGGTGTGCAACAG-1	Fib
CTCAGAATCCTTTGCG-1	Myeloid
GACCCAGGTTCTTTGT-1	Myeloid
TACTGCCCAAAGCATA-1	Myeloid
TGTGACAAGTAACATG-1	Myeloid
CCGCATTAGGGTATCG-1	Myeloid
TCAGGGCGTCCGAGCT-1	Lymphoid
AGCTGTACACCTACCT-1	Lymphoid
CGCGCAAAGTACCCAT-1	Endo
CAAGGCCGTGAATCAA-1	Myeloid
TAGTCCCAGACGAAAG-1	Myeloid
TGCTTTACAGCTATAC-1	Endo
CTCAGAAGTGCAAGAC-1	CM
TGGTCAATCGCACCGA-1	Lymphoid
GCCCGAAGTTTAGACC-1	Myeloid
TTACTTGCAACCTCTC-1	Myeloid
TACGGATAGAGGCAGG-1	CM
GTGACATTCCGTACGG-1	Myeloid
ATTCGTTTCCGAGAGA-1	Lymphoid
CGCTATCCAGTAAGAT-1	Myeloid
ACAAACCCAGGGAGTT-1	Lymphoid
TCAAGCATCGTGAACT-1	Pericyte
CGATGATGTTTGCCCT-1	Lymphoid
AGGCCTGAGCGTGTTT-1	Myeloid
GTTGGTAAGTATACCC-1	Myeloid
TTAACGGGTGGAAGCT-1	Lymphoid
TTTACGTTCGGACGAA-1	Endo
ATGTTTCAGAGATTAC-1	Myeloid
TCACAGATCTAAACGC-1	Pericyte
TGCTATTAGGATGTAT-1	Lymphoid
ATTGTCTAGAAGACTT-1	Lymphoid
GCGATCGCACTTACAG-1	Endo
GTCGTAACACGCGATC-1	Endo
TAGCATGGTGGTGGTA-1	Myeloid
TCTCTGGAGTCGAAAT-1	CM
CGTTCCATCAATTGGC-1	Myeloid
TAGCGGCGTCACCCGA-1	Myeloid
TCAGGTACAAGGACCA-1	Lymphoid
GTCACAAGTCAGCAAG-1	CM
CAGCTGGCATGTATCG-1	Endo
TGCGTAACAGACCTGC-1	Myeloid
TAAGCCATCTTAGTGG-1	Pericyte
TAAACCGTCACCGCGA-1	Lymphoid
TGCGTAAAGTGCCCTG-1	Lymphoid
AGCTGGCGTTGTCGGC-1	Myeloid
GCAGATTTCGGACGAA-1	Endo
TGCTCACCAGCGTCGT-1	Lymphoid
CCTAAAGTCGTATAGC-1	Lymphoid
AGTGCGCGTGAATGTA-1	Myeloid
AACCTTTGTCCAAGAG-1	Lymphoid
TAGGTGTGTATGTCCA-1	Endo
CCTGGGAAGGATGTCG-1	CM
TGGGTGCAGTGATCTC-1	Lymphoid
GGACACCCACTCAAGT-1	Endo
CCAGATACAAGTCTGT-1	Lymphoid
TACTCGCCATTATGGC-1	Endo
TTGTCTACACACACCG-1	Lymphoid
TTCTGTATCATTCTTG-1	Myeloid
GCCATAAGTTTCGATG-1	Lymphoid
TTACTTGAGTGATTAG-1	Lymphoid
CCACGTTAGGATGTCG-1	Myeloid
CGTAAACCAGAGCCAA-1	CM
GTCACGGAGCATGTGG-1	Pericyte
CGCTAGGGTAGACGCA-1	Myeloid
GCAGCTGAGGATTGCG-1	CM
GGGTGTCCACAGAAGC-1	Endo
GGGTCTGTCGCGCCAA-1	Endo
CTTTGCGAGGCGTAGT-1	Lymphoid
GCACGGTTCGACGGAA-1	Endo
AGTGTACGTTGCAGCC-1	CM
CTCTAGCGTCATCAAC-1	CM
GGGTGTCGTCACCCGA-1	Myeloid
GTTATTCAGACGCCAA-1	Lymphoid
CATGCCTGTTTGTACG-1	Lymphoid
GCGTAGCAGCCCATGC-1	Myeloid
CAGCTGGCATTAGCAC-1	Lymphoid
CGTAAACAGCTAGTTC-1	Lymphoid
AAATGAGGTGAATGTA-1	Fib
AACAAAGTCCTTCGAC-1	Myeloid
AAATGCCTCGTGAGTT-1	Lymphoid
TTTGAGGTCTGAGTCA-1	Myeloid
GACCCAGAGATGGGTC-1	vSMCs
ATGTCGAGTTAAGGGC-1	Myeloid
GTGGATTTCAACACGT-1	Endo
CAGGATTCACTAGCCG-1	Myeloid
TTCGGTCTCCGTTAGA-1	Myeloid
TGGCCTTTCCTAAAGC-1	Myeloid
CAGCTAACAAGCGTCC-1	Myeloid
GCGGAAATCGCGCCAA-1	Lymphoid
GCGAGTCGTGATGTGG-1	Lymphoid
TCTCAGCAGTCGATAA-1	Endo
CACCTTGCAACTAGAA-1	Myeloid
TCTCAGCAGGTAGGCT-1	Lymphoid
TTGCTATAGGCGACTA-1	Myeloid
CAATCCCGTATTCTGG-1	Endo
TGCCTGTCAGCCACGT-1	Fib
CCTGGGATCGATATGC-1	Myeloid
CGCTGGACACCCTTTG-1	CM
TATCTGTTCACTCGGG-1	Endo
CTAACTTAGTGAGTGC-1	Lymphoid
CTTGCTGCATGTCCCT-1	CM
ACTGCGGAGTTATGAG-1	Endo
GGGCCATCACGACGAA-1	Myeloid
ACTAACGCAGGACCTC-1	Fib
GGGTCTGTCTGACATG-1	CM
TCAGTCCAGACAGCTG-1	Lymphoid
CTCATGCTCTTCCACG-1	Fib
CCAGATACAAGCGGTA-1	CM
TCGCAGGAGAGCCTGA-1	Myeloid
TTTGTGTGTGTTAGAA-1	CM
GCAGATTTCAGAGTGG-1	Endo
CACATGACAACGTCGC-1	Lymphoid
TCACCACTCCATAACG-1	CM
TTATGTCGTCTGCACG-1	CM
GAGGTCCGTTGCCGCA-1	Myeloid
CGGACTGCAATCACTG-1	Pericyte
GCTGCGACATCAGCTA-1	CM
CTACTTAAGACGTCAG-1	CM
AGCCGCACAAACGACG-1	CM
CTGAATGCAAATAGTG-1	CM
GTGGATTGTAAACGAT-1	CM
GGTGAAGCATGGCCTG-1	CM
TAGCCCTTCGTTACAG-1	CM
TTTGAGGCACAGGTAG-1	CM
