Barcode	cell_type
TTCATCATCTGGCACG-1	Endo
CTCAGAAAGTCGTACT-1	CM
GTCCATCGTGAGGTCA-1	Myeloid
CAGTGTATCTCGCGTT-1	Fib
GGCACGTTCTCGCGGA-1	Fib
CTTTGCGTCTGGCACG-1	CM
TTGCGGGTCACACGTA-1	CM
TGGTCCTCAACCTCTC-1	Fib
TTCAACTAGTAATGTG-1	CM
GAAGTGGTCGCTGATA-1	CM
ACAGCGCAGTGAATAC-1	Fib
CCAATGATCAAGAGAT-1	Fib
GGGACCTAGACCGCAA-1	Myeloid
AACTTGGTCGTCGCAG-1	CM
TCGATTTAGTCAGGAC-1	Endo
TCAGTCCGTGCGTTTA-1	CM
TTCGCGTAGTTGGAAT-1	Fib
GACCAATCACCACCAG-1	Fib
GACTAGTAGAAAGCAG-1	Myeloid
GCGAGAATCGTGGTAT-1	Fib
TAAGCCAGTCATCAAC-1	CM
AGTGTACTCGTGGTAT-1	CM
TATGTTCAGGCAGTAC-1	Fib
GCCCAGACATATAGAG-1	CM
TACTGCCAGGCAATTA-1	CM
ACTAACGGTATCATGC-1	Fib
TACTCGCGTAATGTAG-1	CM
GCGTTGGCAGGAGCAT-1	Myeloid
GCTTGCTAGACGTCAG-1	Endo
GAGCGCTAGAGTCCGA-1	CM
TCAGGGCGTATTCACG-1	Fib
AGCCTTCGTGAATGTA-1	CM
GACTAGTAGAGAACCC-1	Fib
AGTTTGGAGGTACTCT-1	CM
AATACGCGTTAGGCTT-1	Myeloid
GAACCTATCCGATTGA-1	Fib
AAACGAATCGAGCGCT-1	Fib
GTCACTCAGAGCAGCT-1	Myeloid
TGATCAGGTGTGAGGT-1	Fib
AGACAAAAGTTGACAA-1	Myeloid
TCAGTCCTCGATAGGG-1	Myeloid
ACTGCAAAGAAATACC-1	Fib
CACTAAGGTCGGCTGT-1	Myeloid
TACGCCTGTAGCATGG-1	Fib
TGTGGCGAGACTAATG-1	CM
TCAATTCGTGCATCAT-1	CM
ACCTGCTTCTAGTCGA-1	Fib
TCACAGATCAGATACC-1	Fib
GCTCGAGTCAGAACGG-1	Endo
GGGAACATCCAGTTAG-1	Fib
TCAAGCAGTGCGTCCA-1	Fib
GGATGAGAGTATACGA-1	Myeloid
CCTGGGAAGTCGAAAT-1	Fib
CGAGTTAAGTAACTCC-1	Endo
ACTACCCGTTGAAGCG-1	Myeloid
TACCTCGCAACTTGGT-1	Myeloid
ATCCAGAAGGTACTCT-1	Fib
TTGCTTAAGACACAAT-1	Fib
ATGTTTCCAAGGCGTA-1	Myeloid
GCATTGAAGTGTCACT-1	Myeloid
GGGAACACAAGGGAGG-1	Fib
GCCAGACTCTGTCGGG-1	Fib
GATTGACAGTAACATG-1	Fib
ACTAGGTCAATGACTC-1	Myeloid
CTAGGATGTTACACTG-1	Fib
TTGCACCTCACACGTA-1	Pericyte
GGAGTAGTCTGACTTT-1	Fib
TATCTGTAGCTAGCAG-1	Endo
GGGTTATAGCTTCAAC-1	Fib
TTACTCAAGAATCAGT-1	CM
GACTAGTTCGGTCGAC-1	CM
TGTGTCCGTAAGCCGA-1	Fib
GGCATTAAGGATATCA-1	Fib
GAACTTGGTTAGTAGA-1	Fib
ACCTGCTCAATGCCAT-1	Fib
ACAGAAATCGGGACAA-1	Fib
GATTGACGTGCCCTAG-1	Endo
TTGACGAGTAGCTGTT-1	Fib
CAACGTAGTTTCTACT-1	Myeloid
AGCTGGCGTTCACGTA-1	Fib
GTCGTAACACTCCACT-1	Endo
ACAAGCTAGTGATCTC-1	Myeloid
TCAAAGCGTAGGGTTG-1	Myeloid
TATTGCTTCAATGCAC-1	Endo
TTCATTGCAATTGTGC-1	Fib
TTACCGCCAAACGACG-1	Fib
TAGCCGGGTCAGAAGC-1	Pericyte
AAGGTTCAGTCGAAAT-1	Endo
TGATGCACATGGCCCA-1	Fib
TTGTCTAGTGCAACAG-1	Fib
TTACTTGGTGGACCAA-1	Fib
ATTGTCTAGAATATCG-1	Fib
CCATACCGTATGGGTG-1	Fib
TTGCTTATCAGAACGG-1	vSMCs
GTGCTGGAGTTATGAG-1	Fib
CAGGGCTTCGGTTGTA-1	Fib
TGCTTCGAGACACGGT-1	Myeloid
TTCTAACAGATTGACA-1	CM
CCAGAATTCGCCAGAC-1	Fib
GCCTAGGAGTTCAACC-1	CM
TGGCGCAGTACAAGCG-1	Myeloid
ATCCAGACATACAACC-1	Pericyte
GCGGTGTAGTGTGTAA-1	CM
GAACCGCGTAACAATG-1	Pericyte
GCGAGAACACAGCTTA-1	Endo
ACTTCCGAGATGCGCA-1	Endo
TACCCTGAGCGTTGCC-1	Fib
GGATAGGGTTACGGAG-1	Fib
GGAGGATTCAACACGT-1	Fib
CGTACAATCCACGCTT-1	Fib
TATCGAGCAGATGGCA-1	Myeloid
GAGGCTCTCCGGCTGA-1	Lymphoid
TTCAACTGTCATCGTA-1	Fib
ATTCGTTTCTGGACAT-1	Myeloid
TTCGTTATCGAAGCCC-1	Fib
CTGCGTTAGTCGTACT-1	Myeloid
AAAGGATGTTCCGCGA-1	Myeloid
TGTACGACACAAACGG-1	Pericyte
TTACCCGCAGGCATTT-1	Myeloid
GCCTAGGAGGAAGAAC-1	Endo
GAGTGAGGTTACACTG-1	Pericyte
CGTGGCACACACACCG-1	Myeloid
ATCCTCGTCGTTTGAG-1	Myeloid
TTGTCTACAATGGTAA-1	CM
TAGCACAAGTCTGCTA-1	CM
AGTTACGCAAATAGTG-1	Myeloid
AAATGCCCATGGCCTG-1	Endo
GAATCTGCATGGTTTG-1	Myeloid
ATGTCGATCTGACATG-1	Myeloid
CAAGCTACAGATGGCA-1	Myeloid
TAACGGTCAGTGCGAA-1	Fib
TTTGGTTGTGGCATAG-1	Endo
ACTAACGCAAGCGAAC-1	Myeloid
GTCACAATCTACATCT-1	Myeloid
ACGTTAGGTGTGACCC-1	Myeloid
GGCGAAAAGGCTTTAC-1	Fib
TCGCCTATCTCTGCGT-1	Endo
TAGCGGCGTAACGTAA-1	Lymphoid
GTAATCGCATCGAGTT-1	Myeloid
ATGTCTTCAAAGGTCG-1	Fib
GTGTCAAGTTAGTAGA-1	Fib
CTTCTAATCTCTATCA-1	Myeloid
TGAATCGCACTCGTGG-1	Pericyte
GCGTTGGTCGGATAGG-1	Myeloid
GACCAATCATCGAGTT-1	Fib
TACTAGGCATCGACCG-1	Fib
GAAACAAGTCAGAAGC-1	Myeloid
AACCTGATCTACTTTG-1	Myeloid
ATGGATCTCGCTTGAA-1	Myeloid
TAGCGGCTCGTATAGC-1	Lymphoid
TCAAGACGTCTGGGCT-1	Myeloid
CATGCCTGTTGCAGCC-1	Fib
GTGGCGTAGCTATCGT-1	Myeloid
TCAATTCTCGATTACG-1	Lymphoid
TGGCCTTTCAATTCCT-1	Fib
CACCTGTCACACACAT-1	Lymphoid
TCAGTTTCAAGGCTTT-1	Endo
CTAACTTCACCGATCG-1	Myeloid
TTGACGATCTTCTCTC-1	Fib
CACCACTAGTTCAACC-1	Pericyte
ACATGGTAGCATACCT-1	Myeloid
CTGCGTTCAATGTAAG-1	Myeloid
TCGGGACCAGGACTGA-1	Fib
TTACCCGAGTAACTCC-1	Myeloid
TGATTTCTCGGTACTA-1	Myeloid
AAATGCCAGGGCTCTC-1	Myeloid
TCTCTGGTCGAGAACG-1	Myeloid
TGGTCAATCCCAGTAA-1	Myeloid
ACCCAAACATTGCGAT-1	Myeloid
GTAGTACGTCTGTGTA-1	Myeloid
TGAGTCAAGGGCTTCC-1	Myeloid
GATCGTAAGTCGTGAG-1	Myeloid
TGATCAGAGTACCCAT-1	Lymphoid
CACTGAAGTGAATACA-1	Fib
TGCCTCACATGCGACC-1	Myeloid
TACCTCGGTTACCACA-1	Myeloid
GCTTTCGGTGTTGGTT-1	Myeloid
GCAAAGGTCGGTTAGT-1	Myeloid
TAATCGGGTTACTACG-1	Myeloid
ACAGGCCAGAGGAACA-1	Myeloid
TCTCTGGCATCCCTCA-1	Myeloid
GATGGCCAGATGTTCC-1	Myeloid
GGTACCGCACAGGAAC-1	Fib
GCTGAGCTCAAGTTGC-1	Endo
CCCGTTACATACAACC-1	Pericyte
CATGCCTAGCTTTCCC-1	Fib
AGGCGTCAGCTAACAA-1	Myeloid
GCTCACTGTAAAGGCC-1	Myeloid
CTTCTAAAGGTACATA-1	Endo
CACCTGTAGAAAGGGT-1	Myeloid
GCGATCGAGCAGAAAG-1	Myeloid
CGGTGCAGTAGGGTCA-1	Fib
ACAAACCTCAGAACGG-1	Myeloid
TCAAAGCGTGTTGGTT-1	Myeloid
GCTCACTAGCCAGAAC-1	Endo
TACGCCTAGCTTCAAC-1	Myeloid
CTTGTCGAGCGCAATG-1	Myeloid
CCGTAGGCAATTCGTG-1	Myeloid
AAAGATGGTGAATCGG-1	Myeloid
AGTTACGCATACTGCA-1	Myeloid
TATCTGTGTTCAGAAA-1	Myeloid
GGTGAAGGTTATCGAC-1	Myeloid
GTTACGATCGGTTAGT-1	Endo
GATTGACCAGCAGGTA-1	Myeloid
TCAGGTACACACATTG-1	Myeloid
AGCCCGAAGGCTTCGC-1	Fib
AGCTATGGTACAACGG-1	Myeloid
ACAAAGAGTACGGAGT-1	Myeloid
TGCTCGTGTCAGTGTT-1	Myeloid
CCACGTTGTGCCGGTT-1	Myeloid
GGAATCTGTATGCTAC-1	Pericyte
ATTTGTCAGGTTAACA-1	Myeloid
TCAATTCTCGGGCTCA-1	Pericyte
GCTGTTCAGCAGGAGG-1	Endo
TCACTCGGTTGGCGAA-1	Myeloid
AACGGGATCTGATCTT-1	Myeloid
AAGGAGCGTGCTGTGC-1	Myeloid
AGGCGTCAGTAGTGTA-1	Endo
TACCTATGTTCCATCC-1	Endo
CTACAGACATGCTATG-1	Myeloid
TCCATCGGTTCCTATT-1	Myeloid
TCCCACAGTTCCATCC-1	Myeloid
TGCTCACCAAACCGAG-1	Lymphoid
CACTAAGTCTCGACAA-1	Myeloid
GCTTGCTCAGATTTGC-1	Lymphoid
TTGCGGGAGCCTTTGA-1	Fib
TTACCCGGTACGGATG-1	Myeloid
TTGCAGATCACGTCAA-1	Myeloid
ACCCAAATCGGTTGTA-1	Endo
ATTCGTTGTGCCCAGT-1	Endo
AGCTGATAGAGCCACA-1	Myeloid
AGGCCTGGTGAATCGG-1	Myeloid
GAGAACGAGTCCGATT-1	Myeloid
CGCTAGGAGTGCTAGG-1	Fib
TCCGACTGTGTGTGTT-1	Myeloid
CGCAATAAGACTTGAA-1	Myeloid
AGCGTATAGTGAGCTG-1	Myeloid
GTAATCGTCTTTGCAT-1	Myeloid
CCGTAGGTCCGGCTGA-1	Myeloid
GAGGATGTCTCCTTAA-1	Myeloid
ATGTCGAGTCAGAAAT-1	Myeloid
TGGGTGCTCAGTCAAC-1	Endo
TTGCAGAGTCAAGACG-1	Myeloid
AGGCCCAAGGCTCCTG-1	Myeloid
TCACCACTCCATATCT-1	Myeloid
CGCTATCGTGAGTCGA-1	Endo
CTAGGGCGTGATAAGT-1	Pericyte
AGCGTGCCACAAGTGG-1	Endo
CCCTAGTCACTCAGCG-1	Myeloid
ATCGAGTGTTGTGAGG-1	Endo
GCGCATGGTTCATTTC-1	Fib
TGGCAATAGCAGTAGC-1	Myeloid
GGTGTCGGTTCTTAGG-1	Myeloid
GTTGGTACATTACACG-1	Fib
CCACAGGTCGTGGCGT-1	Myeloid
GCTCGAGGTTCCGGCA-1	Myeloid
GACTAGTTCACTAGCA-1	Myeloid
GGGCCATTCGAGGTAG-1	Myeloid
GCATTCCAGATCGAGC-1	Myeloid
CGGTGCACACATCATG-1	Myeloid
CTAACTTCATGGGACA-1	Myeloid
AGCGATTTCGCCAGAC-1	Fib
GCTTTCGTCTCGTAGA-1	Fib
TTACGTTGTTTCGATG-1	Lymphoid
TTAGCGACACAACGGA-1	Myeloid
CTGCGTTGTGACGCAA-1	Endo
CGCGCAATCTATCTTG-1	CM
CCTCCCTTCGGTCAGC-1	Endo
AATACGCCAGCTATAC-1	Myeloid
AGCCTGGGTTTCTACT-1	Myeloid
AGTGCCGTCAACGTGT-1	Myeloid
GCTCCTATCGATCTTT-1	Myeloid
CGGACTGCATTCACCC-1	Myeloid
AACCGATTCGTCAACA-1	Myeloid
TCGCAGGAGGTTAACA-1	Myeloid
AGCTGATAGTAATCAG-1	Fib
CCAGAATAGTGTCGGA-1	vSMCs
AGCGTATTCTTAGTGG-1	Myeloid
ATTCGTTGTGGAAGCT-1	Myeloid
GCCAGCATCTAGTCGA-1	Fib
CGGTGCAGTCATCAAC-1	Myeloid
TATGTGGTCGCTTACC-1	Endo
GAACCTAAGTATACGA-1	Myeloid
CCTTGGTTCGCATACA-1	Lymphoid
AACGTACGTCTGATTG-1	Myeloid
GCGCATGAGAGACTCG-1	Endo
TCCAGAAGTTCTTTCA-1	Myeloid
GAGATTCAGTCGAGCA-1	Fib
GAGTGAGCATTACTCT-1	Myeloid
CAGCCTTTCCAACAAC-1	Myeloid
GGAATCTGTTCATTTC-1	Endo
GGCACGTTCCTGTAGA-1	Myeloid
AGCTGTAAGCACGTAG-1	Lymphoid
CAACGGCGTCCTCAGG-1	Myeloid
TGCATTTCAAGTCTCA-1	Myeloid
TAGCATGGTAACGGCA-1	Pericyte
TCCGACTAGTAGAAGG-1	Myeloid
TAAACCGGTTCTCGAA-1	Lymphoid
TGTGACAGTAGGGTCA-1	Fib
AAACTGCAGGAGTACC-1	Fib
GCCTAGGTCTCGTGAA-1	Fib
TGACAACTCTGAACGT-1	Myeloid
TACTGCCCAGTCCTGG-1	Myeloid
TAACTTCTCACTGATG-1	Myeloid
TTACCCGGTTTGTAGC-1	Myeloid
TTCTAACTCTTCCAGC-1	Myeloid
ACAGACTCAACGAGGT-1	Lymphoid
AGCGTATAGACCCATT-1	Lymphoid
TGATTTCGTGCTTGAT-1	Myeloid
CTGCTCACAACTCAAC-1	Pericyte
GTCACTCCACGCTAAT-1	Myeloid
TTCATCAAGGATTAAC-1	Myeloid
AGTTACGGTATGAAGT-1	Lymphoid
TGTGACACATTTAGGC-1	Myeloid
CCTGCTAGTCATAAGA-1	Lymphoid
AGATTCGTCACACGTA-1	Myeloid
CCGTAGGCAGTTACAC-1	Fib
GCAAAGGAGTTCGCGC-1	Myeloid
GCTCACTCATTGAACC-1	Myeloid
ACCTGCTTCTCGTGAA-1	Myeloid
TTACTTGCATGGTATC-1	Myeloid
TACGCAAGTGTCCCAG-1	Endo
GGTCATAAGCGCCTAC-1	Myeloid
GCCTACTTCGCTTCAC-1	Endo
TCACTCGTCCGTGCGA-1	Myeloid
CTCCCAAGTAGAGAGA-1	Myeloid
TCCAGAATCATTGCCC-1	Myeloid
CTCTACGAGACCTATC-1	Myeloid
TCAGGTAGTAACCATC-1	Endo
CTGAATGTCGGCATAT-1	Endo
TTATGTCCAAGTAATG-1	Myeloid
TGAGCCGAGGTTGACG-1	Myeloid
AACCAACGTAACGGAC-1	Myeloid
TACAGCACAGACCTGC-1	Myeloid
GTCACAACATAGCCGC-1	Fib
TGCTCACGTAGCAGCA-1	Lymphoid
TTGTTGTAGTCCCGCA-1	Myeloid
TGGCCTTAGCGTATCT-1	Lymphoid
CGCAATAAGATTAGAC-1	Myeloid
CATAACGAGCGTCTGC-1	Endo
TTGCCCAAGTGAGTGC-1	Fib
CTGGGACCATTCTCGC-1	Myeloid
CTTGTCGAGCCTATAC-1	Endo
GGGAACACATTCCCGT-1	Myeloid
CGTGGCACATAGATAG-1	Myeloid
ATCCAGAGTGTCCAGC-1	Myeloid
CAACGGCAGTCAACTC-1	Fib
CTTTGCGTCGCAGATT-1	Lymphoid
TCAAGGTAGTATACCC-1	Myeloid
GCGCATGTCCAGGTCG-1	Endo
CCCTCTCAGATATGTG-1	Myeloid
GAAGTCTGTGGCCTTG-1	Myeloid
CAGGGCTCAAGCAGGT-1	Myeloid
ACGGATTAGCTAACAA-1	Myeloid
GAGGTCCTCAAACCAC-1	Lymphoid
GGATGAGTCTGGAAGG-1	Myeloid
GTGTCAAGTGAAACAT-1	Lymphoid
CGGACCACAGGTCTGC-1	Myeloid
GCTCAGGCACCCTTTG-1	Myeloid
GCTCGAGCATTATGGC-1	Myeloid
AGCTGGCAGTCAACTC-1	Myeloid
CCAATGACAATTGTGC-1	Pericyte
ACAAACCGTCAGTGTT-1	Lymphoid
AGGCCTGCATCCCTTG-1	Lymphoid
ATCCCTGTCTCTGCAC-1	Lymphoid
CAGCTGGTCGTGCTTC-1	Pericyte
GGAGTAGTCCTAAAGC-1	Myeloid
ATTACTCCAAATGTCC-1	Lymphoid
GTCACAATCCAAGAGG-1	Pericyte
TATGTGGAGACCAATA-1	Lymphoid
AAGATAGGTGCTGAAG-1	Fib
CCGAAGCCAGCGTACC-1	Lymphoid
CAATCCCGTCAAGACG-1	Pericyte
CTCTAGCAGTGTCGCC-1	Myeloid
CGGTGCAAGAGAGTAG-1	Lymphoid
GGCATTACATGCGACC-1	Endo
TGAGCCGAGGCAGTAC-1	Lymphoid
TTCTAACTCCCGTATC-1	Lymphoid
GAGGCTCAGGCTTCGC-1	Myeloid
GGAACCCCAATGGTAA-1	Endo
TGGGTGCCAGCGTGAA-1	Pericyte
CATTCATTCTTGTCGC-1	Myeloid
AGATAGAAGCTACGCC-1	Lymphoid
GCCCAGACAAACTACC-1	Lymphoid
CTAGCGGAGGAGTCTG-1	Endo
TGATGCACATTAGCCA-1	Lymphoid
TCAGGTATCTGCCGAG-1	Myeloid
ACAAACCTCAACACGT-1	CM
GCTTTCGTCTCATATC-1	Lymphoid
GATTGACCAACCTCTC-1	Pericyte
AAACGAATCGGGATCC-1	Myeloid
GCTGCGAAGTCCTTCC-1	Myeloid
TAGGTGTGTGGATTTC-1	Lymphoid
GAGGCTCCACCTGTGG-1	Myeloid
AAATGCCGTAGTCTGT-1	Endo
GCACCTTTCTAGCAAC-1	Endo
GCTGAGCAGCTTTCCC-1	Endo
AATGGCTAGGGAGTTC-1	Endo
CATTCCGTCCTTCGAC-1	Myeloid
AGTGTACGTGGAGTGT-1	Lymphoid
GTCACCTTCTGTGTCC-1	Myeloid
GAATCTGCACATATCG-1	Fib
TAGTCCCGTAGTTTGC-1	CM
GCGGAAAAGTCGTATC-1	Myeloid
CCCTGATTCCCGATTC-1	Lymphoid
TATGTGGTCGCCTTAC-1	Myeloid
CCTTGCACAGGGTAAC-1	Lymphoid
TTCGGTCCAATTCAGC-1	CM
ACCCAAACAAATGCTC-1	Myeloid
CAGCTAACAGAAAGAG-1	Fib
CTTGTCGAGCTAGTTC-1	Pericyte
ACCCAAACATCGACGC-1	Fib
ACAGACTAGTCGACCC-1	Endo
AGCCTTCCAGCGCGTT-1	Endo
CACGTTCCACGCGACT-1	CM
TCACAAGCACTCGCAG-1	Myeloid
AGTGTACCATAGATAG-1	Endo
AGCCAGCGTACCAAGG-1	Lymphoid
TTATGTCTCAGAGTGG-1	Myeloid
GGAACTTTCAAGAGGC-1	Endo
CTCACCAGTTCCTATT-1	Myeloid
TTAGCGATCGTGGGTC-1	Myeloid
TGCTCGTAGAAACGCC-1	Endo
GGTCATATCCATAACG-1	Myeloid
GCTTTCGGTGCGTGTC-1	Pericyte
GAGATTCCAATGAAAC-1	Myeloid
ACGGATTTCAGGAAGC-1	Myeloid
TTTGGCCGTCGCGCTA-1	Myeloid
