Barcode	cell_type
ATCGAGTAGAAAGGGT-1	Fib
TAAGCCACAATTCAGC-1	Fib
TTACTCAGTGATAACA-1	Endo
AACGGGAAGAGCGGTT-1	Fib
TTACGGACATATTGGC-1	CM
GCGATTACAGAACGAC-1	Endo
GTGGATTAGAGAACCC-1	Fib
GAACGTTAGAGCGGTT-1	Fib
CATAACGAGGGACGTT-1	Fib
TGTTAGGAGCCTATAC-1	Myeloid
GGAACTTAGGTAAGTT-1	Endo
GTTACGATCACGTGTA-1	Endo
AATGGAAGTGCACCCA-1	Fib
AACTGGTTCCACGAGC-1	Fib
TGCTCACTCGGGACAA-1	Fib
GGTGCTGGTAAACGTA-1	Fib
GCCAGACCACTCAAGT-1	Myeloid
CAACGTAGTATATGGA-1	Endo
ACAGACTGTGTCGTCG-1	Fib
GGTGCTGTCCCGTAGG-1	Endo
AAGGTTCAGAGAACCC-1	Fib
GGTTGCGGTTCAGAAA-1	Fib
TCCAGAACAGTCCTGG-1	Endo
CAGGATTTCCAGTTAG-1	Pericyte
ACCGCAGTCCTGACCT-1	CM
TTGTCTATCCGAATTG-1	Endo
TTTGTGTGTTAACTCG-1	CM
CTTGCCAGTAGGTGAC-1	Endo
GACCGACGTTCAGTAC-1	Endo
ATTACCTCATTGCCTC-1	Fib
GGCGAAAGTGGACCAA-1	Myeloid
TCGGGACCAGACTAAA-1	Endo
GTACTTTCAATAGCGG-1	Fib
CCGCATTGTCCTTATT-1	Fib
GCTCCTATCCTGTGGG-1	Fib
TACTAGGTCTCTGAGA-1	Endo
GTTACTTGTAGCAGGT-1	Fib
TAGGAGGGTTTGCGAT-1	Fib
GCGGTGTGTTTAGGAA-1	Fib
TGATTTCCAGAATGCG-1	Fib
GTAGTACGTAGAAAGG-1	Myeloid
GCTCAGGCATTACTCT-1	Endo
TACGCCTTCGTGCTGG-1	Fib
TATCTGTAGACACGGT-1	Fib
CAGGGCTCAGTTGGAG-1	Myeloid
GTGACATAGAAGAGTG-1	Pericyte
ATGGATCAGTGTCACT-1	Endo
GCTCAGGCATTGAACC-1	Fib
CAGGATTAGGTGATGC-1	Fib
TTACCGCAGTGGTGTG-1	Lymphoid
GCTTTCGGTACGGATG-1	Fib
TGGGTGCGTTCGGGAA-1	Fib
TAAACCGTCTGATCTT-1	Endo
GGTGCTGAGGCAGTAC-1	Fib
TGCGTAATCGCAAACT-1	Fib
AGGCGTCTCACTGATG-1	Fib
GCCCGAAGTTCCCGGA-1	CM
CCTAAAGAGCACCATT-1	Fib
GGGTCTGGTACCCACG-1	Endo
CCGAAGCGTATCACAC-1	Fib
TCCATCGAGACTCGGA-1	Lymphoid
CTCTAGCCAATGGCAG-1	Endo
CAATCCCAGATGAGGA-1	Fib
ATCGAGTTCGCCCTTA-1	Fib
ATCCAGACATATACGC-1	Fib
GAACCGCTCAGTTGAC-1	Myeloid
CACAACAGTAACGGTG-1	Myeloid
GATCATGCAGAACTTC-1	Endo
GCACGGTGTTAGGAAT-1	Endo
TTACGGATCCTTTGAT-1	Myeloid
GAAGTCTGTAATGTGA-1	Pericyte
ATGTACGTCACTAGCA-1	Fib
TGACAACGTACCCACG-1	Fib
TTCTAACAGCAGAGCT-1	Myeloid
TTCATCAAGAGCAGCT-1	Fib
TGTGTCCCACTGTTAG-1	Fib
TAGCACAAGTCACGCC-1	Endo
CTTGCTGAGATGGGAA-1	Fib
CAGTGCGCAATGAAAC-1	Myeloid
GTAGGAGTCCAGAGAG-1	Fib
TGCATTTCAGTGCGAA-1	Fib
TTCGGTCCAAGCCAGA-1	Myeloid
GGAGAACCAAGAGCGT-1	Myeloid
GAGCATTTCTTGCGCT-1	Endo
TGAGCCGCATTGCACA-1	Fib
TTCAACTAGAACTCCT-1	Myeloid
AGCCTTCAGCGTATCT-1	Endo
GAGATTCAGTCGTATC-1	Pericyte
CTGGCAGCAGGTGTCC-1	Myeloid
ACTATTCGTAGACACG-1	Endo
AACAAAGCACTGTCGG-1	Fib
GTAATCGAGTCTCCAA-1	Myeloid
CAGCCTTCAAGAGCGT-1	Endo
GGGTTATTCGCATACA-1	Fib
CACCACTTCAGGATCT-1	Endo
GCGTTGGTCAGTCTTT-1	Endo
CAACGTAGTAACCATC-1	Endo
CACAACAGTTCTTAGG-1	Fib
AACGTACAGTATGCTC-1	CM
ACTAGGTTCTCTTAAC-1	Pericyte
GCGTTGGCACCTGAAT-1	Endo
TGCTCACGTGCACATT-1	Fib
TATCTGTGTATTGTCG-1	Myeloid
CTTAATCGTACCTATG-1	CM
ATCCAGACACTAAACC-1	Endo
AATGGCTTCCTGGGAC-1	Myeloid
TCGCCTAAGTACCTCA-1	Endo
CACCACTCAACGTAGG-1	Endo
ATAGTCGTCCTCTCTT-1	Endo
CTCAGCTTCCAGGGAA-1	Myeloid
TCGGGACAGGAATGGA-1	Fib
GACCCAGAGAAGAGTG-1	Pericyte
GCTTAAGTCTCTTCTC-1	Endo
CTTAATCGTCCGAGCT-1	Endo
GTGATCATCCGAGAGA-1	Fib
ACATGCAAGACTCGGA-1	Myeloid
TTGGTCCAGTCAGCCC-1	Fib
CCCGTTACATCGGCCA-1	CM
TAGACTGAGGCTCCTG-1	Fib
GCACGGTTCCAACCTC-1	Fib
GCCAGCAAGGGAAGCG-1	Endo
GCCTACTGTCAGGCTC-1	Fib
TGACAACAGCGTCAAG-1	Fib
TAGCTTTGTGCATCAT-1	Fib
ACTTCCGAGTCGCCTG-1	Myeloid
TAGGTGTAGACTAGCG-1	Lymphoid
AATGGAAAGGCAATTA-1	Myeloid
ACTACGACACGCTAAT-1	Myeloid
TTGCACCTCGATCGCG-1	Myeloid
CCTTAATGTGCTGTGC-1	Endo
CGGTGCAAGTCTGCTA-1	Endo
TAATTCCCATAGCCGC-1	Endo
AAGGAGCCACTCAAGT-1	Myeloid
ACTACGAAGTAATCAG-1	Myeloid
CGGACCATCCCACTTG-1	Endo
GGCACGTAGTTGGAAT-1	Fib
TTCATCAGTTCTACGA-1	Fib
GTTGGGCCAGAATGCG-1	Myeloid
GACCGACAGTCGGGAT-1	Endo
GTGTCAAAGCTTTCCC-1	Myeloid
CTCAACCCAACCTCCT-1	Myeloid
AAACGAAAGCGAGCTA-1	Myeloid
GATGATCAGGATCCTT-1	Myeloid
TTACCCGAGCCTCGCA-1	Myeloid
AGCGATTTCCCGGGTA-1	Myeloid
GCGCATGTCATTCTTG-1	Myeloid
GAACTTGTCACTACCC-1	Myeloid
TACCCTGAGGATTAAC-1	Lymphoid
CATTGGAGTTCCTATT-1	Lymphoid
TCAAGGTTCCATATCT-1	Endo
GAGTGAGCAGCTGATT-1	Fib
ACAGCGCTCGGCATAT-1	Lymphoid
GGTTGCGCACATGATC-1	Myeloid
TACATGGGTCACTCTC-1	Myeloid
ACTGCAAAGAGAAGCA-1	Myeloid
ATCCTGCAGCACCATT-1	Fib
AGGCGAAGTCAAGACG-1	Myeloid
GACCGACCAGCGCGTT-1	Lymphoid
CTACTTATCCCATAGA-1	Myeloid
GCTGCGATCCAGGCCA-1	CM
TCAGTCCAGACCAATA-1	Fib
ATGTACGGTCTCTGGG-1	Myeloid
CTTTGCGTCTGAACGT-1	Fib
CGCGCAATCCACGCTT-1	Fib
TTTACGTCACGCTGTG-1	Myeloid
CGCTATCAGTCTCTAG-1	Lymphoid
TAAGTGCTCGTGATAC-1	Myeloid
CGCAGGTAGAACTAAC-1	Endo
GGTACCGGTGGTAGAC-1	Myeloid
CCCACATTCCTCCATG-1	Myeloid
TCAGCTCTCCTGGGAC-1	Myeloid
CGTAAACGTAAACGTA-1	Myeloid
CAACCAAAGTGATATG-1	Endo
ACTATTCAGAAACGCC-1	Myeloid
GGAGAACCATCAGCTA-1	Endo
TACAGCACAATGATGA-1	Myeloid
GTTGGGCTCTTCTCTC-1	Lymphoid
GTTGGGCCAAGAGCGT-1	Myeloid
CTCATGCAGAACGACC-1	Endo
AACAGTCAGAATGCTA-1	Myeloid
TGAATCGCATTTCTTG-1	Myeloid
AATGGCTCAGGCTACC-1	Lymphoid
CAGGGCTAGTGAGTTA-1	Myeloid
CAATCCCTCTCTGCAC-1	Myeloid
