Barcode	cell_type
ACGTGGCGTAACCCAT-1	Fib
GGTTGCGCAAGGAACC-1	Myeloid
GGAATCTCAAGATGCG-1	Endo
ACTGCAATCAAAGTAG-1	Fib
CAAGCTACAATGCACT-1	Myeloid
TTGCGGGAGAGCAGCT-1	Fib
AACCTGATCTCTGCGT-1	CM
TGACTCCCAATTGTGC-1	Fib
GCTCGAGGTTTAGGAA-1	Fib
ACCAAACGTTCCCTTG-1	CM
GCTGAGCTCGGCAATT-1	CM
AAAGATGTCGACTATG-1	Fib
TCACAGATCCATGACA-1	Endo
CAATCCCCATCACAGT-1	Myeloid
GAACCTAGTACTTGAC-1	CM
GCGGTGTAGTGCTAGG-1	Fib
GCAGATTCAAAGAGAG-1	Myeloid
AACTGTGTCGATCTTT-1	Fib
TACATGGGTGTCTACA-1	Fib
TGCCTGTGTAAACGTA-1	CM
GATGATCAGAATCAGT-1	Myeloid
TCACCACGTATTCGCA-1	Fib
TTGAGTGGTACGCCCA-1	Fib
GCAGATTCATGATCGT-1	Fib
CACCTTGCACAGCTTA-1	Myeloid
GGAGAACGTACTTCGA-1	Fib
ACCCAAAGTACGTAAA-1	Myeloid
ATCGAGTAGTCGTACT-1	Myeloid
ACAAACCTCACCCGGA-1	Fib
CTGTTCGCACAGATGG-1	Fib
GGATAGGTCGTCAACA-1	Lymphoid
CACCTTGGTCACAGGA-1	Endo
CTACTTAGTTCCGCGA-1	Endo
CCTGCTATCAGAACGG-1	Endo
TCACTCGAGAGTTTGA-1	Fib
TTGCGAAAGTCTGGGA-1	Endo
GCCCAGATCTTCACTA-1	Myeloid
TCCATCGAGATTCCGT-1	Fib
CTCAGAATCACCACAA-1	Fib
TCAAGACAGAAATTCG-1	Endo
GAGGATGTCAGGGTTT-1	Fib
GAACGTTAGGTCTTTG-1	Myeloid
TTAGCGACACACATGT-1	Fib
AATACGCCATATAGAG-1	Myeloid
TCGAGCGCAAACCGAG-1	Myeloid
CGGTGCAAGGTAGGCT-1	Pericyte
GCTTAAGCACATAAAG-1	Myeloid
CTGTATTGTTTAGAAG-1	Myeloid
GATGATCTCTCCCTTT-1	Pericyte
TTCTAACAGGCTTAAA-1	Endo
AGCTGATTCAGCACGC-1	Myeloid
CGCTATCTCAGGGTTT-1	Myeloid
TTGTTGTAGGCCTCGT-1	Endo
TTGTTCAAGTTAGAGT-1	Myeloid
GGGTTATTCGAGGTCC-1	Fib
TGTAGCATCAGGAAGC-1	Myeloid
CTGGCAGTCAAGGCAG-1	Myeloid
TATGTTCCAGTCAGCC-1	Lymphoid
ACTAACGAGTTCGACT-1	Endo
GCACCTTAGACTCGGA-1	Myeloid
TAAGTGCTCATTCATC-1	Endo
ATGTTTCTCTACTGCC-1	CM
GTTATTCTCTATGAGC-1	Myeloid
TGCCTCAAGCGCACAA-1	Fib
GCGGTGTCAAGATTAG-1	Myeloid
TTAACGGTCAAACCCA-1	Myeloid
GTGTCAAAGACGACTG-1	Myeloid
TTCGGTCCAATGGTAA-1	Lymphoid
CGCTAGGTCATCATGG-1	Endo
GGGTCTGGTCCATTGA-1	Myeloid
CTCCCAACATTCGTCC-1	Endo
GGTAGGACATTCACCC-1	Myeloid
TGATCAGGTGGAGTGT-1	Myeloid
GACTAACAGTAACTCC-1	Fib
GAACGTTCAGGGTAAC-1	Myeloid
CCTGCTAAGATCGATA-1	Myeloid
GCAGCCAGTATATGGA-1	Pericyte
TACTAGGTCAAGAGGC-1	Myeloid
GAACCTAAGTCTCCAA-1	Myeloid
TGAATCGCACCGATCG-1	Fib
CCAGATATCAATTCCT-1	Endo
GTAGACTTCGGCATAT-1	Myeloid
GGTTGCGGTCACAGTT-1	Myeloid
GCGGAAAGTAACTGAA-1	Endo
CCTCCCTCATCGTACA-1	Myeloid
AATGCCACAAGCGGTA-1	Myeloid
AAAGGATGTCCCGAGT-1	Fib
TTGCGGGGTTGGACGA-1	Myeloid
TCAAAGCGTCAAACAA-1	Lymphoid
GAAACAAAGTTACCAC-1	Fib
CGTACAAAGTTACACC-1	Fib
TCAGGGCAGTAGAAGG-1	Myeloid
GGAGTAGGTTTGAAGA-1	Myeloid
TGATTTCGTGCTGTGC-1	Fib
CCGTGAGGTAGTCTGT-1	Myeloid
GCACGCAAGCGCGTTC-1	Endo
ACGGATTTCGTCCCAT-1	Endo
CAACGTATCAGGAATA-1	Myeloid
TTCTGTATCGCCCTTA-1	Endo
TGCATGACACCGATCG-1	Myeloid
CTCACCAGTGGCGCTT-1	Fib
TCGCCTATCTCATCCG-1	Lymphoid
CCCTAGTGTTTGCGAT-1	Myeloid
CATTCCGAGGCACTAG-1	Endo
TGGACATCAAGCCCTG-1	Myeloid
GCTCGAGTCGAGAACG-1	Myeloid
GTTACTTGTGATAACA-1	Myeloid
GGTTGCGGTCTTAGCA-1	Myeloid
CTGGGACAGATCACCT-1	Myeloid
AAGATAGGTCTAACCA-1	Pericyte
TATTGCTGTTGTGACT-1	Fib
GCATGATCAGAGAGAA-1	Myeloid
AACAAAGGTGAGGTCA-1	Myeloid
TCAAGCATCGAGGTAG-1	Myeloid
GCGGGTTGTACGTATC-1	Myeloid
CTCCCAAGTATCAGCT-1	Myeloid
GCCTAGGCACATATCG-1	Myeloid
GGGCCATGTGCTTGAT-1	Lymphoid
TACTAGGTCTTGTCGC-1	Pericyte
TGTAGCAGTCTAAGAA-1	Endo
TACATTCAGTAACACA-1	Myeloid
TCCAGAAGTGGCGCTT-1	Myeloid
GAACCGCGTTATCGAC-1	Myeloid
ACCATCCCATTGTTCT-1	Myeloid
GCATGATCAGAAGTGC-1	Myeloid
ATCCAGACAAGCGGTA-1	Pericyte
ACTACCCTCCTCCTGA-1	Myeloid
ACGTTAGTCGATATGC-1	Myeloid
ATCCCTGAGCGATACG-1	Myeloid
CCTAAAGGTCGACTGC-1	Myeloid
ACAGGCCGTCCAAGAG-1	Myeloid
TGCATTTGTATCGCGC-1	Fib
TAGCATGAGATTGACA-1	Myeloid
TTGTCTAGTTTGTACG-1	Myeloid
GAGGCTCAGAGTTTGA-1	Fib
GCACGGTGTACGCCCA-1	Pericyte
AACGTACGTAACGTAA-1	Myeloid
AACGAGGTCCAGTACA-1	Fib
CTCATGCAGGAGAACA-1	Fib
GCAAAGGAGACCATAA-1	Myeloid
CCCTAGTAGACCCTAT-1	Fib
ACTGCGGGTCCGAGCT-1	Myeloid
GCAGCCACAGCAAACG-1	Myeloid
TCTATTGAGACTTGAA-1	Myeloid
AGCCGCATCCAATCCC-1	Myeloid
TCTCAGCCACACACAT-1	Myeloid
TACGCAATCGTCCCAT-1	Myeloid
TACCTCGCACTCAAGT-1	Endo
ATTCGTTAGAGAATTC-1	Myeloid
ATCCTCGAGAGATTAC-1	Endo
TGCTTCGGTATACGCT-1	Myeloid
GAAGAGCTCATACTTC-1	Myeloid
GCGAGAAAGGGTATCG-1	Pericyte
CAGCTAATCCTGAAAC-1	Myeloid
GCGGTGTGTGTGACCC-1	Endo
CATTCCGTCTGTTTAC-1	Myeloid
TAGGTGTCAGGCAAGT-1	Myeloid
GCCCAGATCCGGACTG-1	Myeloid
TCAAAGCGTGCTGTCG-1	Lymphoid
GGTAGGACAAATGCTC-1	Endo
TTCAACTTCTTCCAGC-1	Endo
CGCAGGTGTAGTAACA-1	Lymphoid
GGTGAAGAGATGGCAC-1	Pericyte
ATTTGTCCAGGCAGAT-1	Lymphoid
TCACCACTCAGCACGC-1	Pericyte
TAAACCGGTGCGCATC-1	Myeloid
CCAGAATTCGGGACAA-1	Endo
TACCTCGGTCCGGTAC-1	Myeloid
TCACCTGTCGCTCTAC-1	Endo
GTCTACCGTTTAGACC-1	Endo
AACTGGTGTGCCGGTT-1	Fib
AAAGGATGTTGCAGAG-1	Endo
TATGTTCCACCGAATT-1	Myeloid
AGCCAGCGTCTGGGCT-1	Myeloid
ACCCAAACATCCGTGG-1	Lymphoid
CTAGCGGCACGGTGTC-1	Fib
GGTGCTGGTATCAGCT-1	Pericyte
ACATGCAAGTAGCAAT-1	Myeloid
CAGGGCTGTTCTGATG-1	Myeloid
CAGTGCGCACTGTCGG-1	Myeloid
ACAGACTGTATGTCCA-1	Pericyte
ATCCTGCAGTTGCCGC-1	Myeloid
TGTGTCCTCCAAGTCA-1	CM
CAGTGCGCAAGCCCTG-1	Endo
AGCGTATAGTGAAACT-1	Lymphoid
ACAAGCTTCCCGTAGG-1	Lymphoid
TTCATCAGTAATGCAA-1	Endo
AACTGTGTCAGGTTTG-1	CM
CAAGCTAGTTTGGATC-1	Myeloid
GGTGAAGGTTGAAGCG-1	Endo
AGGCCCAGTGGGTAGT-1	Fib
GTCACAAAGTTATGAG-1	Endo
TTCTAACGTACGGATG-1	CM
TTCGTTACAAAGACGC-1	Myeloid
GCACGCAAGAATAGTC-1	Fib
GGTGAAGTCTGGCCAG-1	Endo
GGTTGCGAGCCTTTGA-1	Endo
TTCTGTACAAGGGAGG-1	Endo
