Barcode	cell_type
GACCAATCAATAGCGG-1	CM
TAACGGTTCGACTGGC-1	CM
TTGAGCACAACAACTC-1	CM
TGCATGACACAATAAG-1	CM
TGAGCCGAGTCGTGAG-1	Fib
AGCTATGTCGCTATAG-1	CM
TGAGCCGCAACTCGTA-1	CM
GAGATTCCAAGCCCTG-1	CM
TATGTTCAGGTAAGTT-1	CM
CAGGGCTGTTATAGAG-1	CM
TTCTGTACAACGGGTA-1	CM
TACAGCATCAAGAGAT-1	CM
TGTAGCAAGTCACGCC-1	CM
AGCGTATAGGAAGGTA-1	CM
CTTAATCGTTTAGAAG-1	Myeloid
TGACTCCCAGTAACCT-1	CM
CAGTGCGAGTTATGAG-1	Myeloid
GTCACAAAGTGTGTAA-1	Fib
GTAGTACGTGCTGTGC-1	CM
TGACTCCCACCTACCT-1	CM
TGTACAGCAAGTTCGT-1	CM
TCAGGGCTCACTCGGG-1	CM
GGCGTTGCATCGACCG-1	CM
CGGACTGTCACCCTTG-1	CM
CACCACTAGCATGATA-1	CM
TAGACTGCAATGAAAC-1	CM
TTGCGGGGTACCCATA-1	CM
GGCATTACATACAACC-1	CM
CAGCTAATCTGGTACA-1	CM
TCGGGACAGAGTTCGG-1	CM
ACCGAATTCTATCTTG-1	CM
GGGCCATTCCTCCCAA-1	CM
CAACCAAGTCCTATTT-1	CM
CAACGGCCATGTGAGG-1	CM
TAACGGTTCCTATCAT-1	CM
ATAGGCTGTGACGCAA-1	Fib
GGTGCTGAGTGCAACG-1	CM
CTCAGAAGTAGAGAGA-1	CM
CCCTAACCATACTGCA-1	CM
AGTGCGCAGTCCTTCC-1	CM
TAGTCCCGTATGGGTG-1	Endo
GAGGTCCAGCTGCTCG-1	CM
AGATTCGTCCGATGCG-1	CM
GAAATGATCTGATCTT-1	Fib
GTCACTCGTGATAACA-1	CM
GTTGGTATCATTCGGA-1	CM
ACCTGCTTCACCCTTG-1	CM
GAAGAGCTCGACTATG-1	CM
GACTAGTTCGAAGCCC-1	CM
CGTACAAGTAAACGAT-1	CM
CCCTAACTCGTCTAGA-1	CM
TGCCTGTCATTAGCAC-1	CM
GGATGAGAGTGAGCAC-1	CM
ACGGATTGTCAGAGTG-1	CM
AAACTGCTCGACTCGG-1	CM
TGGCGCACATGCTATG-1	CM
GAGGTCCCACATCATG-1	CM
GGAGGATGTGAATGGC-1	CM
TGTTAGGAGCAGAATT-1	CM
CACAGATCACAGAAGC-1	CM
GAACGTTTCCAACCTC-1	CM
AACGGGACAAGACTAA-1	Pericyte
GCATGATTCCGTCAAA-1	CM
TAAGCCATCCCGCAAG-1	CM
TAGCCCTAGTCGTGAG-1	CM
CCAGAATGTCTGCACG-1	CM
TACGGATAGAGCACTG-1	CM
AAACTCGTCCCAGCAG-1	CM
CTCAGCTCAAGCAACG-1	CM
CAGCTAATCCAGCACG-1	CM
ACTCGGGCAAGACACG-1	CM
CTAGCGGCAAATAGTG-1	CM
ACTAGGTAGCGAGCTA-1	CM
CACAACAGTAGACGCA-1	Myeloid
TAGGTGTTCGCAACTA-1	CM
TAACTTCCATGGCCTG-1	CM
ACAGACTGTATTCTTC-1	CM
ACCCAAATCGCTACCT-1	CM
CCATACCAGGCCTCGT-1	CM
TTTGTGTAGTCGTGAG-1	CM
CCTTAATAGCTAGCAG-1	CM
TTGAGTGTCCCACTAC-1	CM
CTGGCAGAGTGCAACG-1	CM
ACGTGGCCATGCCCTT-1	CM
GATTGACTCAGTGTGT-1	CM
CTCCCAAGTGCAGACA-1	CM
ACCAAACTCGAGGTCC-1	CM
AATGGCTGTTAGGAGC-1	CM
ATCCAGAAGATTAGAC-1	Fib
CATTCATGTGATAAGT-1	CM
TTTACGTGTGTCGTGC-1	CM
CATAACGTCTGTTGCC-1	CM
GTGCTGGTCTCGGCGA-1	CM
GGGACCTCACATTCTT-1	CM
GGAACTTAGGCCTCGT-1	CM
TGGTCAAAGCAACTGG-1	Myeloid
GTTATGGTCCAATCCC-1	CM
TGAGCCGGTCTGTGTA-1	CM
GCATTCCGTACGCCCA-1	CM
AGGCGAAGTACGGTTT-1	CM
TGCTTCGAGGACCGAT-1	CM
TACATTCCACTCGCAG-1	CM
TTCTGTATCCTGTGGG-1	CM
GAGGTCCCAGTTGGAG-1	CM
TGGCAATAGGTAGGAA-1	CM
ATTCGTTTCCATAACG-1	CM
GTTATGGAGTGAGTTA-1	Myeloid
ACCTGCTCAAGCGACA-1	CM
ACGGATTAGGCAGTGT-1	CM
GCATTCCCATCCCAAA-1	CM
TGCCTCAAGATCTCAC-1	CM
GGTGTCGTCGTCAACA-1	CM
TGGACATAGACCCATT-1	CM
TGCCTCACATTTGTTC-1	CM
TAGCGGCAGCTAACAA-1	CM
TGACTCCCAAGTAACA-1	CM
TTACTTGGTTGGACGA-1	Fib
TTCAACTCAGTTGCAT-1	CM
CCTTGGTAGAAGAGTG-1	CM
AGTCAACAGTCATACC-1	CM
CCCTAGTAGCGTTAGG-1	CM
TAGCCCTAGGATTGAT-1	CM
TTCTAACGTCATGAGG-1	CM
AATGTCGTCGGTCAGC-1	CM
ATGTCTTTCGGACGAA-1	CM
AAACTGCCACGATATC-1	CM
CGTTCCAAGTCTCCAA-1	CM
CCTTAATTCTCGACCT-1	CM
TCACAAGTCCATCATT-1	Fib
CCGAAGCGTTTGCCAA-1	CM
TCAAAGCTCGTTGTTT-1	CM
GCTTAAGGTAAACGGC-1	CM
CACATGAAGTAGTGTA-1	CM
TGGCAATAGAATACTG-1	CM
GCGGGTTAGTCACGCC-1	CM
GACCTTCGTACCCATA-1	CM
GGTGAAGAGTGATAAC-1	CM
GCTTAAGGTCACCGCA-1	CM
CAACGGCGTTGTGACT-1	CM
GGGTTATTCTGTCGGG-1	CM
GCGAGAAAGTCTAGAA-1	CM
CTTGCCAAGCAGAAAG-1	CM
GTTGGTAAGTCTGGGA-1	CM
GGGTCTGCACAACGGA-1	CM
TTACCCGGTAAGTCTC-1	CM
ACTTCCGTCTTTATCG-1	CM
TTTACGTGTGCTTGAT-1	CM
TAGTCCCGTGTCGTCG-1	CM
TCTCTGGTCTTACGGA-1	Fib
TCACCACTCAGGTTTG-1	CM
GAGCATTCATTAGCAC-1	CM
TTAGCTTGTAGATTAG-1	CM
CTGTTCGGTGCATCAT-1	CM
CGTTCCAAGGATTAAC-1	CM
GCTTTCGGTATGGGTG-1	CM
AGTCCGGCACTTGCGG-1	CM
CTCAACCCACAGGAAC-1	CM
TGGTCCTTCCCAATGA-1	CM
CTCTCGAGTAATGCAA-1	CM
GGAGGATAGACTCTTG-1	CM
TTAGCGATCTATCTAC-1	CM
AACTGTGGTAAGTGCG-1	CM
TTGCGGGTCAGTGTGT-1	CM
TACAGCATCGGGATCC-1	CM
TTGCGGGCAATTCAGC-1	CM
CCTGCTATCGATAGCT-1	CM
ACGTTAGGTGCGTCCA-1	CM
GAGACTTTCAAGAGAT-1	CM
AACATCGTCGTGGGTC-1	CM
TTGACGAAGTTAGAGT-1	CM
TGCTCACAGCTCCATA-1	CM
CTGTTCGTCTCAGATG-1	CM
CTCTCGATCGGTGATT-1	CM
CGTTCCACACAACGGA-1	CM
TCGCCTATCTTATCAC-1	CM
GAACGTTGTGGTGGTA-1	CM
CACCTGTTCTTCAGAG-1	CM
TGTGTCCCAAGCGTCC-1	CM
ATAGTCGAGGTTTCTG-1	CM
GCAAAGGAGCCGCTGT-1	CM
GCTCCTACAACACGGA-1	CM
CCGCATTGTGATTCCA-1	CM
AACTGGTCAGCGTACC-1	CM
GCATTGAGTGATTCCA-1	CM
TTTGAGGGTCGAGGTA-1	CM
TGGGTGCTCGGTCCGA-1	CM
GCGCCAAGTTAAGTCC-1	CM
GTGTCCTTCTATCTTG-1	CM
TAAGCCATCTCTTCCT-1	CM
AGGCGAATCGATCTTT-1	CM
GCTGAGCAGCAACGGT-1	CM
CTCGCTAAGACAGTGC-1	CM
ACTAGGTGTCAATACC-1	CM
CGTTCCAAGCTAGTTC-1	CM
TTGCGGGAGTGTCCCG-1	CM
AAGGTTCCATCCCTTG-1	CM
GCTCCTACAAAGCATA-1	CM
TAACGGTCAGGCACAA-1	CM
TACGCAATCGATGTAC-1	CM
TCACCTGGTCAAGACG-1	CM
TTATGTCTCCCTACGT-1	CM
CGGACTGTCCTGGAAT-1	CM
CATGTTTAGGTCCTCG-1	CM
GTGTCAATCCGCTATC-1	CM
GGAGAACTCCTGAAAC-1	CM
TCTCAGCGTGCGACCT-1	CM
ACTGCGGGTAGAATAC-1	CM
GCGATCGGTAGATTAG-1	CM
GTGACATCAGCTATAC-1	CM
TACGGATCAAGTCTCA-1	CM
GACCGACCATTAACGC-1	CM
AGCTGTAGTATGAAGT-1	CM
GTGGATTAGTCGGGAT-1	CM
TTACGGATCACAGGGA-1	CM
GCGGGTTAGCCATTCA-1	CM
ATCCTCGCAGTTACAC-1	CM
TAGGTGTCAGCCGAAA-1	CM
CCTATTAGTAACTCCA-1	CM
CCCTCTCCAAGTAACA-1	CM
ACAAAGACATTCTCGC-1	CM
TAGCCGGAGCGCACAA-1	CM
TCAAAGCCAAGACTTC-1	CM
AGTGCGCGTTCTGAGT-1	CM
AGTCCGGTCGATATGC-1	CM
TGCCTGTGTTAGCTCA-1	CM
GAACGTTAGCCTGTAT-1	CM
AGCCTGGAGGCCAATG-1	Fib
TAATTCCAGTATGCTC-1	CM
AGTCAACGTCTGGGAA-1	Fib
GAGCGCTAGAACTCCT-1	CM
TAGCCCTCAAACCCTA-1	CM
TTGCAGACATTACTTC-1	CM
CCAGATACAAGCTTTG-1	CM
ACTAACGTCAGGAAGC-1	CM
CTCTAGCGTGAATCGG-1	CM
TGTGTCCTCTTCATAC-1	CM
CAAGGCCTCGTTACAG-1	CM
GAAATGATCCATGACA-1	CM
GTCACCTGTAGCAGGT-1	CM
AACCTTTAGATCCGAG-1	CM
TGATTTCGTCTTAGCA-1	CM
TTTGTGTGTTCAGAAA-1	CM
AGCCCGAGTTAGCTCA-1	CM
AGCCGCAGTGGGTAGT-1	CM
TCCAGAACAGTTACAC-1	CM
TTGACGAGTCAGCTTA-1	CM
TAGCACACACTCCCAT-1	CM
TGCTCACAGTAATCAG-1	Lymphoid
CCACAGGAGAAACGCC-1	CM
CGCTGGACAAGTCTCA-1	CM
TATCGAGGTGAGTTGG-1	CM
GCCTACTCAGGCACAA-1	CM
TAGGAGGTCGAACCGC-1	CM
GAGCATTGTTACCCAA-1	CM
CTGGGACCAAGCACTT-1	CM
TCCCACATCCGCGATG-1	CM
TAGCCCTTCCCAGCAG-1	CM
TTCATTGTCCGGGCAT-1	CM
TTTGAGGCATTTGGTG-1	CM
CTCAGCTCACAGTTCA-1	CM
CTCGCTACAAAGGAAG-1	CM
GTTGGGCGTATCACAC-1	CM
TTCTAACTCATGCTTT-1	CM
CGGTGCAAGTGCTCGC-1	CM
AAACTCGCAAAGGTCG-1	Fib
ACTTTCAAGATGTTCC-1	CM
GTAGTACGTTTGACCA-1	CM
GGTGAAGCAAGGAAGA-1	CM
AAGGTTCGTCATAAGA-1	CM
GAAGTCTCAAGTCCTA-1	CM
GCCCAGAGTGAGTAAT-1	CM
AACCTTTGTAGATTAG-1	CM
TCAGCTCCAGATTAAG-1	CM
AAACTGCGTAACACTC-1	CM
GTTCAAGAGAGTAAGG-1	CM
GCATTCCTCACGTCAA-1	CM
GGCGTTGGTTGGCTAT-1	Fib
CACCACTTCAATCGTG-1	CM
TTCGGTCTCAGTGTGT-1	Myeloid
CCGTGAGGTGAGTTGG-1	CM
GTGGCGTAGCATTGGG-1	CM
TGCTTTAAGGTTCGAG-1	CM
ATGTCGAGTAGCGTTT-1	CM
TTACTTGAGAGGTGGG-1	CM
CACCACTGTAGTAACA-1	CM
TGCCTGTCAGGATGTG-1	CM
CCACGTTAGTACGACG-1	CM
AACCGATAGACGAAAG-1	CM
TGGCGCAGTTGGGAAC-1	CM
CAAGGCCGTTGGAGGT-1	CM
ATATTCCCACTAAACC-1	Fib
GCTCGAGCACGATTAC-1	CM
GGGTGTCTCTAGCAAC-1	CM
ACCCAAACACCGAAAG-1	CM
CAGTATGTCGCACCGA-1	Fib
TTAACGGTCTGGCACG-1	Fib
ACATGGTCAGTAGGCA-1	CM
GTTACTTGTCAAATCC-1	CM
TGCCTCAAGTAGTGTA-1	Myeloid
AAAGATGGTTTCCTAT-1	CM
GAACCGCCAGACTAAA-1	CM
TGCCTCAAGAGCGAAA-1	CM
CATTCCGTCTAGCTGA-1	CM
GAGCGCTCAGTGCGTC-1	CM
ACATGGTCACAAGTGG-1	CM
GAACGTTGTCCTATTT-1	Myeloid
GCGAGTCCATGTGGGA-1	CM
GTGCACGAGATCGATA-1	CM
TAGCGGCTCGTTTGAG-1	CM
TGGCGCATCATCGCAA-1	CM
CAGTATGCATGTATCG-1	CM
CTAGGATAGAAGGGCG-1	CM
GAGAACGAGTTGCCGC-1	CM
CGTGGCACAATGACTC-1	CM
CTAGGATCACGTTACA-1	Fib
AACTTGGTCCGTACGG-1	CM
GCTGCGACACGACGAA-1	CM
TTCGTTACAGTAAGAT-1	CM
AATGGCTGTTGTATCG-1	Fib
TATGTGGCAGACTAAA-1	CM
CGTGGCATCGCAAGCC-1	CM
GGCACGTCAGGCAAGT-1	CM
TCAGGTAAGACCATAA-1	CM
ACCGAATTCTTGGCCT-1	CM
GGACACCCACCTCGTT-1	CM
ACAATCGAGAAATGGG-1	CM
AGGCCCACATTCCCGT-1	CM
ACGTTAGGTCTCTAAG-1	CM
TTCGGTCTCACTGATG-1	Pericyte
TCAAGACAGTCCTTCC-1	CM
CCCTGATCAGTTCGGC-1	CM
ACCGAATAGAGCGAAA-1	CM
GCTCCTACACGCGTTG-1	CM
ATCCTCGGTCTCTGCT-1	CM
CCTGGGATCTCTCAAT-1	CM
TCCCACAGTAAACCCT-1	CM
CGCTAGGTCCACGCTT-1	CM
GCCAGCACACGTGAAG-1	Fib
GGAACCCCACTACACA-1	CM
AATACGCGTAAACCCT-1	Fib
ATCCCTGAGTAGACCG-1	CM
GACCGACGTCTGAGCC-1	CM
GCGGAAAAGACCCATT-1	CM
CTCACCACAACTCAAC-1	CM
AAACTGCCACTCCCAT-1	CM
GTTGGTACACAGAAGC-1	CM
AACGGGACACACATTG-1	CM
GACCTTCCACTGTTAG-1	CM
TAGCCCTAGAGTGGAA-1	CM
GCCCAGATCACTTACT-1	Fib
AAAGGGCCAAACCGAG-1	CM
TACGGATGTAAACGAT-1	CM
TCACCACTCTATCCTA-1	CM
GTGCCAGTCCATCTAT-1	Endo
CAGTGTAGTACCTATG-1	CM
GAAAGTACATTACCTT-1	CM
TAATCGGTCCCAGCAG-1	CM
TCTCTGGAGAGAGTTT-1	CM
AACAAAGAGGAAGGTA-1	CM
CGCGCAATCGGTAGGA-1	CM
TGCTTCGTCGGTTCCT-1	CM
CGGTGCAGTAGGTCTT-1	CM
TTTGTGTAGGCGTAGT-1	CM
AAAGGGCTCGATCGCG-1	CM
GCAGCTGCACGAACGA-1	CM
TCACAAGCAGGAGCAT-1	CM
AGTCCGGAGAGAGTTT-1	CM
AGCCGCAAGTCGTATC-1	CM
AGCCTTCAGTGAGTGC-1	CM
CTTTGCGGTCCCGTGA-1	CM
CTCAGAACAGGACCTC-1	CM
GCTTTCGTCCTGTGGG-1	CM
AACAAAGTCTTTGCAT-1	CM
GTAGACTAGTACCCAT-1	CM
CCTGGGACATCCGTGG-1	CM
GTCACCTGTACGGTTT-1	CM
TTCATCATCGCTCGGA-1	CM
GTAGACTGTCAGTGTT-1	Fib
ACCGGGTAGAATGCTA-1	CM
ACAGACTCATTACACG-1	Fib
ACCGGGTGTCAACTGT-1	CM
TAATCGGGTCAGCTTA-1	CM
TCAGGGCGTATGAAGT-1	Myeloid
ACTAGGTCATGACTGT-1	vSMCs
ACGTGGCCACTCCTCA-1	CM
AAGGAGCTCTGGCCAG-1	CM
TGACTCCGTACCAAGG-1	CM
TAAGCCACACGAACGA-1	CM
GCGTAGCCACTCGTGG-1	CM
AGCGATTAGTAGCAAT-1	CM
TCCAGAAGTTCGGGAA-1	CM
CTGTTCGGTGCTGGCT-1	CM
TAATCGGGTCAGAAAT-1	CM
TCAGGTAGTCAGAAGC-1	Fib
AGCTGTACACTGATAC-1	CM
TTAGCGATCGGTGATT-1	CM
TTCTAACTCAGAGTGG-1	CM
TCTCTGGCACAACGGA-1	CM
CCGCATTTCCTCAAGA-1	CM
CAACCAATCTTAACGG-1	CM
GACCTTCTCTCATATC-1	CM
GTAGGAGAGTTCGTTG-1	CM
ATGTACGTCCTGTAGA-1	CM
GGAGTAGGTTACTTTC-1	CM
CCCTCTCGTAGCAGCA-1	CM
CTTCCAGGTTGGTAAA-1	CM
CACCACTTCGTGGCGT-1	CM
CCCTCTCGTCCACCAG-1	CM
CTAGGGCGTGTTGTTG-1	CM
GGGCCATCACATATCG-1	CM
GATCATGGTTTCAGCA-1	CM
AGACAAAGTCCTTATT-1	CM
AATACGCCAAGGTTCT-1	CM
GGAACCCGTCTCAAAC-1	CM
TACATTCGTGACGCAA-1	CM
AACAAAGAGGAGGCGA-1	CM
GTTACGAAGTCGTACT-1	Fib
CCTTGCACAAACTACC-1	CM
GTCACAATCTATCTTG-1	CM
TACCCTGAGCATGATA-1	CM
GACCGACCACGTTACA-1	CM
CCTTAATAGCTTCAAC-1	CM
AAACTGCTCGTGCTGG-1	CM
ATGGATCGTCAGGTGA-1	Fib
TGTACGACACTCCACT-1	CM
CCTCCCTCACTCGTGG-1	CM
CGCTGGATCCTTACGC-1	CM
TCTAGTTTCAGTTGAC-1	CM
CAGCCTTTCTGTTTAC-1	CM
TACCTCGTCAAGTTGC-1	CM
TTGGTCCAGAGTAAGG-1	CM
TTGCTTAAGATACCAA-1	CM
AGACAAAAGTAACATG-1	CM
AGCCAGCAGTCTGTGT-1	CM
TCAATTCGTGTTAGAA-1	CM
GGCGTTGAGCGCATTT-1	CM
AGCCAGCTCCGATGCG-1	CM
ACCCAAACAACGCACC-1	CM
CATTGGAAGGGTGTTG-1	CM
TACATGGCAGGCACAA-1	Fib
TCAGCTCGTATGGATA-1	Fib
CTCAGCTAGTGAAACT-1	CM
TGTACGATCACAACAC-1	CM
CTGGCAGTCCTGTGGG-1	CM
GCATGATTCCTCAAGA-1	CM
TGGCGCACAAGGAGGG-1	CM
GCCTACTTCCCGAAGC-1	CM
CTCAGAACACACATTG-1	CM
AAACGAAGTCAGAAGC-1	CM
TAGCTTTTCGCACAAT-1	CM
TTTGTGTAGTTCAGGG-1	Fib
CCTGCTATCTTCAGAG-1	CM
AAGATAGGTAATGCAA-1	CM
ATATTCCCACACACAT-1	CM
GGAACCCCAATCACTG-1	CM
GCCTACTCACCTGAAT-1	CM
GGCGAAAGTATGCTAC-1	CM
TACGGATTCAATTGGC-1	CM
TAATTCCTCCGTCAAA-1	CM
CCCAGAGCAAGATTAG-1	CM
CCACAGGAGTAGCAAT-1	CM
GTAATCGTCCTGTGGG-1	CM
AACATCGAGTGTCCCG-1	CM
GTGGATTAGGTTAGTA-1	CM
ACCGAATTCCGTCAAA-1	CM
AACCAACGTTACCCAA-1	CM
ACCGGGTAGATCGATA-1	CM
GTCGTAACAGTAGGCA-1	CM
CAGTATGCAAGCGACA-1	CM
GCTTTCGAGGAAGACA-1	CM
AAGGAGCCAGGGTACA-1	CM
ACCGAATCATCGACCG-1	CM
GAGCATTAGGCAGTAC-1	CM
ACCTGCTCACTGCTTC-1	Myeloid
TATTGCTAGGTTCTCA-1	Fib
GATTAGCGTTCCATCC-1	Fib
CCCTAACAGTACCCAT-1	CM
AAGATAGTCCGAGAGA-1	Fib
GATGATCTCTTGTCGC-1	CM
AGATTCGAGCATTCCA-1	Endo
ACTATTCTCGACTCGG-1	CM
ATCCAGAGTGGGTAGT-1	CM
CTAGGGCAGAGAACCC-1	CM
ACCGAATCAATCCATG-1	CM
GTCACAACATCGGCTG-1	CM
CGTAAACAGTATACGA-1	CM
AAGATAGAGTCTAGAA-1	Myeloid
AGGACGATCTCTGTTA-1	CM
TCGGGACCAGGCACAA-1	Fib
TTCGTTACATCCTGGG-1	CM
AATGCCAGTATCTCAG-1	Fib
TCCAGAAGTACTTCAG-1	CM
TCACAAGAGTGGTGTG-1	CM
TTACCCGTCGTTCTAT-1	Fib
TATGTGGAGTGATCTC-1	Myeloid
GTGACATAGCGTGTTT-1	CM
TGCCTGTAGTAACACA-1	CM
ACAGAAAGTAGTTTGC-1	CM
TGCATTTTCTGGCCAG-1	CM
AGATTCGCAACGGACA-1	CM
GAGATTCGTAAAGCTA-1	CM
CAGTGTAAGCTACGCC-1	CM
GCCTACTTCTCCTTGG-1	Myeloid
GCATGATGTTCCCTTG-1	CM
GTCTACCCATCTGCAA-1	CM
GACCTTCAGGACTTTC-1	CM
ACATGCACAGTGGTCC-1	CM
CCTCCCTTCCTCCCAA-1	CM
TGCTTCGGTGAGTTGG-1	Myeloid
GGTGAAGAGTTAGCAA-1	CM
TCACCTGCAGTAACCT-1	CM
CTAGGATGTTAAGTCC-1	CM
TACCTATGTGCCGGTT-1	Fib
CAGGATTCATCCATAG-1	CM
CTAACTTCATAGCAGG-1	CM
TGGTCCTGTCCCGTGA-1	CM
GTAGACTAGGTTCGTT-1	CM
AGGACGAAGTAATCAG-1	CM
GGCGTTGAGTTGACAA-1	CM
ATTACCTTCCGGCTGA-1	CM
TAGCCCTCATTACACG-1	CM
ACCTGCTAGTTACCAC-1	Endo
TGCTTTATCAGTCTTT-1	CM
AGCGATTGTCGGCTGT-1	CM
TTCATTGTCTGACATG-1	CM
GGTGAAGAGAAATACC-1	CM
TGATGCATCCAAACCA-1	Fib
AGCCTTCCACAGCTTA-1	CM
GGGTGTCTCGATGCAT-1	CM
GTAGGAGCATGATTGC-1	CM
GCTTGCTTCAGTGTGT-1	CM
GACCGACAGGGAGATA-1	CM
GAAGTCTCATAGGCGA-1	CM
CCACGTTCATCCGTAA-1	CM
GTTACGAAGACCCTAT-1	CM
GCTTAAGTCCAAACCA-1	CM
TCGAGCGGTAGATGAT-1	CM
GCTGTTCTCCTCCATG-1	CM
TATCTGTGTTTCGTTT-1	CM
TGCTCACAGATCACCT-1	CM
TGAATCGAGGCAAGGG-1	CM
ACTGCAATCTGAACGT-1	CM
TCCGACTCAAGATGCG-1	Fib
CACATGAAGTGTCGCC-1	CM
AACATCGGTAGAACGC-1	CM
ATTACCTGTTTCCTAT-1	Fib
AGCTATGAGTAGACCG-1	CM
GTCTACCTCTGTAGAC-1	Fib
GCGCATGAGGCTCAGA-1	CM
GTCCATCGTAAGGTCG-1	CM
CTCCCAAGTGCTGTCG-1	CM
GCCAGACGTTAGCTCA-1	Fib
TCGAGCGCAATGGTAA-1	CM
AACTGGTCAGTAGGCA-1	CM
TACGGATGTCCCGTGA-1	CM
CCACGTTCATCATAGC-1	CM
ACTAACGGTGAGAGTC-1	CM
GTTGGGCGTATCGCGC-1	CM
CTCGCTATCTACATCT-1	CM
ACTACGATCATCGCCT-1	CM
CACCTGTCATTAGCAC-1	CM
TTATGTCAGAGAGTAG-1	CM
CCTTGCAAGAGAATTC-1	CM
GATTAGCGTGTCTCGG-1	CM
TCCATCGGTGTCCAGC-1	Myeloid
AGCCTTCTCCAGTTAG-1	CM
TCAAGCACACAGTTAC-1	CM
GGATAGGCAGTAACGG-1	CM
ATGTTTCGTTGTATCG-1	CM
TATGTGGTCGTGCTTC-1	CM
CAAGGCCGTCACTCTC-1	CM
AAATGAGCAGCGCGTT-1	CM
TCCATCGGTTTCGATG-1	CM
GCCCAGACATGCGACC-1	CM
GTAGTACTCTTAAGCG-1	CM
GTCACTCAGCGCGTTC-1	CM
TGATTTCAGTATCTGC-1	Fib
AACTTGGTCGATGTAC-1	CM
TACTAGGGTCTAAGAA-1	CM
TAGCATGCATGGGACA-1	CM
ACAAAGAGTAGATTAG-1	Fib
TGAGTCATCACTCGGG-1	CM
ATCGAGTGTTTAAGCC-1	Fib
AGCTATGTCGTTCAGA-1	CM
CCAGAATGTCAGGCTC-1	CM
ACCCAAAGTAACACTC-1	Endo
CTCTACGGTCAAGACG-1	CM
ACTACCCGTCCGTGCA-1	CM
TCCGACTAGGTCACTT-1	CM
GCGTAGCCACGACGAA-1	CM
CCGCATTTCTGTGTCC-1	CM
TCTATTGCATCTGCAA-1	CM
TATTGCTTCATCGCAA-1	CM
AAACTGCCACACTAGT-1	CM
GAACCTACAGAATGCG-1	CM
TTGCGAATCTCTGTTA-1	CM
TATCGAGAGTCCGATT-1	CM
TATCTGTCATAGTCCA-1	CM
TGAATCGGTCCTTCAC-1	CM
TGCCTGTAGTTCAACC-1	CM
CCACGTTTCGATGTGT-1	CM
GGAGAACAGAACCATA-1	CM
GACTAGTGTGAATACA-1	CM
ACTTCCGCATCGTACA-1	CM
TTACGTTGTAAACGAT-1	CM
ACCGAATTCAGGAATA-1	CM
GACCGACAGGCACCTC-1	CM
TCTATTGGTTTGATCG-1	Fib
AGGCCTGTCGTAGCGC-1	CM
AACTGTGGTAACTGAA-1	CM
CAGGATTGTCGCGCTA-1	Fib
TAAGTGCCAGCGCGTT-1	CM
TAAGTGCCATTTAGGC-1	CM
TGCATTTTCTTGTCGC-1	Fib
GCCCGAACAGAACAGC-1	Fib
TAAACCGCAGGTAACG-1	CM
CGCAATATCGGTCCGA-1	CM
ATAGGCTCAGGTAGCA-1	CM
CCTTGGTCAAGATGCG-1	CM
AAATGCCCAAAGCTTC-1	CM
CAGGATTGTGTTGGTT-1	CM
CTGGGACAGCTCGTTA-1	CM
GCTTGCTGTCTCTGGG-1	CM
GCGATCGTCAGGTTTG-1	CM
GGTGTCGGTTCTCGAA-1	Myeloid
TACTAGGTCGTGAGTT-1	CM
CCTGCTACATCCGTGG-1	Endo
TTACGGAAGTACGACG-1	CM
GCACGCAGTGATAACA-1	CM
TAGCGGCCACTAAACC-1	CM
GCGAGAACAAGTAATG-1	Myeloid
AGGCCTGCAATGTAAG-1	CM
AGACAAACAAGTGGCA-1	Myeloid
CGGACCATCAATGCAC-1	CM
TCACAAGTCGAGGCTC-1	CM
AAATGCCGTATGCTAC-1	CM
ACCAAACGTGTCGTCG-1	CM
GGAACCCTCAGTAGTC-1	CM
AACGTACAGTAACTCC-1	Fib
TTGCCCACAAAGGTCG-1	CM
GAAGTCTGTATCAGCT-1	CM
TGCTTCGGTACAAATG-1	CM
TCTCAGCCAAGGAAGA-1	Fib
CCGTAGGTCGGTACTA-1	CM
AATGGCTTCGTGTGCG-1	CM
CCAGATAGTTAGTAGA-1	CM
CAATCCCAGTTCTCCC-1	CM
GCCTACTCATGATCGT-1	CM
TACTCGCCAAATGTCC-1	CM
TTGCAGAGTTTCGATG-1	Fib
TAGCGGCCACCTGGTG-1	Fib
ACAGGCCCAGGGCTTC-1	Myeloid
GCTTTCGTCGCAAACT-1	CM
GGCACGTTCCTCTCTT-1	CM
ACTAGGTAGTCACACT-1	Fib
GAGAACGAGTATACGA-1	CM
ATCGAGTAGTCCGTGC-1	Myeloid
GATTGACTCAACTTGG-1	CM
AACTTGGGTCGAGGTA-1	Fib
TTACGTTGTCTAAGAA-1	Fib
GTCACTCGTCAAACAA-1	CM
GAGCGCTCATTAAGGA-1	CM
GTCCATCGTAATGCCT-1	CM
TGGAAGGCACTGTCAA-1	CM
GGCGTTGCATGACTGT-1	CM
TGATCAGAGGTACACG-1	CM
TGGTCCTAGTACTCTG-1	CM
GAGATTCCATGCCTTC-1	CM
TAAACCGTCTGATCTT-1	CM
CTCTCGATCCAAGAGG-1	CM
ACTTCCGTCGCCCTTA-1	Fib
CTCGCTAAGGCACTAG-1	CM
CGCTATCCAAACGACG-1	Fib
TGTACGAAGTAGTTCC-1	Endo
CAACGGCCAAATTCCG-1	CM
ATCCCTGGTGCATTCA-1	CM
TAACAGCGTCAGCAAG-1	CM
AGACAAACAAGCAATA-1	Myeloid
TACGCAATCACTACCC-1	CM
ACAGAAAAGCAGTAGC-1	CM
TTCGATTCAGATTAAG-1	Fib
GACTAACGTGCTTACA-1	CM
CTGCTCAGTCATCGTA-1	CM
CTACTTAAGTTCCAGT-1	CM
CTTAATCGTGCCCGAT-1	Myeloid
TGCTTCGTCGTGGTAT-1	Fib
TAGTCCCTCCGCCTAT-1	CM
CTGCGTTCAAGCCAGA-1	CM
GTGTGATTCCATCATT-1	CM
ATCCTGCCAAGGTTCT-1	CM
CTTAATCGTATTCGCA-1	CM
TACATGGAGCTACGCC-1	CM
ATAGTCGCATTGCACA-1	CM
CTGGGACCAGAACAGC-1	CM
GACCCAGGTATCCTTT-1	CM
TACGCCTCAAGCAATA-1	CM
GGTGTCGGTTTGTACG-1	CM
GAACCTAGTACGGAGT-1	CM
TTGAGCAAGCCTATAC-1	Fib
GCCTAGGAGTGTCCCG-1	CM
TCACCACCATCATGTG-1	CM
CGCTAGGAGTCTTAGC-1	CM
TAGCCGGGTGCCCGAT-1	CM
GTCACCTGTGAGTTGG-1	CM
TGTACGATCCAATAGC-1	CM
GAACTTGTCGCCCTTA-1	CM
GGAACCCAGTCGTGAG-1	CM
TCAGGGCCACACATTG-1	CM
TGAATCGTCCTATCAT-1	CM
AGGCGAACACCCATCT-1	Fib
TCAGTCCCATTGCGAT-1	CM
CAGTGCGTCGCAGATT-1	CM
CTCAGAAAGTGCCCTG-1	CM
GAGGTCCCAAGGGAGG-1	Myeloid
GAAATGATCGGGAAAC-1	CM
GCAGCTGCAATAGCGG-1	CM
TTGAGTGTCTCCCTTT-1	CM
CCTTGGTAGCGATACG-1	CM
CCAGATAAGTAGTTCC-1	CM
TCCCACATCTGGACAT-1	CM
GTTATGGGTCCGCTTT-1	CM
GAACTTGTCGCCTTAC-1	CM
GCATGATGTCAGGCTC-1	CM
ACTATTCAGAGCTGTG-1	Fib
CTGTATTAGAACAGGA-1	Fib
ACTGTCCCATGATTGC-1	CM
AGTCAACAGTGCTGAG-1	CM
AAAGGGCCAGAGTCGA-1	CM
CTGCGTTAGAGGCCTA-1	CM
TCTAGTTCAGCAACAG-1	CM
GTAATCGAGGCGTCCT-1	Fib
TCCAGAAGTAACCCAT-1	CM
AAATGAGAGGCATGCA-1	Fib
TAACGGTTCAGCCGGT-1	Myeloid
GTTACGAGTCTCTGCT-1	CM
TGTGACAGTAAAGGCC-1	CM
GACTAGTCACGCCGAT-1	CM
GTCACGGGTTTGAAGA-1	Myeloid
TCGATTTAGTACCCAT-1	Myeloid
TGTAAGCTCGCATACA-1	CM
TCTCAGCTCAGGAATA-1	Fib
GGCGTTGAGAGCCACA-1	Fib
CCCTCTCTCCGTTAGA-1	CM
GCGATCGGTTCCTATT-1	CM
GATTGACAGGAGAACA-1	CM
AGACAAAAGTTAGCGG-1	CM
AGACAAAGTCGTCGCA-1	CM
GCGTTGGAGTTGGAAT-1	CM
GTCACGGGTTCTTATC-1	CM
AATGGCTTCTGTCGGG-1	CM
CCGTACTAGCTGGAGT-1	Myeloid
TAGGTGTCATTCACCC-1	Fib
TGTGGCGCACCTGAAT-1	CM
AAACTGCTCGAGTTAC-1	CM
GGAGAACGTCCAGACC-1	CM
TTGCTTAGTGCATTGT-1	CM
GCAACCGAGTTCAACC-1	CM
CGGACTGAGGGTCTGA-1	Myeloid
CGCTATCGTCTGAGCC-1	CM
GCCCAGAGTTCCAATG-1	Pericyte
CTGAATGAGGCCTAAG-1	CM
TGAGCCGCAAGTAACA-1	CM
AGCCTTCTCTTACTCA-1	CM
CTAGCGGTCCAGGTCG-1	Myeloid
TGGGTGCAGACTAATG-1	CM
GACCGACCAAGACACG-1	Fib
GGGTCTGTCTCGTAGA-1	CM
CGAGTTAGTAGATGAT-1	CM
CTCATGCCACAGGAAC-1	CM
GGAGGATGTTGTATCG-1	CM
TGCCTGTGTAGCAGCA-1	CM
CGCTAGGCACGCCGAT-1	CM
GGAGTAGGTGTTTCTT-1	CM
CAGCCTTGTATGGATA-1	Myeloid
TAGCCCTGTGCATTGT-1	CM
GACTAACTCGTCCCTA-1	CM
TCCAGAAGTAGTTTGC-1	CM
CCGTAGGTCATTCGGA-1	Myeloid
GTCACTCTCGGTACTA-1	Myeloid
TCTCTGGGTTCTTTGT-1	Myeloid
ACAAACCAGGGAGTTC-1	CM
GGGACCTAGTCGAAAT-1	CM
GGTGTCGAGGATTGAT-1	CM
TTACCGCCAGGTAGCA-1	CM
GGTTGCGCAGGTGTGA-1	Myeloid
TCGGGACAGCCATGGA-1	CM
TTGCAGACAAGTTGCT-1	CM
TTGTTCACACCTGAAT-1	Fib
TATGTTCGTTCATTTC-1	Fib
GCTCGAGAGCGCAATG-1	CM
ACGTTAGCAACGTAGG-1	CM
ATCGAGTTCCGTACGG-1	CM
GCGTAGCGTAATGTGA-1	Endo
TACGCAACAATGTAAG-1	CM
TGGCAATTCTGTTGCC-1	Fib
CAGTGCGTCTTCCAGC-1	CM
GCACCTTGTGCCCAGT-1	CM
GAGAACGTCGGGCTCA-1	CM
GAGAACGCACACACAT-1	CM
AGCCTGGTCGGTCTAA-1	CM
GCTGAGCCAAACCTAC-1	CM
ACTAGGTCAGGAGCAT-1	CM
TGCTTTATCTCTGACC-1	CM
CTGGCAGGTATCTGCA-1	CM
TTGCTATGTAGTAACA-1	CM
CGCTATCTCAACACGT-1	CM
TAGCATGGTTCCCGGA-1	CM
CAGTATGTCTCCCTTT-1	CM
AACATCGGTTAGTAGA-1	CM
GTCTACCGTCACCCGA-1	CM
TGCTTTACAGCGTACC-1	CM
TTGTTCATCGGGAAAC-1	CM
ACATGCAGTCAGAGTG-1	CM
GTAGGAGAGGCTTAAA-1	CM
ATATTCCAGTGAGTGC-1	CM
TTGCGAAGTATGGGTG-1	CM
TCCAGAAAGTGTGTAA-1	CM
GAACCGCAGAAGGGCG-1	Myeloid
CCTATTAGTCTGTTGA-1	CM
GATGATCCATGGAGGT-1	CM
ATGTCGACATCATCGA-1	CM
TTCGATTAGTTGTCCA-1	CM
ATTGTGGTCTACCCGT-1	Myeloid
TCACTCGAGAGTGGAA-1	CM
GCTGAGCAGAGTTCGG-1	CM
TGTGTCCCATTCGTCC-1	CM
GCTTAAGGTGTTGGTT-1	CM
CCAGATAAGCATTGGG-1	CM
AAACTCGAGTGCTCGC-1	CM
ATATTCCTCCCTATTA-1	CM
TCGAGCGGTGCACTTA-1	Fib
TATCGAGTCGCTATAG-1	CM
TGGTCCTGTCACCCGA-1	Fib
GATCGTACAGATTAAG-1	Fib
ATATTCCGTGCGTAGA-1	CM
TTTGGTTTCCTTACGC-1	CM
TCAAGACTCTGCGTCT-1	Fib
CTACAGAGTCAACAGG-1	CM
TTTGAGGGTAGTCTGT-1	Myeloid
ACCCAAAGTAGTTTGC-1	CM
GTTACGAAGACAGCTG-1	Myeloid
ATGGATCAGGATTTGA-1	CM
TTACTTGAGCGAGAAA-1	CM
AGCGTGCAGCAACGGT-1	CM
AGGCCTGTCCATTGTT-1	Myeloid
TAGCCCTTCGTTCAGA-1	Fib
AACAAAGAGGATATCA-1	Myeloid
GAGCGCTCAAACTACC-1	CM
GCGGAAAGTTCCGGCA-1	CM
CTGAATGAGACGAAAG-1	CM
CGCAGGTAGGAGTCTG-1	Myeloid
TATGTGGAGCAGAAAG-1	CM
CTCATGCTCAGAACGG-1	CM
CACCTGTAGGAATGGA-1	CM
CTTTGCGCACGCTGTG-1	Fib
TTGCTATGTACGTAGG-1	CM
TAGCGGCCACTCGGAC-1	CM
TTGGTCCCACCGATCG-1	CM
AGTCCGGCATTGAACC-1	CM
GCCAGCAGTTCCTATT-1	Fib
ACATGGTGTAATGCCT-1	Fib
TACCTCGTCCCTACGT-1	CM
GGCACGTGTAGGGTTG-1	CM
CAACCAACATTTCTTG-1	CM
AATGCCATCGCATACA-1	CM
TACATGGTCCAATCCC-1	CM
AGTTACGTCTCCTTAA-1	CM
TACTCGCTCGACCCGA-1	Myeloid
CTACAGAGTGGACGAT-1	CM
GGCATTAGTCGGCTGT-1	CM
GGGCCATGTGAGCTAG-1	Myeloid
GTGTGATTCGTGAACT-1	CM
TAGCATGTCATTGCCC-1	CM
CCCGTTATCCGTTTCG-1	Myeloid
TTGCTATGTGAATGTA-1	Endo
GAATCTGAGGTAAGCC-1	CM
GCGTTGGGTTCCAGTA-1	CM
CCGTACTGTCGCTACG-1	CM
CAGGATTAGGTTTCTG-1	CM
CTGTTCGAGGCGACTA-1	CM
GCAGATTGTAAGCCTT-1	Myeloid
GATTGACTCGTTTGAG-1	CM
AGATAGAAGTGATTAG-1	Myeloid
ACTACGATCGCGCTGA-1	CM
GGCATTAAGTGAGTTA-1	CM
GCACGGTAGTGAAACT-1	Fib
ACGTGGCGTATTCACG-1	CM
CGGACTGTCGGTACTA-1	CM
CTACAGAGTACATGGG-1	CM
TGCTCGTCACATAAAG-1	CM
GTCACCTCAGGTGTGA-1	CM
TTGAGCAAGGCTCCTG-1	CM
TTCGTTAAGCCCATTA-1	CM
TGAGCCGGTAGTGATA-1	CM
CACAACAGTGGAAAGA-1	CM
GCACGCAGTGTTGGTT-1	Endo
TCAGTTTCACTCGGAC-1	Pericyte
CAGCTAACACCTATTT-1	CM
GCATTGAAGTTGTCCA-1	CM
GTGATCAAGAAGCCTG-1	Myeloid
TTGCAGACAACGCAAG-1	CM
CCAGAATGTTTCACCC-1	CM
CCAATGACAAGCAGGT-1	Fib
CCCTGATGTTTCGTTT-1	CM
TTACTCACACCTGGTG-1	Fib
TGACAACCAGTTCGGC-1	CM
CAGGATTTCACGTGTA-1	CM
AGTGCCGTCTTCACTA-1	CM
GTCGTAATCGGGTCCA-1	CM
GACTAACCAAGGAGGG-1	CM
TATCGAGTCGGTCAGC-1	CM
TCAGGTAGTGCATTCA-1	Myeloid
GTTCAAGTCGCGGCAT-1	CM
CTCAGCTAGAACCATA-1	CM
GCACGCAGTGGATTCT-1	CM
TTCAACTCACACACCG-1	CM
CTTGCCACAAGGTCGA-1	CM
TGGCCTTGTCTGCACG-1	Fib
TGGTCAATCGTGAACT-1	Fib
CTTGTCGCAACCTCCT-1	Fib
GTCACAATCGTGCTTC-1	CM
TCTATTGCAGTTACAC-1	Myeloid
CAACGTACATTGATGC-1	Myeloid
CACAGATCAGCCGAAA-1	CM
TAACTTCAGTCGTATC-1	Fib
TGCTTTACATAGGCGA-1	Endo
TTACGTTGTGAGGGTT-1	CM
GAGGATGAGGGCATTG-1	CM
CTCACCATCCTTCGAC-1	Fib
CCGTACTAGCATTCCA-1	CM
TCAAAGCTCGGGATCC-1	CM
GAAACAATCAGGAATA-1	CM
CGTACAATCCCAGTAA-1	CM
AAATGAGCACTGCTCT-1	CM
ACAAGCTAGGTTGTTC-1	Myeloid
TTAACGGGTCATCAAC-1	CM
TGATTTCGTGGACAGT-1	Fib
GTCACTCAGGCAGTAC-1	CM
TACTGCCGTCAACAGG-1	CM
CACGTTCGTCCCGTGA-1	Endo
CCACAGGTCACAACAC-1	CM
CGGACTGTCCATACGA-1	CM
GCTTTCGGTGACAAGC-1	CM
GGTGCTGGTGCAAGAC-1	Fib
ACCTGCTGTTACTTTC-1	CM
TTTGTGTAGTCTGGGA-1	CM
CTTTGCGAGATCACCT-1	Myeloid
CCCTAGTTCGTTACAG-1	Myeloid
ACTTCCGTCAGTGTGT-1	Fib
CCCTCTCGTACGGATG-1	CM
GTCACCTCATCCATAG-1	Pericyte
AAAGGGCAGCAAGGTC-1	Fib
TAGCTTTTCTCGACCT-1	CM
CCAGAATCACAGTTAC-1	Fib
CGAGTTAGTAGAACGC-1	Fib
CCTTAATTCATTCTCA-1	CM
AATACGCCAACGTACT-1	CM
GGTTGCGCATCGCTAA-1	CM
CAAGAAAGTATGTTCG-1	CM
ATGTTTCCAAAGAAGG-1	Myeloid
GCCTACTGTGCAAGAC-1	CM
AATGCCATCTATCTCA-1	CM
GCGCCAAAGGATTAAC-1	Fib
GTGGATTAGAAGGGCG-1	Endo
TTACCCGTCCTCCATG-1	CM
GTAATCGCAATCCATG-1	CM
GTCCATCCACTCGCAG-1	CM
TCGCAGGAGCGTCAAG-1	CM
TTGGTCCCAGCTATAC-1	Myeloid
TAGCACACAGCAAACG-1	CM
CTTTGCGCATCAACTG-1	Myeloid
TCACCTGCACTGGGCT-1	Myeloid
TACTGCCGTAGCAGCA-1	CM
TTAGCGAAGTGTTCCA-1	CM
TTGAGTGGTGACAAGC-1	CM
ACAGCGCCATGGTAAA-1	CM
TAGGAGGGTATTGTGC-1	CM
TTGGTCCCAGATGGCA-1	CM
GGTGTCGAGTATACCC-1	CM
ACGGATTCATGCGCTG-1	Myeloid
AGTGCCGGTGCACTTA-1	CM
AGCCCGAAGGGAAGCG-1	CM
CATTCATGTCATAGCT-1	CM
CCATACCGTACGGTTT-1	CM
TTACCCGCATGCGTTA-1	Endo
GCACGGTTCTCCACTG-1	Endo
TCCCACATCGATATGC-1	CM
CCTTGCAGTTGGTAAA-1	Myeloid
CTTCTAAGTATTGTGC-1	Myeloid
TGATGCACATGTATCG-1	Myeloid
GTAGGAGTCCTTCGAC-1	CM
GCGAGAAAGGTAAGTT-1	Pericyte
TTGCACCCAGTATCTG-1	Fib
GTTACTTAGCGTGTTT-1	CM
GCTCACTCAATGGTCT-1	CM
GCAGCCAGTTTGCATG-1	CM
GCCATAATCCAGGTAT-1	CM
GCTGCGAGTGGAGTGT-1	CM
TTTGTGTTCCAGTACA-1	Myeloid
AGTCCGGCACTCCTCA-1	Fib
CTTGCTGCATGGGTGA-1	Endo
TCACAGAAGGACTAGC-1	CM
CCACGTTCACGTACAT-1	CM
TTCATCATCGGGATCC-1	CM
CGGACTGTCTCGCGGA-1	CM
CGTACAAGTATGGATA-1	CM
AGACAAATCTGACATG-1	Fib
CGCACAGCATGCGACC-1	CM
GAGGATGGTCCTCAGG-1	CM
TTAGCGACAGCAGGTA-1	CM
TCACCACGTGCCAAGA-1	CM
ACCGGGTAGATGTTCC-1	CM
TTGCAGATCCTATCCG-1	Myeloid
AGGCCCAAGTGAAGGA-1	CM
CCTTGCATCGGATAAA-1	CM
ATGGATCGTCAACGGA-1	CM
CTTTGCGCAGTGGTCC-1	CM
ACTACGATCGCTATTT-1	Myeloid
TGCTTTAGTTCATTTC-1	CM
ACTACCCCAGGCATCC-1	Endo
TTACTTGGTCAGGTGA-1	Pericyte
CTGCGTTAGACCTATC-1	Fib
AGTCCGGTCCACACCT-1	CM
TAATCGGTCTACTTTG-1	CM
GTCCATCGTACCCATA-1	Fib
GGCGAAAAGGATTGCG-1	CM
AGGCCCACACGGCCAT-1	Fib
GTGGCGTTCCAATCCC-1	CM
CCATACCCATGGTTTG-1	CM
CTTGTCGCACTGCTCT-1	CM
ACTACGATCGATCGCG-1	CM
GGATGAGAGATTAGAC-1	CM
CAACCAAGTAGCAGCA-1	Myeloid
GGCATTACATCGCTAA-1	CM
AGGCCCAAGTGCTCGC-1	Fib
TAAGTGCTCCTCCATG-1	CM
CTTTGCGAGATCGATA-1	CM
GCTGTTCTCGCTAGTA-1	CM
TCAATTCGTTGGCGAA-1	CM
GTCACAAGTATCTAGC-1	Fib
AGGCCCACAAGATTAG-1	CM
TTCATTGGTGGATTTC-1	CM
ACTGTCCGTAAACGTA-1	CM
CCTGGGAAGATGCGCA-1	CM
TATGTTCCACGTGAAG-1	Myeloid
TTGCACCAGTCCGTGC-1	CM
AATACGCAGTTGGAAT-1	Fib
ATGTACGTCCATAGGT-1	CM
GAGTGAGCAGTATACC-1	Fib
TGTGGCGGTATGGATA-1	CM
GGGCCATCAGTCCTGG-1	CM
AGCCCGACACCGATCG-1	Myeloid
ATCGAGTTCCACGGCA-1	CM
TCCGACTCAACTCGTA-1	CM
AACAAAGGTATACGCT-1	CM
ACATGGTGTATGAAGT-1	CM
AGACAAATCTCGCGGA-1	Endo
GAAACAACACTGCTCT-1	CM
GGTGAAGTCCCAATAG-1	CM
GAAGTCTTCCATAACG-1	CM
ACTACCCGTGACCAGA-1	CM
GCACGGTTCGGGCTCA-1	Fib
ACTATTCCACTGTAAC-1	CM
CCCAGAGCATCAGAAA-1	CM
TTACTCAGTCCAAGAG-1	Myeloid
GGAACTTCAGAATGCG-1	CM
GCCAGACCAAGGAACC-1	Myeloid
GTAGACTTCGACTATG-1	Fib
TATGTGGGTTAACCGT-1	CM
CCGAAGCCACGTTACA-1	Fib
AGCGATTCAAGCCAGA-1	CM
TGCCTCAAGGCCAATG-1	CM
CCCTCTCGTCAACAGG-1	Endo
CAGCTGGCAGATGGCA-1	CM
AGTTACGAGGAGACTC-1	Myeloid
TGATCAGGTCTGTTGA-1	Fib
ACCGCAGCATTCTCGC-1	CM
CGGACCAAGGTTGACG-1	Endo
GTTATGGGTGGCATAG-1	CM
GCTTTCGCACTGAAGG-1	CM
CTTGCTGGTGGCCTTG-1	CM
CAGGATTCAGTCAGAG-1	CM
TGTACGAAGACACGGT-1	CM
GCATTCCAGTCTGCTA-1	CM
TCGAGCGCAAGCAGGT-1	CM
TGCATTTGTGGTAAGC-1	CM
ACTACCCAGTATGCTC-1	Fib
GCTTGCTTCCCAATAG-1	CM
CAACCAAGTAGGGTTG-1	CM
TACTAGGCACAACGGA-1	CM
CAATCCCGTGAATACA-1	CM
ATTACCTAGGCTTAAA-1	CM
ACAATCGAGCGCATTT-1	Endo
AGGCGTCAGATTACGA-1	Fib
GCGGAAATCTTACGGA-1	Myeloid
TTTACGTAGCAGTAGC-1	CM
CTAGCGGAGTTTACGC-1	CM
GAAAGTAAGGGTGTTG-1	Fib
TTCATTGTCGCCAGAC-1	Endo
TGTACAGTCAAAGTAG-1	CM
AAAGGATAGATGCGAC-1	Fib
CAACGTAAGAGGAAGT-1	Fib
TGCACCTTCAGGGTTT-1	CM
GTAGACTGTAAGTGCG-1	CM
TCGAGCGGTGCGACCT-1	CM
GATTGACTCTGGCTAA-1	CM
TCAGTTTTCGAGGCTC-1	CM
CCAATGAAGAGGAACA-1	CM
GTGGCGTCATAGACGG-1	Myeloid
CCTTGGTAGTCTCTAG-1	CM
GACCAATTCGCACCTT-1	CM
GTGTCCTAGGAAGAAC-1	Endo
ATTCGTTAGTGCTCGC-1	CM
TCGAGCGGTCATTGGT-1	CM
GCCTACTCAAAGGAAG-1	CM
CCTAAAGTCGGATCGC-1	CM
ACTATTCGTAATGCAA-1	CM
ACTATTCTCCATTGTT-1	Endo
ACAGACTCAGACTAAA-1	Lymphoid
GCTGCGATCAATGCAC-1	CM
AAACTGCAGACCGCAA-1	CM
GGAGAACCAACTACTG-1	CM
CGCAGGTAGTTATGAG-1	Fib
TTCGCGTAGTACCCAT-1	Fib
GTCACCTTCCCAATGA-1	CM
GCGAGAAGTGCAGACA-1	Myeloid
GTTGGGCCAATGCATC-1	CM
AGGCGAAGTAACATAG-1	CM
GGAACTTCATGGATGG-1	CM
TTCGTTAAGAGGTACC-1	CM
AACTGTGCAAGGAGGG-1	Fib
TCCCACAGTGGAGTGT-1	CM
TCCCACACATTCTCGC-1	CM
GGACACCGTAGATGAT-1	CM
TGACAACCATCCGTGG-1	Myeloid
AGGCGAATCCTTACGC-1	Myeloid
TTGTCTACATACTGCA-1	CM
ACATGCATCGGTCTAA-1	CM
CACTAAGGTGATCAGG-1	Myeloid
GCCTAGGAGTGAGTGC-1	CM
GAAATGAGTACAAATG-1	CM
TTCAACTTCTCGTAGA-1	Fib
ACGTTAGCATTGCACA-1	Fib
GGTTGCGAGTGTCACT-1	Endo
AAATGCCAGAACTCCT-1	CM
TAAGTGCTCACATCCC-1	CM
CGCAATACAATGCCAT-1	CM
TTGCGGGTCGTGGAAG-1	CM
TGCGTAAAGTCGATAA-1	CM
TAACTTCGTCTGGATT-1	Myeloid
AGCCAGCTCGTCTTAT-1	CM
CCAGATACAGCTGATT-1	CM
GCAGCCAGTAGCCATT-1	CM
CGTGGCACATGCCTTC-1	CM
GAAGAGCTCTGTAGAC-1	CM
AAACTCGTCCCAGCGA-1	CM
CATGCCTGTTCAGAAA-1	CM
TATCGAGCACGGTGTC-1	Myeloid
CCTTGGTTCACAACAC-1	CM
GCTTTCGTCGGGCTCA-1	Fib
TTCGCGTCACGCTCAG-1	CM
TTGCGAAAGGCTCAGA-1	CM
TGTAGCAGTGATAAGT-1	CM
AACATCGAGGAGTCTG-1	Pericyte
GCACGCAAGTGCAACG-1	CM
GGTGCTGCAGCTGATT-1	CM
TGGACATTCCGATTGA-1	CM
GTTACGATCACTGGTA-1	Pericyte
CTCGCTAGTAACGGCA-1	Myeloid
ACCCAAATCTCCTTAA-1	CM
GAAGAGCCACGCTAAT-1	Myeloid
GGCACGTCACACACCG-1	CM
GAAATGAAGGAGTCTG-1	Myeloid
AGCCAGCGTGCCGGTT-1	CM
CTTGAAGTCACCACAA-1	Myeloid
TGACAACGTTGTCGGC-1	CM
ACTTCCGTCCCTACCA-1	CM
TCGATTTCATTACACG-1	Endo
GCAACCGCAGATACAA-1	CM
CCACGTTTCCGATTGA-1	CM
TATGTGGGTCTGGTCG-1	CM
TAACTTCTCTCGACAA-1	Myeloid
AGATAGAAGGTTACAA-1	CM
TGATGCACAACGCACC-1	CM
CTAGCGGAGGCGTAGT-1	CM
CTTTGCGGTAGCGTTT-1	Fib
CTGGGACTCCCTACGT-1	CM
GTTGGTATCTCTGACC-1	CM
TAGCCCTAGAGCTACG-1	CM
TTACGGATCAAGAGAT-1	CM
GCAAAGGGTTCCAATG-1	CM
GACCCAGAGTCGTGAG-1	Pericyte
ATTACCTAGAGTCCGA-1	CM
TACCTATTCAACGTGT-1	CM
GTACTTTCAGAACGAC-1	CM
GAGACTTTCGGTTCCT-1	CM
GCGGTGTCAACGCAAG-1	CM
ATCGAGTAGGGTTCTT-1	Myeloid
TTACGTTTCTTAACGG-1	Fib
GTGTGATCACAATAAG-1	CM
CTCCCAAAGGAGGCGA-1	Fib
TAATCGGAGTTCCCGG-1	CM
TGTACGATCTGCGTCT-1	Fib
GCTGCGAGTTAACTCG-1	Myeloid
GTCGTAAAGGTTGTGG-1	CM
CAAGGCCGTGTTAGAA-1	CM
CAACGTAAGAAATACC-1	CM
GAAGTCTGTTGTCGGC-1	CM
ACCAAACAGACCATAA-1	CM
ACAAACCTCGCTATTT-1	Fib
GAAAGTACACGTTAGT-1	Pericyte
GTGCTGGCACAAACAA-1	Endo
ACCTGCTTCCCACGGA-1	CM
CAAGAAAGTATTCTGG-1	Fib
GCACGGTAGCAATGTA-1	CM
AATGGCTTCAGGATCT-1	Endo
TGCCTGTAGTCCCGCA-1	Endo
GCCAGCAGTGCATTCA-1	CM
ACAGAAAGTAACGGAC-1	Endo
ACCAAACCAATGTAAG-1	CM
TCACAGAGTCAAATCC-1	CM
CTTCTAAGTTAAGGGC-1	Myeloid
CAAGCTACATGGCCCA-1	CM
AAACTGCCACTGCTTC-1	CM
GCCAGCACATTGAACC-1	Fib
CGTAAACGTTTGTACG-1	Fib
TTCATTGGTCATAAGA-1	CM
GCTGAGCCATTAACGC-1	Myeloid
TTTGTGTTCTTAACGG-1	CM
AAACGAAGTTTGCATG-1	Myeloid
TAGCATGGTGCAAGAC-1	CM
TAACAGCAGGGTCCCT-1	Myeloid
CCTTGCATCAGGATCT-1	CM
TAGGTCAGTACAAGCG-1	CM
CTTAATCCACTTATGG-1	Myeloid
CCATACCGTAACGGTG-1	CM
TTTACGTGTGCCCAGT-1	Pericyte
GGTGCTGGTGACCAGA-1	CM
AGTCCGGCAGAGAGAA-1	CM
TTAGCTTTCCTTGACC-1	Fib
TTCAACTGTGCGTGTC-1	CM
CCCTGATTCACTTACT-1	Fib
CAACGGCTCCTCATTA-1	CM
CAGTATGAGACTAGCG-1	CM
ATTCGTTAGTCAACTC-1	CM
TGTGGCGGTTCTGATG-1	Myeloid
TGCTCACCACGATATC-1	CM
GATTGACAGAGGTGGG-1	Myeloid
AACAAAGAGGTGAACC-1	Endo
TTCATCAGTTTGCCAA-1	CM
TGCCTGTAGCAGGAGG-1	Endo
ACCGAATTCGGCATAT-1	Fib
GGGTCTGAGGTAGGCT-1	Endo
CGTTCCACATTGATGC-1	CM
CAGTATGAGTATACCC-1	CM
GATTGACAGAGGTACC-1	CM
TTGCGAATCTGTGTCC-1	Myeloid
TTACCGCTCTGGCTAA-1	CM
GGGAACAGTCAGAGTG-1	Myeloid
GTCTACCGTCCAAGTT-1	CM
TAAACCGGTACGGATG-1	CM
TCCATCGAGATGCGCA-1	Fib
CCGAAGCAGTACCTCA-1	Myeloid
CTCCCAACATCGCTAA-1	Fib
GATTAGCAGTTAGCAA-1	CM
GTCACTCAGTGAGTGC-1	CM
TGGCCTTTCCATCATT-1	CM
TGGCCTTTCCACGCTT-1	Endo
TTTACGTAGCGTTAGG-1	Fib
AACTGGTCAATGTAAG-1	CM
GAGCGCTAGGTTGTGG-1	Myeloid
TGCTTTATCGGTTGTA-1	Pericyte
CACAACACATTATGGC-1	CM
TAAACCGAGATATGTG-1	Myeloid
GGGAACAAGGTAAGTT-1	Myeloid
ACTAGGTAGGATTAAC-1	CM
TGCTCGTGTATTGTCG-1	Fib
TGCTCACTCTGTCGGG-1	CM
TTGAGTGTCTAGCAAC-1	Lymphoid
CCATACCAGGAAGAAC-1	CM
TTTGTGTGTAAACGAT-1	Myeloid
GCAGCCAAGAGAACCC-1	CM
AACGAGGGTCGTAATC-1	CM
ACGTTAGTCTGCGTCT-1	CM
CCTTAATTCGCTCGGA-1	CM
ACGTGGCCAATGGCAG-1	Pericyte
TACGGATTCTTACCTA-1	CM
GGAGAACTCGATCTTT-1	CM
GCACCTTCAGTAGTCT-1	Myeloid
CCACAGGTCGGTCGAC-1	Fib
CATAACGTCCATGACA-1	Fib
TCGATTTGTCGCTAGC-1	Endo
CGAGTTAGTCTAAAGA-1	CM
AGCGATTCAGCTGATT-1	CM
GTGTCCTCATACAACC-1	CM
CGCGCAATCCTAAAGC-1	Fib
CATTCCGTCGCTAGTA-1	Myeloid
GCAACCGGTCAACTAC-1	Endo
GTACTTTAGTATACCC-1	CM
AGCCTGGAGTGTCACT-1	CM
GGTGCTGAGTTCGACT-1	CM
GGCATTAGTGATTCCA-1	Fib
TGGAAGGAGCCTGGTC-1	CM
GGAGGATTCGGGTCCA-1	Lymphoid
TGACTCCGTGAATGTA-1	CM
TAGGAGGCATTCCCGT-1	vSMCs
GGGAACACATGGGACA-1	CM
GTGCACGCATAGTCCA-1	Pericyte
TTCGGTCCACATTCTT-1	CM
GAAACAATCCAACAAC-1	Fib
GCCAGCATCAAGTTGC-1	CM
TGCTCGTAGATCGCCC-1	Myeloid
CCACAGGAGGGTCTGA-1	CM
GTGTGATCACTGATAC-1	CM
GAAACAAGTGGAAAGA-1	CM
CGGACTGCAAGTTCGT-1	CM
CCTATTATCTGTGTCC-1	CM
CTTGAAGTCGGTTCCT-1	CM
CTCTCAGTCTGAACGT-1	CM
AGATAGAAGCCATCAT-1	Myeloid
TGCCTCAAGTACAGTA-1	CM
TGTAGCACAGACTAAA-1	Fib
GGAACTTAGGGTCCCT-1	CM
AATGTCGTCTGGACAT-1	Endo
GTTGGGCCAGGCAGAT-1	CM
CCCTAACAGTATCTGC-1	CM
GTACTTTAGTGTCACT-1	CM
GCGAGAAAGTAGACCG-1	Myeloid
TGTACAGTCAGTGGTT-1	CM
TAGGTCATCGCTTACC-1	CM
CCGTGAGGTTACTACG-1	Endo
GTACTTTAGATACCAA-1	Neuronal
ATTGTGGCACCGATCG-1	CM
GATGGCCCAATCAGGG-1	Myeloid
GTAGTACCAGCGTCGT-1	CM
AGCTATGGTTTAAGGA-1	CM
GAACTTGTCCCACGGA-1	CM
TTGCACCAGTTATGAG-1	CM
GGCGAAAAGATTCCGT-1	Myeloid
TTGCAGAGTTCTCGAA-1	Pericyte
TTCTAACTCGACTGGC-1	Pericyte
TTTGGCCAGCCTGGTC-1	CM
ACCTGCTAGAGACTCG-1	CM
CTTGCCAGTCAAACAA-1	CM
TGCTTCGAGGCAGTGT-1	Fib
GCTCAGGAGCTTACCA-1	CM
CACAGATGTTTGCATG-1	Fib
GCGGAAATCCAACAAC-1	Myeloid
TCAGTTTTCTTTCGAT-1	CM
GGAATCTGTGCGTTTA-1	Endo
CCAGATACACGCCGAT-1	Myeloid
CTAACTTGTCCTCAGG-1	CM
GTGCTGGCACCGTTGG-1	Myeloid
CGTGGCAAGTACCTCA-1	Pericyte
ATCCCTGCAGGTAGGT-1	CM
ACAGCGCAGTTACCAC-1	CM
CTAGGGCCACAGCCAC-1	Myeloid
CGTTCCAAGTGAGTTA-1	vSMCs
TTACTCATCGTGCTTC-1	Fib
GCGATCGCACATTCTT-1	Fib
GCTGCGACATTCTCGC-1	CM
GCTGTTCGTACTTCGA-1	CM
CTCAGCTGTTAGGAGC-1	CM
GCAAAGGTCAGGATCT-1	Myeloid
ACCATCCAGCATACCT-1	Myeloid
AACCAACGTGGATTTC-1	CM
GAGAACGTCTCATCCG-1	Myeloid
GCGTAGCTCTATCTAC-1	CM
TACCCTGGTGGATTCT-1	CM
ACCGGGTCATTACTTC-1	Pericyte
TACTAGGTCGGGAATG-1	Myeloid
GAATCTGGTATCTGCA-1	Fib
GTGTCAACAGGGCTTC-1	Fib
TCACCACGTATGGATA-1	Myeloid
GAAACAATCGTCAACA-1	CM
AGCCTTCCAGGTTATC-1	CM
TTCGCGTGTCGTCGCA-1	Neuronal
GCAGCTGTCCTCCAGT-1	Pericyte
GTCTACCTCTTCTCTC-1	Myeloid
TGCATGACAGTTCGGC-1	Fib
TTACGTTAGATCGCCC-1	CM
TAGGTCAGTGCTAGTT-1	Myeloid
CTCAGAATCGGGAATG-1	CM
GTGTGATAGACGCCCT-1	CM
TTACGTTAGTACTCTG-1	Endo
CAAAGCTCAATCATCG-1	CM
ATGGATCTCAGGCGCT-1	CM
TAAGTGCTCCCACGGA-1	Myeloid
GCTTTCGCAGCAACCC-1	Endo
GTCTACCAGGGTAGTC-1	CM
CACAGATCATAGTCCA-1	Endo
GCTTGCTCATTGCCTC-1	Fib
CTAGCGGCATATACGC-1	CM
GAACCGCAGGCCTAAG-1	vSMCs
TTCGTTATCGGTCGAC-1	Fib
GCTCCTAGTCCGTGCA-1	Fib
TATCTGTAGGCGATTG-1	Endo
CACCTTGTCCGCGATG-1	Myeloid
TTCAACTGTTGGCTTA-1	CM
GGCATTAAGTTCGTTG-1	CM
CTTCCAGGTGCCGGTT-1	CM
AACCGATGTGCAAGCA-1	Myeloid
GGATGAGCAGATAAGT-1	Endo
TTAGCGATCATAGGTC-1	CM
CGCAATATCGCGATGC-1	Fib
TGCTTTACATGGTTTG-1	Myeloid
GAACTTGCACCTGAAT-1	CM
ATTACTCGTCAATACC-1	Fib
GTCACTCGTAGACACG-1	Myeloid
TCAGTTTGTTCTTTCA-1	Lymphoid
AAAGGGCGTCATTGCA-1	CM
GTCACAAAGTATAGTG-1	Myeloid
TTGCTTAAGACCTATC-1	CM
CATAACGCAATTGCCA-1	Fib
AAAGATGTCGCACAAT-1	Myeloid
GAAGTCTGTCCCGAGT-1	CM
CGTAAACGTGATTCCA-1	Fib
CGGTGCAAGTTACACC-1	CM
GTAGTACAGTAATCAG-1	Myeloid
ATCCAGAGTGTTGTTG-1	Myeloid
TTTGCGCCATTGATGC-1	Fib
AGACAAAAGTGTCCCG-1	Fib
TACCTCGTCCTGGAAT-1	CM
GAATCTGGTGTACGCC-1	Myeloid
CTCTAGCTCGCGTGAC-1	Myeloid
GACCGACGTTACGCTA-1	Fib
GAAGAGCAGTCGATAA-1	Myeloid
AGTCAACGTAGTAACA-1	Myeloid
GAAACAAAGAACGTCG-1	CM
GGCATTACATCCCTTG-1	CM
TCAATTCAGATCTCAC-1	Endo
TCCAGAATCTATCTTG-1	vSMCs
TCGCCTACAGATAAGT-1	CM
TTGTTCAGTCACCCGA-1	CM
GCATGATAGACTCGGA-1	Endo
CATGTTTGTTAGTAGA-1	CM
GCTGTTCAGCCGCAAA-1	CM
AACCTTTGTGCCAAGA-1	CM
AGCTGGCCAAATGTCC-1	CM
TCCGACTCACGATATC-1	CM
GCTGTTCGTCAGACGA-1	CM
CATTGGATCTCTTCCT-1	CM
CTTCTAAGTTTGTCTT-1	CM
AAAGGATCATTTAGGC-1	Neuronal
AGCCTTCGTAACAATG-1	Pericyte
GTGACATGTAGTACAA-1	CM
TGCTCGTTCCCTATTA-1	Endo
TTACCGCAGTTCAACC-1	Myeloid
CACCTGTGTCCGGTAC-1	Fib
TTACGGACATCACAAC-1	Fib
GGTGTCGGTCTGTTGA-1	Fib
TGGACATCATCTCTCG-1	CM
ACCTGCTAGGGCATTG-1	Myeloid
AACCTGAAGGTTCGAG-1	Myeloid
AGGCGTCGTAGAACGC-1	Myeloid
TTTGCGCTCGCAACTA-1	Myeloid
GAAGAGCTCCCGATTC-1	Fib
GGTGAAGGTTGTGACT-1	Fib
TGGGTGCGTACGGAGT-1	CM
CAATCCCTCTGTGTGA-1	Myeloid
TGCTCACAGACACGGT-1	CM
ATGGATCGTAGACGCA-1	CM
AGGCCTGCAGTATACC-1	CM
CAGTGTATCTGTTGCC-1	Myeloid
CGTACAATCGCTGATA-1	CM
GCAGATTAGGTTCGTT-1	Myeloid
GACTAACCAGTAACGG-1	CM
AGCGATTAGCTGCTCG-1	CM
GATGGCCAGAACGCCA-1	Fib
TATTGCTAGTACCTCA-1	CM
GCTTAAGAGCAAGGTC-1	CM
TCCATCGAGAGTTCGG-1	Pericyte
ACTTTCAGTCATTGCA-1	CM
GTCACCTAGGAAGGTA-1	CM
GTGGATTCATATACGC-1	Fib
TACGGATCAGGGTACA-1	Pericyte
TTAGGTGCACATGATC-1	Endo
TAGCATGGTAGTAACA-1	Pericyte
TGGACATAGAGTGGTC-1	CM
TTACGGATCACGGGTC-1	CM
TAGCCCTAGTCAACTC-1	CM
AGCTGGCAGGAGTACC-1	CM
AACAGTCAGAGAGTAG-1	Endo
AGCTGGCTCGGGAAAC-1	Fib
CTAACTTTCGTGATAC-1	Endo
AACTTGGTCAATGCAC-1	Endo
CAAAGCTGTTTCTTAC-1	Myeloid
GTCACGGGTGTCCAGC-1	CM
AACATCGGTTTCTTAC-1	Myeloid
ACAAAGATCAGGAATA-1	Myeloid
AAAGGGCTCAAGTTGC-1	Pericyte
GTAGGAGGTTTCTACT-1	CM
CCAGAATCATTACACG-1	CM
TACGGATGTGCACATT-1	Endo
TGCATGACAGAACAGC-1	Fib
ACAGACTCAAGCGTCC-1	Pericyte
TCACTCGGTTCATTTC-1	CM
GTTACGAAGCTGCTCG-1	CM
TTCAACTCAGATGGCA-1	CM
CAGCTGGGTTGCCGCA-1	CM
TTGCTTAAGAATACTG-1	CM
GGTCATATCTATATCC-1	Fib
TTACGTTAGATATGTG-1	Endo
CACAGATCACTCCACT-1	Fib
GGGCCATTCGATAGCT-1	Endo
GCTGCGATCGAACACT-1	CM
GCTGAGCCAACTTGGT-1	CM
ATTGTCTTCCGATGCG-1	CM
GATGGCCGTCTGGGCT-1	Myeloid
GCTCACTCATTAGCCA-1	Endo
GGTACCGGTAACCGAG-1	Pericyte
ATGCATGTCAGCCGGT-1	CM
TTGCGAAGTTGAATAG-1	CM
TGCACCTTCAGAGTGG-1	Myeloid
ACATGGTGTGAGGTCA-1	Fib
CAGTGCGCAGTTCGGC-1	CM
TCACAAGAGTCGCCTG-1	Fib
ATTGTCTCACAGGTAG-1	CM
AGCCGCACATAGCCGC-1	Endo
TTCGTTATCGCTTACC-1	CM
TGCATGACATCGGCCA-1	Fib
CGTGGCAAGATGCGCA-1	Endo
AGCCGCAGTCAACGGA-1	CM
GGATGAGAGAGGCCTA-1	Pericyte
GGGCCATAGTACCACT-1	Myeloid
AAACGAATCCCGGGTA-1	Myeloid
CTACTTATCTAAGGTC-1	CM
TACGGATTCGTAGCGC-1	Fib
GCTTTCGAGTTACCAC-1	Endo
TAGCCCTAGGTTCGAG-1	Pericyte
ATCCTGCAGCAGAGCT-1	CM
TCGTTCGCAGATTGTC-1	CM
GTCCATCGTGAGGTCA-1	CM
GAGGCTCCAATGACTC-1	CM
CTAACTTCATGCGCTG-1	Fib
CTGCGTTGTTAACCAC-1	Myeloid
TTGCACCGTATGGTTC-1	CM
CATTCATCAGAGATGC-1	Myeloid
GTCTACCGTGAGCTAG-1	CM
AGGCGAAAGGCGTCCT-1	Fib
GTAATCGGTATGGTTC-1	CM
CTCACCAAGTTGAATG-1	Endo
GAGACTTGTAGGTGAC-1	Fib
GTAGACTCACATGATC-1	CM
TAAACCGTCGTGAACT-1	Myeloid
ACCATCCTCGCGATGC-1	Fib
CCTTGGTGTCAACTAC-1	CM
GATCGTAAGATGGGTC-1	CM
TCGATTTTCTTGGCCT-1	Myeloid
TGGTCAAGTTGGCGAA-1	Endo
CTTGTCGAGGGAGTTC-1	CM
CAGTATGAGCAGGACT-1	Fib
TGTGGCGCAGTTAAAG-1	CM
CTCTACGGTTTCCACC-1	Pericyte
GCCAGCATCTAAGGTC-1	CM
TCCAGAACAGCCGAAA-1	CM
GGATGAGAGGTAAGTT-1	Myeloid
CATTCATAGATTACGA-1	Lymphoid
TTCTGTATCGCACAAT-1	Pericyte
GAGGATGGTTGTATCG-1	CM
CTTGCTGCAGCGTACC-1	CM
CAGGGCTGTTTGCGAT-1	Lymphoid
CACATGACAAGCGACA-1	CM
ACGGATTCATAGGCGA-1	Myeloid
TTAGCGATCCACACCT-1	Myeloid
CCTGCTATCCAACCTC-1	CM
TGGGTTAGTCGTAATC-1	Myeloid
TAAACCGCAAGGGTAC-1	Lymphoid
GTTGGGCAGTTCCAGT-1	Endo
ATTTGTCTCAGTAGTC-1	CM
CAAGAAATCGCAGATT-1	Myeloid
CAGGGCTTCTCTTAAC-1	Endo
TGAATCGTCGGATAGG-1	CM
CATTCCGTCAGAGTGG-1	Fib
CGGACTGTCACTAGCA-1	CM
TTGGTCCAGTGCCCTG-1	Lymphoid
CCTTAATCATACTGCA-1	Fib
TCAAGGTAGGTTGTGG-1	CM
ACAGACTCAGCTTACA-1	Myeloid
TGCACCTAGGTTCTCA-1	Fib
CGGACTGTCGCAACTA-1	Pericyte
CTCGCTAAGTATACGA-1	CM
GCGATTAGTTACTTTC-1	CM
GCTCAGGCAGCAATGG-1	Myeloid
GGTTGCGTCTATATCC-1	Pericyte
CCAATGAAGATCGAGC-1	Myeloid
CCTTAATAGATATGTG-1	Endo
TTTACGTTCATCGCTC-1	Myeloid
GACCCAGGTCCCGTGA-1	Myeloid
TTACGTTGTTTCCTAT-1	Fib
GGAACTTGTAGTAACA-1	Myeloid
TGACAACCAGGACCTC-1	Lymphoid
AAAGGATGTTTAAGGA-1	Myeloid
TCGAGCGCATAGCCGC-1	Fib
CATGCCTCAGGTGTGA-1	Fib
CTTCTAAAGTGTAATG-1	CM
ACATGGTAGGAGACTC-1	Pericyte
TGCTTTATCGGTCAGC-1	Pericyte
GTGGATTAGCGTCAAG-1	Myeloid
GCTCGAGTCTTAACGG-1	Myeloid
CTCATGCGTGTACGCC-1	Pericyte
TGGCGCACAAACGTTC-1	Pericyte
AAAGGGCGTGTGACCC-1	CM
GAAATGAAGTGTCGGA-1	Myeloid
TACGGATAGGGAGTTC-1	CM
GTCACTCAGGAGAACA-1	Pericyte
GAGCATTTCAGCGGTC-1	Fib
ACAGGCCCACAGCCAC-1	Myeloid
CGCAGGTAGTCCCTCT-1	Myeloid
TCACCACAGAATAGTC-1	Fib
TGCTCACGTCAGTGTT-1	Myeloid
GGCGTTGTCGACGGAA-1	CM
TGGGTTAGTATCAGCT-1	Myeloid
GACTAACGTTTAGACC-1	Fib
AACAAAGCACGTACAT-1	Myeloid
GCCTACTTCTATCTCA-1	CM
TTGTTCAAGACTTGAA-1	Pericyte
CTAACTTGTGCAGACA-1	CM
ATTGTCTAGTTCGACT-1	CM
CCGTGAGCAGCGTACC-1	Pericyte
TTCGATTCACTTTGGA-1	Myeloid
GCCCAGACACCTGTGG-1	Fib
CGTTCCATCACTGGTA-1	CM
AGATTCGCAACGTCGC-1	Fib
TTAGGTGGTGTCTCGG-1	CM
CAGTGCGAGCAGTAGC-1	Endo
GTCGTAACAAGAGCGT-1	Lymphoid
GCCAGCACACTGATAC-1	Fib
AGCCGCACAAGGGAGG-1	Lymphoid
GTGCTGGCAGCGTACC-1	CM
TTGCTATAGATGGGTC-1	Fib
TCCGACTAGGCTCAGA-1	CM
GTAATCGAGCGCGTTC-1	Myeloid
GCCTAGGCACCACGAC-1	Myeloid
TAAACCGCAAGCAATA-1	CM
GTGACATTCGTCCCAT-1	Lymphoid
TCCAGAAGTGGCATAG-1	CM
TCACCTGCACCTGTGG-1	Pericyte
TACTCGCCACTACACA-1	Pericyte
ACCCAAACAGCGTCGT-1	Endo
GGTGTCGGTATTCGAC-1	Myeloid
GCGAGAACAAGCCCTG-1	CM
TCGCCTAAGTAACATG-1	Pericyte
TGTGGCGGTCGATTAC-1	CM
CAGTGTACAGAGATGC-1	Fib
ATGTCTTGTCATCGTA-1	Myeloid
GTAGACTTCGCTCGGA-1	Myeloid
AAGGTTCCAGTATACC-1	Fib
GCGGGTTTCGACGGAA-1	CM
TTTGGTTGTAACTCCA-1	Pericyte
CGTACAACAGAGCCAA-1	CM
AGTGCGCCAATGTGTC-1	CM
TGGGTGCGTTCCTGTC-1	CM
TCTATTGCATTACACG-1	CM
ACCAAACCACGTTGTA-1	Myeloid
GTAGTACGTCGATTAC-1	Fib
GAAACAACATCGGCTG-1	Endo
ACATGGTCATTTCTTG-1	Myeloid
CTCTACGCAGAGATGC-1	CM
ATGTTTCCAGGTCTGC-1	CM
AATGGCTTCGACTTAG-1	Myeloid
TATCGAGAGACGCCAA-1	Myeloid
ATTGTGGTCTACATCT-1	Endo
ACCGAATAGAATGCTA-1	Myeloid
ACTAACGCATCCCAAA-1	CM
TGGAAGGCAAGAGATT-1	Pericyte
GGATGAGGTGCTGTCG-1	Neuronal
GCTTGCTGTCCATTGA-1	Endo
TGTTAGGAGGCCTCGT-1	CM
CTCTCGACAGATTAAG-1	Myeloid
ACAAAGAAGGGAAATG-1	CM
TGCTCGTAGAGATTAC-1	Myeloid
GGAATCTTCGCAAGCC-1	Fib
GGCGAAAAGCATACCT-1	CM
TTCGTTAAGTAATGTG-1	CM
TGTGGCGGTGCTGGCT-1	Myeloid
GCGAGAAGTGGTAAGC-1	Myeloid
GCAAAGGTCAGTAGTC-1	CM
GGAGGATAGTCTCGAT-1	Myeloid
CTACAGAAGTCGGGAT-1	Lymphoid
TGGAAGGCACCTATTT-1	Myeloid
TGCATGACACGCGATC-1	Myeloid
GATTAGCAGTACCTCA-1	Myeloid
CCATACCTCGCAGATT-1	CM
TGATCAGTCCCGCAAG-1	CM
AGCGTATCAAATTGAG-1	Endo
GCTCACTGTTACGCTA-1	CM
GAGTGAGTCACGGGTC-1	Myeloid
CAGGATTTCCAACAAC-1	CM
CCCGTTAGTTGTGACT-1	Pericyte
TTTGAGGGTCGCTAGC-1	Fib
CTAACTTGTGGATTTC-1	CM
TTGCAGAGTGGCATAG-1	Endo
CGTGGCAAGGCCAGTA-1	Lymphoid
TTACCGCGTATCACAC-1	Endo
ACAAAGACATTAGCCA-1	Lymphoid
TAAGTGCGTATCACAC-1	Endo
GGTACCGTCAGCACGC-1	Endo
ACGGATTCAGTTCGGC-1	Endo
CTCTCGACAGCAACGA-1	Myeloid
TCAATTCGTTGAATAG-1	Lymphoid
CTCGCTAAGTGAACCG-1	Neuronal
TTCGATTTCCTCATTA-1	Endo
CGCTAGGTCCAGGGAA-1	Myeloid
GCGTAGCAGTCGACCC-1	CM
GCGGGTTTCGCGCCAA-1	Myeloid
CACTAAGTCCACGAGC-1	CM
CGCGCAATCCCAATGA-1	CM
TACTGCCGTGAGAGTC-1	Endo
GGAACCCAGCATGTGG-1	Pericyte
ACCGAATCACGCGTTG-1	Endo
GCTGAGCCACTCCTCA-1	CM
GCGGGTTAGTGAAACT-1	Neuronal
CACCACTGTCTGAGCC-1	Myeloid
ACCAAACCACGCTAAT-1	Endo
TGCTCGTGTATCTCAG-1	Fib
TAACGGTTCGACCCGA-1	Myeloid
CCAATGATCGCGCCAA-1	Lymphoid
GCTGCGATCTATCTCA-1	CM
GCAAAGGGTCAGTGTT-1	CM
GCCAGACCACAGTTCA-1	Pericyte
AAGGTTCGTGATCAGG-1	Lymphoid
AGTGTACTCATCGCAA-1	CM
TCGGGACGTAGCCATT-1	Neuronal
GCTGTTCGTGGAGTGT-1	CM
CAGCTAACATGGCCCA-1	CM
CAGTGTACATTCACGA-1	CM
TTAGGTGGTTGTGAGG-1	Fib
TAGCATGGTAGCCATT-1	Fib
TGCTATTTCGCTACCT-1	Endo
AGTTTGGTCGAGGCTC-1	CM
AACTTGGGTCGCTAGC-1	Fib
TGTACGAGTAAGTCTC-1	Myeloid
ACCTGCTTCCGATTGA-1	Pericyte
TGATGCAGTACCCACG-1	Fib
CCTAAAGAGCTGAAAT-1	Pericyte
GCTTGCTAGGCCAATG-1	Endo
TTTGCGCTCCTCAAGA-1	Fib
CCGAAGCTCTCTTCCT-1	Fib
ACTGTCCCACGTTAGT-1	Myeloid
TAGTCCCGTTTCAGCA-1	CM
CAACCAATCGACCCGA-1	Myeloid
ATCCTCGGTCTGGTTA-1	Myeloid
CTGGCAGCAATGTGTC-1	Fib
CTACAGAAGAACGCCA-1	Endo
CTTGAAGCAGTAGTTC-1	Myeloid
CCACAGGGTAGTCCAT-1	CM
GAACCGCCATTGAACC-1	Endo
ACATGGTGTCTCGGGT-1	Fib
TCAAGACTCCAGGGAA-1	Myeloid
TCGCCTAGTCCATTGA-1	CM
ACGTGGCGTATCTCAG-1	CM
TGGACATAGATACCAA-1	Pericyte
AGTGTACCAGAACAGC-1	CM
ACCTGCTAGAGAACCC-1	CM
CACAACACAAACCTAC-1	CM
CGGACCACACCACAGC-1	CM
TTGGTCCAGTCGCGTC-1	CM
TTCTAACTCACTCGTC-1	CM
GGAGAACTCGCGCTGA-1	Endo
AGCCGCAAGGAGTCTG-1	Pericyte
GCGCATGAGAACCCGA-1	Endo
CAGTGCGGTAACACTC-1	Myeloid
ACGGATTAGGCCAGTA-1	Pericyte
GTCCATCTCGACCCGA-1	Myeloid
TTGTTGTTCCCTACCA-1	CM
TAAACCGTCCGGGCAT-1	CM
TTGTCTACATCGCCTT-1	Myeloid
CGTAAACGTGTCGTGC-1	CM
ACTACCCAGGCGTCCT-1	Myeloid
GGTGTCGAGCGTAGCA-1	vSMCs
AAATGAGCATCGTACA-1	Myeloid
AGGCCTGAGGTAAGTT-1	Endo
TTCATTGGTCAGTGTT-1	CM
AGCGTATAGGTGAACC-1	Myeloid
TCGAGCGGTTTCGATG-1	Myeloid
TTTGAGGGTCAGTGTT-1	Myeloid
CCCTAACTCCCGTAGG-1	CM
AATGTCGGTAACATAG-1	Lymphoid
TAGCCGGTCGTTGTTT-1	Pericyte
TGCGTAAAGCTGGAGT-1	Myeloid
TGGCCTTAGGCTCCTG-1	Endo
GTTACGAAGAGGTGGG-1	CM
CCGTGAGGTGCTTACA-1	Myeloid
TGGTCAATCTTCCAGC-1	Fib
CCTAAAGTCGACGGAA-1	CM
TTGCGGGAGAACCCGA-1	Endo
GATCATGCAAGCCTTA-1	Endo
GCATTGATCCTGTGGG-1	Lymphoid
TTGAGCAGTAACGGCA-1	CM
GTTGGTACAACCTCCT-1	CM
GCAAAGGGTAGACACG-1	CM
TGAGTCAGTGCTTCCT-1	Endo
GCAGCTGTCGATAGCT-1	CM
TTGAGCATCTCATATC-1	Fib
CAGTGTAGTGTCCTTC-1	Endo
TAACTTCGTCAGCTTA-1	Fib
GAGATTCAGGTTTCTG-1	Myeloid
CCACAGGGTCCGCTTT-1	CM
TGAGTCAAGATGGGAA-1	Endo
TAGGTCAGTGTGACCC-1	Endo
TTGCGAATCGGTCTAA-1	Lymphoid
TTGGTCCCAATCAGGG-1	Myeloid
CTTGCTGGTCGCTAGC-1	CM
CCCGTTACAGCCGAAA-1	CM
GCCAGACAGCTACGCC-1	Lymphoid
CTACAGATCGGTGATT-1	Lymphoid
GAGTGAGTCGATGAAA-1	Myeloid
GTTACGATCGATAGTC-1	CM
GTTACGAAGGGCTTCC-1	CM
TAACGGTCAAATGTCC-1	CM
CCCACATAGAGCCACA-1	Endo
TGCTTCGAGGAAGGTA-1	Myeloid
CGGTGCATCGGTCCGA-1	CM
ACGTGGCAGGTTGACG-1	Myeloid
GACCAATTCTGGAAGG-1	Pericyte
CAGCTAACACCGAATT-1	Myeloid
GCTCGAGTCGGAAAGC-1	Endo
GATGATCCACTGTCAA-1	CM
CACCACTGTCACTCTC-1	CM
GCCATAATCAGGGTTT-1	Lymphoid
CTCACCATCTTAACGG-1	Fib
CAGGGCTTCGCTATTT-1	Myeloid
TAAACCGTCTGACATG-1	CM
GTCCATCCAAATGTCC-1	CM
TGCATGACAAAGACGC-1	Fib
CTTAATCCAGCCACGT-1	Lymphoid
ACATGGTGTCTGAGCC-1	CM
TCGAGCGGTGCTGTGC-1	Endo
GAACCTAGTTTCGATG-1	Myeloid
TGTGACAAGGCTCCTG-1	Myeloid
TTTGAGGGTAATGTGA-1	Lymphoid
CGTTCCACATACCCGG-1	CM
CCCAGAGCAGCGTCGT-1	Lymphoid
TGATCAGTCATCGCCT-1	CM
TGATCAGAGTAGACCG-1	Lymphoid
AACTGTGGTCAACTGT-1	CM
CTCAGCTGTTCTACCC-1	Lymphoid
TCTCTGGCATACCCGG-1	CM
CACCTTGCAAGGAGTC-1	Endo
GCCCAGATCGTGAACT-1	Lymphoid
CTTGTCGGTGCTGTGC-1	Endo
GGAGGATCACTGTTAG-1	CM
CATAACGAGATGCGAC-1	Fib
GAATCTGGTTCCAATG-1	Myeloid
GGTACCGCATCGACCG-1	Endo
GGAACTTAGTAATGTG-1	Endo
TGTGGCGGTTGGGAAC-1	Myeloid
ACTAACGCACAGTAGG-1	CM
ACTAGGTAGGTAGGAA-1	Fib
TGTAAGCCACTGAAGG-1	CM
CCGTGAGTCCTCCCAA-1	Pericyte
AACTTGGGTCTCTGGG-1	Fib
GTCACCTAGATGCGAC-1	Fib
CTGAATGTCGGACGAA-1	Myeloid
ATTGTGGGTTGCCGCA-1	Myeloid
GCTGTTCGTGAGGTCA-1	CM
CCGTGAGTCTGTAGAC-1	Fib
TGATCAGTCGCGCTGA-1	CM
CGGTGCAAGATGCGAC-1	Endo
TAGCTTTTCACTAGGT-1	Lymphoid
TCCAGAAAGAAATACC-1	CM
CACAGATAGCCTGTAT-1	CM
GGCACGTAGGTTTCTG-1	CM
CCACAGGCAGACTAAA-1	CM
TTTGTGTAGATACCAA-1	Lymphoid
TGAATCGGTAAACGTA-1	Myeloid
TCAGTCCCAGGTGTCC-1	Endo
CTCTAGCTCGATGAAA-1	Myeloid
TATCTGTCAGAGAGAA-1	Endo
TCCAGAAAGAGGAAGT-1	Fib
GGGTCTGCATACCCGG-1	CM
TTGCAGAAGGGCGAAG-1	CM
AGCGATTAGTTGTCCA-1	Endo
AAATGCCTCTGGCGCA-1	Myeloid
TTTGAGGGTAGACACG-1	Myeloid
TCTCAGCTCAATGCAC-1	Endo
TGAGCCGCATTAAGGA-1	CM
TGGGTGCCAATGAAAC-1	Endo
GATCATGGTGATGCTT-1	Myeloid
TTGCGGGAGGTTCGTT-1	Endo
GTTCAAGGTGTCGGTC-1	CM
CATTGGAAGGTTCTCA-1	Fib
GGAATCTAGGTTCTCA-1	Fib
TAATCGGAGCGCGTTC-1	Myeloid
AGTTTGGTCTTTCGAT-1	CM
GCATTGAAGGTTTCTG-1	CM
GAAAGTATCTCGTAGA-1	CM
CTAGGATGTTCCTGTC-1	CM
AGTGTACCAAACCCTA-1	CM
TTCATTGCACTGTCAA-1	CM
TGCATTTCAAGGTTCT-1	CM
CTCATGCTCCTTCGAC-1	Myeloid
ACGGATTTCGCATACA-1	CM
ATCCAGAGTACATGGG-1	Lymphoid
GTAGACTCAGTGGTCC-1	Myeloid
TTGTTCAAGGTTTCTG-1	CM
GCGCATGAGGGTTCTT-1	Lymphoid
AAAGGGCCATTATGGC-1	Myeloid
GCGAGAACATAGTCCA-1	CM
AGGCGAAAGGTTCTCA-1	Fib
AGTCCGGCAGAACAGC-1	Fib
GTTGGGCCACTGGGCT-1	CM
GCTGAGCCACAAACGG-1	CM
AGTGCGCGTAGTCCAT-1	CM
TGCACCTAGCCTGTAT-1	CM
ACAAGCTCAGCGCGTT-1	Myeloid
ACTCGGGTCCAATAGC-1	Endo
TAGCCCTGTCCGTAGC-1	CM
TCAAAGCGTAGCGTTT-1	CM
TACCTCGTCTCAGATG-1	CM
GCTGTTCCACTGTCAA-1	CM
TGTTAGGTCGCACCGA-1	CM
GCATTCCGTGTCTCGG-1	Myeloid
ACTACGACATAGTCCA-1	CM
CAGGGCTAGCTACGTT-1	Lymphoid
TAGCCCTGTCAATACC-1	CM
GACTAGTAGGCACCTC-1	Lymphoid
GAGCGCTGTCCATTGA-1	Fib
TACCTCGTCCCGCAAG-1	CM
AACCGATTCGGACGAA-1	CM
TGATGCATCCAATCCC-1	Fib
CGGACCACAGGGCTTC-1	Myeloid
GCTGCGAGTTGGGAAC-1	Myeloid
ACTGCAATCACTAGGT-1	Myeloid
TAAACCGTCGCCAGAC-1	Endo
TAGGTCAAGAGGAAGT-1	Fib
GATCATGGTGCCGGTT-1	Fib
TTAGCTTCATTGTTCT-1	Fib
TTGCCCAGTGTGCGTC-1	Endo
AACCGATAGTTCCCGG-1	CM
TATCGAGAGGATTTGA-1	CM
AGCTGGCCACTACACA-1	Pericyte
TTGCTTAGTCCGTAGC-1	CM
TGTTAGGAGAGAACCC-1	CM
GCTCACTAGTTCCCGG-1	CM
GCCCGAAAGGCCTCGT-1	CM
TCGGGACGTAAACGAT-1	Fib
TGATCAGTCGATCGCG-1	CM
CACCACTGTGTAGGAC-1	CM
CAAAGCTCATCGGCCA-1	Myeloid
GTTGGTATCTCGCGGA-1	Endo
TATGTGGGTTAAGGGC-1	CM
TGAGCCGCAGAAGTGC-1	CM
GGCATTAAGATATGAC-1	Pericyte
CATTCCGAGGTCCTCG-1	Endo
CTGTATTAGTTCCCGG-1	CM
CTGTTCGCATAGTCCA-1	CM
GTCCATCTCCCTATTA-1	CM
TGTAAGCCAGCAACCC-1	Endo
TCAGGGCAGGAGAACA-1	Myeloid
TAACGGTTCTTAACGG-1	CM
AACGGGACATGCGACC-1	CM
GCGGAAAGTGTCTCGG-1	CM
GCTTGCTTCATTCATC-1	Endo
TACCTCGAGTACGCGA-1	CM
TTGCTTAGTGTTGGTT-1	CM
GACCCAGTCTTGTCGC-1	Pericyte
CGCTATCCAAGCAATA-1	CM
TACATTCCATACCCGG-1	CM
TACGCAACAATGTGTC-1	CM
CTAGGGCAGGTTTCTG-1	Myeloid
GTAGACTCACTGGGCT-1	Myeloid
GACCGACGTTACGGAG-1	Fib
TAATCGGAGGTTTCTG-1	CM
GGAACTTAGTTCCCGG-1	CM
TACCTCGTCATCGCCT-1	CM
GGGCCATCAGACCTGC-1	CM
GAGATTCAGCGTGTTT-1	CM
TAGCCCTGTGTTGGTT-1	CM
ACATGGTGTCAGACGA-1	Fib
ACCGAATTCTATCTAC-1	Myeloid
TCCAGAAAGTTCCCGG-1	CM
GTTATGGGTACGGATG-1	CM
TTGCTTAGTCAATACC-1	CM
CGGACCAAGGGCATTG-1	Myeloid
ATCCAGACACTGCTTC-1	CM
TCGGGACGTCTGAGCC-1	Neuronal
TAAGTGCTCCCTACGT-1	CM
GTGTGATAGGGCATTG-1	Myeloid
CGTACAAAGGCGACTA-1	CM
CGCAATAGTCGCGCTA-1	Endo
GTCTACCAGGTTGACG-1	CM
ACGGATTTCTATCTCA-1	Endo
