Barcode	cell_type
CTCTAGCAGGCAGTGT-1	vSMCs
CAACGGCTCAAGGCAG-1	Fib
TCCAGAAGTATATGGA-1	CM
CCCTAGTGTCCGTCGA-1	vSMCs
AACTGGTAGTCTAGAA-1	Fib
TACGGATCACATGATC-1	Fib
ATGTCGATCCGTTAGA-1	CM
GGTACCGTCGTGGAAG-1	CM
ACCAAACAGTTCTCCC-1	CM
TTACTTGAGTCAGGAC-1	Myeloid
CACTGAATCGACTTAG-1	CM
TTCTGTAGTATCTCAG-1	CM
CACCACTTCAACTTGG-1	CM
CTTAATCAGTAGGTCG-1	CM
CTCTCAGAGACCAATA-1	CM
GAAGTGGGTGGTAGAC-1	Endo
GCAGATTTCGAGGTAG-1	Fib
CATAACGGTAACGGAC-1	Fib
CTACAGAGTTCATTTC-1	Myeloid
AAAGGATTCCATAGGT-1	CM
CGCACAGTCTGAAAGA-1	Endo
GTTACGAAGGAAGGTA-1	Pericyte
TCGATTTCAACTAGAA-1	CM
AGGCGAAGTCTGGGAA-1	Endo
AGCCGCACATCGACCG-1	Myeloid
CGCTGGATCGTCCCAT-1	Fib
TACTAGGAGGCTTAAA-1	CM
TGCCTCAAGTCTGGGA-1	Pericyte
ACCGGGTAGACACAAT-1	CM
CTTTGCGGTGGAAGCT-1	Fib
TTGCGAAAGTTCTCCC-1	Endo
AGTGCCGGTTAGGAAT-1	Myeloid
GGCGTTGCAGATAAGT-1	Fib
CTAGCGGCAGAAGTGC-1	Pericyte
TTTACGTAGTGAATAC-1	CM
ACCATCCCAACATAAG-1	Fib
TATCGAGTCGGTAGGA-1	CM
AAGGAGCCAAAGCTGG-1	Pericyte
ATATTCCCACGATTAC-1	CM
TCACCACAGCTAGCAG-1	CM
CAGTATGTCTCGACAA-1	Fib
CTTGTCGTCGCTTACC-1	Endo
TACATGGCATCAGAAA-1	vSMCs
AGCGTGCTCCATGACA-1	CM
TACTAGGAGAGCTGTG-1	Fib
GCTGTTCGTCGGCTGT-1	CM
GCTTGCTTCCAACGCG-1	Fib
TAGCTTTAGGTTGTTC-1	CM
TTCATCAAGATGGCAC-1	CM
TAACGGTAGGCAGTGT-1	CM
GGATAGGGTACATGGG-1	Endo
GCGGAAACATGGTATC-1	CM
TCAAAGCTCAAGTTGC-1	CM
TTACTTGGTTACTTTC-1	CM
GGAATCTTCCTGAAAC-1	Fib
CTTGAAGCACTGTAAC-1	Fib
GAAGAGCAGCAATGTA-1	CM
GTTGGTATCTGATCTT-1	Endo
CCCAGAGGTCTAAAGA-1	Myeloid
CACCACTTCTTCACTA-1	CM
ACCCAAAGTATTCTTC-1	CM
GAGTGAGTCCCAATGA-1	Endo
CAACGTATCTCTTAAC-1	Fib
CTTTGCGAGCAGAGCT-1	CM
GGCATTAGTGCACCCA-1	Endo
TTGCCCAGTCAGACGA-1	CM
GGTGTCGTCGTAGCGC-1	CM
CAGCCTTGTGATAACA-1	Fib
AACGTACTCAGTGTAC-1	CM
TAGGTGTAGGGTCTGA-1	Endo
AGTTTGGAGTTATGAG-1	Pericyte
GCTCAGGAGGTCTTGT-1	Fib
TTTGGTTAGGGCATTG-1	Myeloid
GTGGCGTAGATCGAGC-1	CM
TGGACATAGTCATACC-1	Fib
GCTCGAGCAATTCTCT-1	CM
CACCTGTAGCTATCCA-1	Pericyte
TGAGTCAAGCTACGCC-1	Myeloid
CTCTAGCGTCTGTTGA-1	Endo
TTTGCGCAGTACCTCA-1	Fib
ACAAACCCACATCATG-1	CM
CTCCCAAAGTCGTGAG-1	Fib
AGGCCTGTCCGTTTCG-1	Endo
AACAGTCGTCAGCAAG-1	Fib
CCAGAATCATCGGCCA-1	Lymphoid
CATGTTTAGTCCAGAG-1	CM
CCTTGGTTCATGTTCT-1	Myeloid
TCAGGGCCAAGCTTTG-1	CM
TAACAGCAGAATGCTA-1	Fib
TACGGATTCCTGGAAT-1	CM
CAGTATGTCGACTATG-1	Fib
CCCGTTACACCAAGGA-1	Fib
CCGTACTTCCATTGTT-1	Endo
CAGTGTATCGATTACG-1	Fib
CTAGCGGAGTCGAAAT-1	Fib
TGCTCACCAACGAGGT-1	Pericyte
CTGAATGAGTACCACT-1	Pericyte
AGCGATTCAACCTCCT-1	CM
CCTCCCTGTAGGTAAT-1	Fib
CAACGTATCTGACTTT-1	Fib
ACATGGTCATGTGGGA-1	Endo
CGTAAACGTGCATCAT-1	CM
CCAATGATCTCATCCG-1	CM
CCGAAGCGTTCTGATG-1	Endo
CACCACTCATCGGCTG-1	Fib
ACGTGGCCAAGCGGTA-1	CM
TTACTCAAGTACAGTA-1	CM
CCGTGAGTCTATACCT-1	Fib
TGACAACGTCAACTAC-1	Fib
TTAGGTGAGCCATTCA-1	Fib
CGCTATCAGGCCAATG-1	Fib
AGCGTATGTACCCATA-1	CM
GCATGATGTAAACGTA-1	CM
GCCCAGACAATTAGGA-1	CM
GTGTCCTGTCAATACC-1	Fib
GATGGCCTCCTTACGC-1	Fib
TAACGGTGTTTCCGGG-1	CM
CTACAGAGTAGTCCAT-1	CM
CTACAGAAGTGCTCGC-1	CM
GCGTTGGCATAGGCGA-1	CM
CTCAGCTGTTGTATCG-1	CM
ATGTCGAAGGCAGTAC-1	CM
GTGATCAAGGGAAATG-1	Fib
GAGTGAGTCCTGGGAC-1	CM
CGTTCCATCTACTGCC-1	CM
GCGGGTTCAACGACAG-1	CM
TAGCACAAGAGCCACA-1	CM
AACAGTCGTATTCGAC-1	CM
TTCTGTATCGGTGATT-1	Endo
GAACTTGGTTCCCTTG-1	CM
AACTTGGGTAGCGTTT-1	vSMCs
ACTGTCCAGAGCTGTG-1	Fib
ATCGAGTCAGACTAAA-1	vSMCs
TTGCCCACATATTGGC-1	Fib
GTGCCAGTCCAGGTCG-1	Lymphoid
TAGGTCAGTACAACGG-1	CM
CAAGGCCGTATTCACG-1	Fib
CCTCCCTCATTGCGAT-1	Myeloid
CACAGATCATGGATGG-1	Myeloid
GTTACTTGTAATGTAG-1	vSMCs
ATCCTGCCATCAACTG-1	Fib
TATGTTCCACCTCGTT-1	CM
GAATCTGTCACAACAC-1	Myeloid
AAGGTTCCATATACGC-1	Endo
CCCACATCAGTATCTG-1	CM
TGGTCAAAGGTACACG-1	Endo
CCAGAATCAGGTAGGT-1	Fib
TACTAGGAGTATACGA-1	CM
ACCAAACTCGCACAAT-1	CM
TGTTAGGGTCACCGCA-1	Endo
TTGCAGAAGTTCGCGC-1	Fib
ATGTCGAGTGTGAGGT-1	Myeloid
CCGAAGCAGTCAGGAC-1	Endo
ATTGTCTGTCACCCGA-1	Endo
TTAGCGATCACTAGCA-1	Fib
CCTAAAGCAAGACTAA-1	Fib
TGGCCTTTCCATCGAA-1	Myeloid
GCAACCGCATTGAACC-1	Endo
TTAGCTTTCTCCTTAA-1	Fib
GAACCTATCAATTCCT-1	Fib
ACATGCACAAGCTTTG-1	Endo
TTGCGGGGTTCGGGAA-1	Myeloid
CGCTAGGCATGATTGC-1	Endo
GAACCGCCATCGAGTT-1	Pericyte
CCCTCTCCATGGCCCA-1	Endo
CCGTGAGTCGTGAACT-1	Endo
GTGCCAGAGACACTTC-1	Endo
TGTACAGTCCTCTCTT-1	Fib
GCGATTATCTGGCTAA-1	CM
AAGGAGCAGAGAACCC-1	Endo
TACCCTGCACCGAATT-1	CM
AGCTGATCACCGAAAG-1	Fib
AGGCCTGCAAGGCTTT-1	Pericyte
TGACTCCGTACCTATG-1	Pericyte
TACATGGAGCTGCTCG-1	Fib
GAACCTACATTTGGCA-1	Fib
TCCAGAAGTGCACCCA-1	CM
GCGCCAATCAAGGCAG-1	Pericyte
CTAGGATCATGGGTGA-1	Myeloid
TCGCCTAAGGATTGCG-1	Fib
AAATGCCCAGTTACAC-1	Myeloid
ACAGGCCCATTAGCCA-1	CM
ACAGCGCAGGCCAGTA-1	Myeloid
TCAAGACAGCGTTGCC-1	Fib
GATGGCCTCCTGTAGA-1	CM
AAACGAAGTAGACACG-1	Endo
TCAAGCAAGTACGACG-1	CM
TTTGTGTAGTCAGCCC-1	Fib
TACCCTGCAAACCCTA-1	Endo
CTTCTAACAATTGCCA-1	CM
TTGAGTGGTAGTACAA-1	Fib
ACAGCGCGTCTGGTCG-1	Myeloid
GCTGAGCTCTCCTTGG-1	Myeloid
AAAGGGCTCCATATCT-1	Fib
AAATGAGTCCGTCAAA-1	Myeloid
GCAGATTGTTGGTAAA-1	Pericyte
CCCTCTCCAAATTCCG-1	CM
GAGGATGTCCACGAGC-1	Endo
TGACAACTCCGGAAAG-1	Endo
AACTTGGTCAGATACC-1	Endo
CAGTATGGTATTGTCG-1	Pericyte
CCTTGCACAATTCTCT-1	Pericyte
TGACAACGTGTAGGAC-1	Myeloid
CATTCCGAGTGATTAG-1	Fib
TTCAACTTCGTGAGTT-1	CM
ACTATTCGTAGCTGTT-1	Fib
AGCCCGAAGCGTAGCA-1	CM
CTTGTCGCACACTAGT-1	CM
ACAAGCTGTAATGTGA-1	Fib
CCAATGAGTGCAGACA-1	CM
TAGCCCTTCCAATCCC-1	Pericyte
CTCTAGCGTTGCCTGG-1	Fib
TTAGCTTTCCAACGCG-1	Fib
TGGGTTACATCACAAC-1	Myeloid
CTTGAAGCATTAACGC-1	vSMCs
CGCTAGGAGCGATACG-1	Fib
GCTGTTCTCCCGCAAG-1	Fib
GAACCGCCACTGTTAG-1	Myeloid
TGGCGCATCCTCCTGA-1	Pericyte
GGAATCTGTACGTATC-1	CM
TTGTTCAAGTCTAGAA-1	Endo
GAGACTTAGCATGTGG-1	CM
CTAGGATCAGCACATT-1	Myeloid
TTTGAGGGTCTGCACG-1	Fib
TCGATTTAGGATGTCG-1	Endo
TAGGTGTAGGGTTCCC-1	Myeloid
CTGAATGAGGTAAGTT-1	CM
CATGTTTGTTTGTAGC-1	CM
TAAGTGCAGCCATTCA-1	Endo
CCGTAGGCAATAGCGG-1	Myeloid
ACGTTAGAGGCCTAAG-1	Endo
TTCGGTCTCGACCCGA-1	Endo
TCTCAGCAGCGCCTAC-1	Endo
TGCCTCAAGTGAATAC-1	Fib
CTTAATCGTATCCCTC-1	Myeloid
CGCGCAATCGACTCGG-1	Fib
GTGCACGCAACGAGGT-1	Lymphoid
TAGCTTTTCAAGAGGC-1	Fib
ACCCAAACATTGAACC-1	vSMCs
TTCGGTCAGTTCAGGG-1	Endo
CGTGGCACACTCCTCA-1	Myeloid
GATTGACTCCACGGCA-1	Fib
TCGGGACCACAAGTGG-1	Fib
TTGCAGACAACTCCCT-1	Myeloid
TGTGACACACCTACCT-1	Myeloid
TCAAGACCACCACCAG-1	CM
ACTTTCATCAGTGTAC-1	Endo
GCAGCCACACGCCGAT-1	Fib
ACCATCCGTCTGGGCT-1	CM
AACGTACGTAGAATAC-1	Fib
CCCGTTAGTCATGAGG-1	Endo
TTACGGATCCTCCAGT-1	Myeloid
TGACAACAGTGTCGCC-1	Fib
GAACCTAGTAGCAGGT-1	Endo
TTACTCAGTTTGCATG-1	Fib
TAATCGGTCGATGTGT-1	Endo
CCTTAATGTGCCAAGA-1	Endo
CACCTTGGTCATAAGA-1	Fib
TCGATTTAGGATTAAC-1	CM
GAGAACGCATACCCGG-1	Fib
GACTAGTTCGCCAGAC-1	Fib
CACCTTGAGACAGTGC-1	Fib
GAAAGTAGTCGATAGG-1	CM
ACTACGATCGCTATAG-1	Endo
GGACACCCACTGATAC-1	Fib
TCAAAGCAGCCGCTGT-1	CM
ATGCATGGTAGTGATA-1	Myeloid
ATTTGTCCAGTTGGAG-1	Pericyte
TCAATTCGTTATAGAG-1	Fib
TCAGTTTGTAGGGTCA-1	Endo
TCGCCTAGTGTCCAGC-1	Myeloid
GAAAGTACATAGCCGC-1	CM
AACAAAGCAACGTACT-1	Endo
ACCGGGTTCGATTACG-1	Myeloid
CCGAAGCTCCCAGTAA-1	Myeloid
GCGAGTCCAGCCACGT-1	Lymphoid
GGCGAAAGTCAATACC-1	CM
GTGTGATGTCGGCTGT-1	Pericyte
TGATCAGCAGTCCTGG-1	CM
GTTACGAGTGCATCAT-1	CM
GTGCTGGAGTCACACT-1	Myeloid
CGCTAGGCAGTTGGAG-1	Pericyte
GCTCACTGTCCGTAGC-1	Fib
GGGTTATGTTGTGACT-1	Pericyte
TAACGGTAGACGAAAG-1	Fib
TGTAGCAGTTGCAGCC-1	Myeloid
CTCACCACACTCGGAC-1	CM
CCCTAACCAGTATACC-1	Fib
TTGCGGGCAAGCAATA-1	CM
CCTATTACACGTTACA-1	Endo
TACTGCCTCAGAATGA-1	Endo
CTGCTCAAGGAGACTC-1	CM
GAAGTCTGTTTGAAGA-1	CM
CCGTAGGGTTTGACCA-1	Fib
CCAGATAGTCCTTATT-1	Endo
CATGCCTAGTCATACC-1	Fib
GGTAGGAAGGCTCCTG-1	Fib
TGAATCGTCGCAAACT-1	Endo
AACAAAGTCCTATCCG-1	CM
ACAAGCTCACGAACGA-1	CM
ATTGTCTCATTCACCC-1	CM
GAAGTCTAGTGTCGCC-1	Endo
CATGTTTGTCACTCTC-1	CM
AGCGTGCAGCGTATCT-1	Endo
TATGTGGGTAGTCCAT-1	Endo
TGCTTTAAGTCCTTCC-1	CM
CTTGAAGAGTGCCCTG-1	CM
ATATTCCTCACCGCGA-1	Pericyte
CACCTTGTCATTCATC-1	Fib
GGCGTTGGTACGGTTT-1	Endo
ATGTACGAGCCTCGCA-1	Endo
GTCTACCGTACGGAGT-1	Myeloid
AACCTGAAGCATGTGG-1	CM
AGCCTCTTCGGGCTCA-1	Myeloid
ACTAACGAGTGAACCG-1	Fib
AGCTGATCAGTTGCAT-1	Myeloid
CGATGATTCATCATGG-1	Endo
CGCAATATCTCTTAAC-1	Endo
CTAGGATAGGATGTAT-1	Fib
TACATGGAGACTTGAA-1	Endo
AGCGATTTCTATACCT-1	Endo
GCACGGTTCGTGATAC-1	Endo
CATGCCTAGCCTGGTC-1	vSMCs
CAATCCCCAATACTGC-1	Endo
CATTCCGTCAGTGTAC-1	Endo
CGTAAACCAAGCTTTG-1	Endo
AGTCAACAGGTGATGC-1	Endo
ATTCGTTGTTCTTAGG-1	Myeloid
ATAGTCGGTTGTGAGG-1	Fib
CGCTATCAGCCATGGA-1	Neuronal
GTGTGATGTCAAATCC-1	Myeloid
TTCGATTCAACTCGTA-1	Fib
GCCCGAACATGGTAAA-1	Fib
TCACCACAGCAACGGT-1	Myeloid
ACTACGATCTCTCAAT-1	Lymphoid
ACAGACTTCTATGAGC-1	vSMCs
AGCTGATCAGAGATGC-1	Endo
TAGCCCTCACTCCTCA-1	Fib
CCTATTACATGGATGG-1	Endo
TACTGCCAGGTTCGAG-1	Fib
CCCTAACAGGTTGTGG-1	Pericyte
AAAGATGGTAGCAGCA-1	Endo
TACAGCACACAAACGG-1	Myeloid
GCTTAAGTCTCATATC-1	Fib
TCGCAGGTCCTATCCG-1	Endo
ATCCTCGTCAAACCAC-1	vSMCs
GGAGAACAGCAACGGT-1	CM
GTCCATCCACTGCTCT-1	Endo
TATGTGGGTCATGAGG-1	Fib
CGAGTTACAGAGATGC-1	Endo
TTCGGTCGTGATAAGT-1	Myeloid
TTGCGAACACTGATTG-1	Fib
CGGACCACACAGAAGC-1	Myeloid
TTAGCGATCTCATATC-1	Myeloid
CTCAGCTAGATGTTCC-1	Pericyte
ACTCGGGCACGCGCAT-1	Myeloid
TTACCCGGTGCCCTAG-1	Fib
TGGTCCTTCGTGCTGG-1	vSMCs
GCACCTTGTTTGTAGC-1	Pericyte
GAACCTAAGCCTATAC-1	Fib
GCAGCCATCGGGAAAC-1	Myeloid
TTTGGTTTCCTATCAT-1	Endo
CTTAATCAGGTAAGTT-1	Myeloid
CGTAAACGTGATAGAT-1	Endo
TTCGTTAAGGAAGGTA-1	Fib
ACTTCCGAGTGTTCCA-1	Endo
ATAGTCGGTCTGCACG-1	Endo
TACGCCTTCCCAGTAA-1	Fib
GGCATTAGTGCCGGTT-1	Endo
GTGTCAAAGATCGATA-1	Fib
GACCGACGTGGTTCTA-1	Fib
TTAACGGTCTGTTTAC-1	Neuronal
TTGCCCAGTGAGGTCA-1	CM
ACGTGGCTCTTCCAGC-1	Fib
TTCTAACTCACATTCT-1	Endo
CCTAAAGTCTACTGCC-1	CM
GGAGTAGTCGTGTGCG-1	Myeloid
TACAGCATCGTTCCGT-1	Myeloid
AGCTGATCAGTAAGAT-1	Endo
ACATGCAAGGTAGGAA-1	Fib
GTTACGAGTTCTCGAA-1	Fib
GCCCGAATCGCATAAC-1	Endo
AACTGTGTCAATTCCT-1	Pericyte
CACTAAGAGTCAGCCC-1	Neuronal
CCCTCTCGTAAACGGC-1	Neuronal
CTAGCGGTCCCAGCGA-1	CM
GCTCACTTCCGTGCAG-1	Myeloid
TAGCTTTCAGAGATGC-1	Endo
GTGCTGGTCCACGGCA-1	Myeloid
CTCTCGAGTGGACAGT-1	Endo
TTACGTTAGTTGAATG-1	Myeloid
GCTGAGCCATTGCACA-1	Pericyte
AACGTACTCCGCCTAT-1	Fib
ATGTCTTAGTCCCTCT-1	CM
TACAGCATCGTCCCAT-1	Endo
CACATGAGTGCTGTCG-1	Endo
GGAATCTAGCCGCAAA-1	Endo
CACCTGTGTCCAACCG-1	Myeloid
ATCCAGAGTAGTGATA-1	Fib
AACCGATCACGGCCAT-1	Pericyte
TGACAACTCATTCGGA-1	Endo
AGTTACGGTCAACGGA-1	Fib
GTCACCTGTCAAATCC-1	Endo
GCTGAGCCAGTCAGCC-1	CM
GGAGGATCAATCATCG-1	Pericyte
GTCACGGCAGGCAAGT-1	Myeloid
ACAATCGGTAGAGAGA-1	Pericyte
CCACGTTGTTGCTTGA-1	Myeloid
TTTACGTGTCGCTAGC-1	vSMCs
GTGTCAACACCACCAG-1	vSMCs
ACGTGGCCAACAACTC-1	Fib
ACAGGCCGTTTCACCC-1	Myeloid
GCGAGTCAGGCAAGCT-1	Pericyte
ACGTGGCCACTTACAG-1	Myeloid
TTACTTGCAGTATACC-1	Endo
AAATGAGTCCATCGAA-1	Pericyte
TTACGTTGTGCTGTGC-1	Fib
ACCTGCTCAAACCCTA-1	CM
CAGCTGGGTGGATTCT-1	Endo
TTGCCCATCAAGTTGC-1	Myeloid
CACGTTCTCGAGGTAG-1	Myeloid
AGCCTGGAGTCACGCC-1	Fib
GGCGTTGGTCAACAGG-1	CM
CCCTGATAGGTACTCT-1	Fib
CTTTGCGTCTGAACGT-1	Pericyte
TACATGGGTACAAGCG-1	Myeloid
GCGCATGCAAATTGAG-1	CM
GACTAGTCATCATAGC-1	Myeloid
TGCTTTATCTATGAGC-1	Endo
TGTAGCATCAGAGTGG-1	Endo
ACCGAATAGGCTAAAT-1	Endo
GCCCGAACAAATTCCG-1	CM
GCTGAGCGTGAGGTCA-1	Fib
CAAGAAACACAGGAAC-1	Neuronal
TTACCGCAGAGCCTGA-1	Fib
ACCTGCTCAGAACAGC-1	CM
TTTGTGTGTGAGAGTC-1	CM
CCACGTTTCGATAGGG-1	Lymphoid
GTTATGGAGCGCACAA-1	Endo
GCAGCTGAGGCCTCGT-1	Endo
AGTTACGCACAAACGG-1	Fib
TCTCTGGCACTTACAG-1	Endo
TTACTCATCCCACGGA-1	Endo
CAAGGCCTCGATCTTT-1	Endo
AACCAACTCCAAACCA-1	Endo
AGTGCGCTCTTGGCCT-1	Endo
TACCCTGCATCATAGC-1	Lymphoid
TTCTGTATCGAAGCCC-1	Pericyte
GCCTACTAGAGAGTAG-1	Myeloid
ATTTGTCTCGGTCTAA-1	Lymphoid
GAGCGCTGTGCACTTA-1	Myeloid
CAACCAAAGTACAGTA-1	Fib
ATTACCTTCGGATCGC-1	Fib
TTCATTGTCACTTACT-1	Myeloid
TGGAAGGTCTACTGCC-1	vSMCs
CATTGGAGTAGAACGC-1	Fib
TACCCTGCAATGATGA-1	Endo
TGCTCACCAGCGTGAA-1	Fib
GCTTAAGCATCGTGAT-1	Pericyte
TACGCCTTCGCTTCAC-1	Myeloid
TAGTCCCAGATGTTGA-1	Endo
GTTATTCCAGTAGTCT-1	Endo
CTCAACCGTTTCGACA-1	Endo
CAAGAAATCTATAGGC-1	Endo
CCTAAAGCAAACCCTA-1	CM
TGTACGAAGAAAGGGT-1	Endo
GAGACTTGTGTACGCC-1	Endo
CTCTCGAGTAGAACGC-1	Myeloid
AAATGCCGTGAGTTGG-1	Endo
TTCGGTCTCAGCCGGT-1	Endo
GCACCTTGTCACTCTC-1	Pericyte
GTGGATTTCAGCACTA-1	Pericyte
TTTGGCCTCAGCACGC-1	Fib
CTTGCCACATCGCTAA-1	Myeloid
CCGTACTGTAACACTC-1	Myeloid
TAACGGTAGAGGAAGT-1	Pericyte
AGCTGGCAGAACGCCA-1	Myeloid
AACCTGAGTGCACTTA-1	CM
TAGCCCTAGACTAATG-1	Endo
TGCTTTAAGCATACCT-1	Endo
TTACTTGCATCAACTG-1	Endo
GAGACTTTCTTTATCG-1	Myeloid
TCAAGGTCAAAGCATA-1	Endo
GGTAGGAGTTAGGAAT-1	Myeloid
TTGTTCAAGGGTAATT-1	Pericyte
GATCGTATCGCAAGCC-1	Fib
GTGCACGCAAGGAACC-1	Endo
CCACAGGGTCCGGTAC-1	Endo
ACTAGGTTCTCGTGAA-1	CM
GTGGCGTGTCCGTGCA-1	Endo
CGCTGGAAGGTTTCTG-1	Myeloid
TATTGCTAGACCGCAA-1	Fib
CACCACTGTTCTGATG-1	Lymphoid
GAAGTGGGTCTGAGCC-1	Endo
CACTGAAAGTCCGTGC-1	Endo
GATGATCCAGTGGTCC-1	Endo
GGCGTTGGTGTAGGAC-1	Endo
ACTATTCGTGGACTGA-1	CM
TTCGCGTTCTTGTCGC-1	Endo
CAAGGCCAGGCAGATC-1	Myeloid
TTACGGATCCGCTCTA-1	Myeloid
CTCCCAATCTCCAACC-1	Pericyte
TCGCCTATCACTCGGG-1	Endo
TCTCTGGTCAGTCACA-1	Myeloid
CTCCCAAAGTGTCACT-1	Endo
ATCCCTGAGTGTTCCA-1	Fib
GGAACCCGTTCGGGAA-1	Endo
CAGTGCGGTCGAGGTA-1	CM
CGTACAAAGTCCAGAG-1	CM
GCGAGAAGTAACCGAG-1	Myeloid
GGCGTTGGTACGCAAG-1	CM
CGCAATACAAAGGAAG-1	CM
CCGAAGCGTTGGGAAC-1	Endo
ACATGCAAGGCTTTAC-1	Pericyte
CGGACCATCTTATCAC-1	Endo
GAACGTTGTGCGCATC-1	Myeloid
TTATGTCAGAATGCTA-1	Endo
CGAGTTATCAGTTGAC-1	Endo
GGTACCGCACAGCCAC-1	Endo
GATGATCCAGATTAAG-1	CM
CTTGCCATCTCTGAGA-1	Pericyte
CTCAGAAAGTACAGAT-1	Endo
TAGCATGAGGTGATGC-1	Endo
AAGATAGGTAGTACAA-1	Neuronal
TACGGATGTTTCAGCA-1	Pericyte
TCAGGGCTCCCGAAGC-1	Fib
ACAGGCCGTTTGTACG-1	Pericyte
GTTGGTATCTTCGTTA-1	Myeloid
GTGCCAGGTCGCTAGC-1	CM
TGTACGAGTATTCTTC-1	Myeloid
AATGTCGTCAGTGTAC-1	Pericyte
ATGCATGTCCGAGGAA-1	Endo
TACATTCTCTCATCCG-1	Lymphoid
TTGCACCTCGATAGTC-1	Fib
TAGCCCTCATTCGTCC-1	Pericyte
TAAACCGCAAGGATGC-1	Endo
CTCTAGCGTACGCAAG-1	Fib
GAACTTGCACGCTGTG-1	Endo
GCCTAGGAGTGATAAC-1	Endo
TGCTTTAGTACGCCCA-1	Myeloid
AGTCCGGAGGCTTCGC-1	Myeloid
AACTGGTCACGCTAAT-1	Endo
TTGACGAAGAGGAATG-1	Endo
CGCTAGGGTCGAGGTA-1	Endo
CCGTGAGTCCAACGCG-1	CM
TTAGCGACAGATTGTC-1	CM
CATGTTTGTGTAGGAC-1	CM
CCTAAAGCATCGGCCA-1	CM
TACTGCCGTCCCGTGA-1	Myeloid
TTAACGGGTAGTCTGT-1	CM
CGGACTGTCCAGAGAG-1	Myeloid
GTCACTCTCAAACCCA-1	Myeloid
CACTGAATCTGCCGAG-1	Fib
CGTTCCAAGCATGTGG-1	CM
CTCTAGCGTCAACAGG-1	Fib
CTTGCCAAGTTCTCCC-1	Endo
CCATACCCAGTAGGCA-1	Endo
TGTAAGCCAATCACTG-1	Myeloid
GGAGTAGTCAGCCGAC-1	Fib
GAAGAGCAGCCCATTA-1	Fib
GTGTCAACATAAAGTG-1	Neuronal
CCTAAAGCAGAACAGC-1	CM
GCACGCATCTATGAGC-1	Endo
CATTCATGTTCAGTTG-1	Fib
TTGACGATCTTTGCAT-1	Endo
AGTTACGTCTTGTCAT-1	Endo
CCTAAAGCAGTTCGGC-1	CM
CACATGACATCAACTG-1	Pericyte
TTTGGCCGTAGATTAG-1	Fib
TAAGTGCAGGGAGTTC-1	Pericyte
CTGCGTTAGCAAGGTC-1	CM
GGGTCTGGTTCCCTTG-1	Myeloid
GGAATCTGTACGACCC-1	CM
GAACTTGAGAGCAGCT-1	Pericyte
TCTCAGCAGTGCTGAG-1	Endo
TCGATTTGTTGTGACT-1	Endo
AACAAAGGTACGGATG-1	CM
TTTGTGTTCAGTAGTC-1	Fib
TAATCGGAGGGCTTCC-1	Endo
GTTGGGCGTAAGCCGA-1	Endo
CATGCCTCAAACGACG-1	Pericyte
ACCTGCTCAGTTCGGC-1	CM
TTCATTGCAGATTAAG-1	CM
CTACTTAGTATTCTCT-1	Myeloid
ATGTCTTAGCATGTGG-1	CM
CAAGAAAGTACGCCCA-1	CM
TCAGTTTCAGTGCTCG-1	Fib
AACCTTTAGCAACGGT-1	Endo
CCCTAGTGTCCTTATT-1	Myeloid
ACCGAATAGGAGTACC-1	CM
CGCAATACAATGTGCT-1	Myeloid
TCACAGAGTACGCAAG-1	Fib
GCACCTTGTGTAGGAC-1	Pericyte
CGTGGCATCGTGAACT-1	Myeloid
AAAGGGCGTATCCTTT-1	Myeloid
TTAACGGGTGCCCGAT-1	Pericyte
TGGACATCAGGCAAGT-1	Lymphoid
GTGACATCAGTGCTCG-1	Fib
CCGTAGGCAGTGCTCG-1	Fib
ACCTGCTCATCGGCCA-1	CM
ACTATTCGTAGTACAA-1	Neuronal
TCACAGAGTCAACAGG-1	Fib
CAAGAAAGTGTCTCGG-1	CM
GAATCTGCACTCCCAT-1	Fib
TGCATTTAGCAACTGG-1	CM
TGGGTGCAGAGGCAGG-1	CM
GAAACAAAGACGCCCT-1	Endo
GGAATCTGTCGATAGG-1	CM
GCTGTTCCAGATTAAG-1	CM
ACCTGCTCAAGTCTGT-1	CM
AGCCTTCTCTTCTCTC-1	Endo
AGGCCTGCAGTGCTCG-1	Fib
ATGTCGAGTTTGTAGC-1	Endo
AGTGCCGAGAAAGCAG-1	Endo
GGAGGATCACGAACGA-1	Endo
ACCTGCTCAAAGACGC-1	CM
AGCGATTAGTGATCTC-1	Endo
TGCTCGTAGGATGCCA-1	Myeloid
ACTAACGCAGAGAGAA-1	Endo
GTCACGGTCGACGGAA-1	Myeloid
CGCAGGTGTATCACAC-1	Endo
CACCACTGTTGGGAAC-1	Lymphoid
GTGCCAGCAAGGAGGG-1	Endo
TAAACCGCAAATGTCC-1	Endo
AGCGATTCATGCGTTA-1	Lymphoid
ACGTGGCGTATGTTCG-1	Myeloid
AAACGAAGTCAGTGTT-1	Endo
CGCTAGGCAAACCCTA-1	Endo
CTGGGACCAGGTCTGC-1	Endo
GTGGCGTGTAACGGCA-1	Myeloid
GAGCATTTCAGGATCT-1	Endo
TACGGATCATGGGTGA-1	CM
ACCGGGTCAATGTGTC-1	Fib
ACCTGCTCACAGTAGG-1	CM
ACGGATTTCAGGCGCT-1	Endo
CAGCTGGGTATTTGCG-1	Pericyte
GTCGTAAAGCCTGGTC-1	Pericyte
TACAGCACACTCGGAC-1	Myeloid
ACAGACTTCGTGGGTC-1	vSMCs
CTTGAAGCACTCCCAT-1	Fib
CACTAAGGTACAACGG-1	Neuronal
GCTGAGCTCCAATCCC-1	Fib
AGCTGATAGTCTAGAA-1	Fib
TTCATCATCTATCTAC-1	Pericyte
GCTCCTATCCTGGAAT-1	CM
GAAGAGCGTTGCCGCA-1	Endo
AACATCGCACAGCCAC-1	Endo
CAGTGCGGTCTCTGGG-1	CM
TATCGAGCAGTTGCAT-1	Fib
GCTCCTACACAGCCAC-1	Endo
ATGTCGAGTCACTCTC-1	Endo
CGCGCAATCGTGCTGG-1	vSMCs
TGATCAGTCGCTATAG-1	Endo
CATGCCTAGTTCCAGT-1	CM
CCTAAAGCAAGTCTGT-1	CM
CAAGGCCAGCATGTGG-1	CM
CAGTGCGGTCGCTAGC-1	CM
GCTCCTATCGTTGTAG-1	Fib
GACCGACCAATTCGTG-1	Pericyte
ACAAAGACAAGGAGTC-1	Lymphoid
GACCTTCGTTCAGTTG-1	Myeloid
CTTGAAGAGCATGTGG-1	CM
TAAACCGCACCTACCT-1	Endo
TGCCTCAAGGTAAGCC-1	CM
CCTAAAGCAAAGACGC-1	CM
GAAGTGGGTCGCGCTA-1	Endo
CCTGGGACAGCTGATT-1	Endo
CGCTAGGCAGAACAGC-1	Endo
GCTGTTCGTCCGTGCA-1	CM
GCAAAGGCATAGTCCA-1	CM
TGATCAGTCTCTCAAT-1	Lymphoid
GACCAATGTATCATGC-1	CM
AGGCGTCCAGTTAAAG-1	Fib
TGATCAGAGTCCAGAG-1	CM
ACCTGCTCAAGACTTC-1	CM
ATCCAGACAGTGCGTC-1	CM
TCAGGTACAGATTAAG-1	CM
TTGCCCAGTTTAGAAG-1	CM
GCTGAGCGTTGGAGGT-1	Fib
TAACAGCTCCAGTTAG-1	Pericyte
GTGTCCTCATGGGTGA-1	CM
AACGTACCATACCCGG-1	Fib
TGGGTGCAGAGGCCTA-1	CM
CGCTAGGCATCGGCCA-1	Endo
TTGCCCAGTTGGAGGT-1	CM
GCCAGACGTTCCTATT-1	CM
GCTTTCGCACTCGTGG-1	Endo
AGTCCGGCAAATTCCG-1	CM
ACGTGGCTCTATCTAC-1	CM
TTGCCCAGTCGAGGAT-1	CM
CTAGGATGTTATGCAC-1	CM
TAGCTTTAGACTAATG-1	CM
CTCCCAAAGCACACCC-1	CM
GTGCTGGAGTGAGCAC-1	Endo
ACCTGCTCACGAACGA-1	CM
CGTACAAAGCTGGAGT-1	Endo
TGACAACTCCAATCCC-1	Fib
AACGGGACAATTAGGA-1	CM
ACTATTCTCAGCGGTC-1	Pericyte
CCTAAAGCACAGTAGG-1	CM
AAACGAAGTCTAACCA-1	CM
AACAAAGTCGAGAACG-1	Endo
GATGATCAGCGCATTT-1	CM
CGCTAGGCAGTTCGGC-1	Endo
CCTAAAGCACGAACGA-1	CM
CCTAAAGCAAGACTTC-1	CM
CACATGACAAACCCTA-1	CM
GTAGACTTCAATTGGC-1	CM
GTAGGAGTCCGCCTAT-1	CM
TTGCGAAGTTCCTGTC-1	Endo
TAAACCGTCACTTACT-1	Myeloid
TACATTCGTATCAGCT-1	CM
GCTGAGCGTCGAGGAT-1	Fib
GCTGTTCCACTGTAAC-1	Endo
GCCAGACGTGCTGGCT-1	Pericyte
GATCATGGTTCCGGCA-1	CM
AGTCCGGCATGGTAAA-1	Fib
TTAACGGGTCAGTGTT-1	CM
TTGCCCAGTAATGCCT-1	CM
ATATTCCAGCATGTGG-1	CM
CAAGAAAGTACAAGCG-1	CM
GCTGAGCGTTTAGAAG-1	Fib
GGTCATACATGCTATG-1	CM
TACGGATCACAGCCAC-1	Endo
CCGTGAGGTCCCGTGA-1	CM
CAACCAATCTATAGGC-1	CM
TGATCAGTCGTTGTAG-1	Fib
CGTGGCAGTGACAAGC-1	CM
