Barcode	cell_type
TCAGTTTGTATCTGCA-1	Fib
GAACCTAAGCGTTAGG-1	CM
AGGCCCATCACAGGGA-1	Lymphoid
CTTAATCGTCCTATTT-1	CM
TTCATTGCATGGGACA-1	Fib
CCCTAACTCCTGAAAC-1	CM
ATCCAGACAACGTAGG-1	CM
TAGCCCTTCACCGCGA-1	CM
TACTGCCCAACCTCTC-1	CM
ATTGTGGCATCCCTTG-1	CM
TACGGATTCAAAGTAG-1	CM
TTACGGACACAGGAAC-1	CM
GTTCAAGGTCTAAAGA-1	CM
GACCGACAGAATACTG-1	CM
TGTAGCACACTGTAAC-1	CM
TGATCAGTCCCTATTA-1	CM
GTTGGGCAGAGAAGCA-1	Fib
ATCCAGAGTGAGCTAG-1	CM
TGGCAATTCTTAATCC-1	CM
GTGTCCTCATTACTTC-1	Myeloid
ACATGGTCATTTCTTG-1	CM
GCACCTTAGAGGCCTA-1	CM
TAACAGCAGAGACTCG-1	CM
GTACTTTCAAGGCGTA-1	CM
CTAGGGCCATCCCTCA-1	CM
GTGTCAACAAGGAAGA-1	CM
ATCCCTGTCGTAGCGC-1	CM
AACCTTTCATATTGGC-1	Fib
TCAAGGTAGTCATACC-1	CM
AATGGAATCCCTAAAG-1	CM
AACTGTGTCTGGTACA-1	Myeloid
CGGACTGTCGAGGTCC-1	CM
CCGTGAGAGACCGCAA-1	Endo
GCACGGTGTGTCGTGC-1	CM
GCCAGCATCCGGCTGA-1	CM
GCCTAGGGTACGGATG-1	CM
ACAAGCTGTTCTTTCA-1	CM
TTAGCTTTCACATTCT-1	CM
AGATTCGTCGATTACG-1	Fib
GAAGTGGAGGGATCCA-1	CM
AGTCAACGTTCCGGCA-1	CM
GCGCATGTCGGTCTCT-1	Endo
TTATGTCCAAAGCTTC-1	Fib
GAGTGAGTCCATGTTT-1	Fib
AGGCGAATCAATTCCT-1	Fib
GGTGAAGGTCCGAGCT-1	Fib
GCGTTGGCACTCCCAT-1	Fib
GGAGAACGTCAGAGTG-1	Myeloid
ACCCAAATCGCAAACT-1	CM
TGGCAATAGAGTTTGA-1	Fib
AGCCTGGCATTACTTC-1	CM
ACAAACCGTTTGGATC-1	CM
TGTAAGCGTCCAAGAG-1	Fib
CAGCTGGAGGTTGACG-1	CM
CTTGCTGAGTCGTGAG-1	CM
ATGGATCTCAGATACC-1	CM
AACGAGGTCCATCTAT-1	CM
TGATCAGGTAGGTGAC-1	CM
TTACCGCAGTGAGTGC-1	CM
GTGATCACACAGCTTA-1	CM
GCACGCAAGGGTATCG-1	Myeloid
ACTAGGTCAGGGTAAC-1	CM
CCGCATTAGATGTTCC-1	Myeloid
TAGGTGTAGGTAGGAA-1	Endo
CGCTATCGTGAATACA-1	Fib
TCAGTTTCACTCGGAC-1	CM
GTGCACGGTATCCCTC-1	CM
TGCCTGTAGAGTAAGG-1	CM
CGCAGGTTCCTTGACC-1	Myeloid
CACCACTAGGACTAGC-1	CM
ACGTGGCAGTTGAATG-1	Endo
TTGAGTGGTCTGGGAA-1	Myeloid
GCACGGTTCTTTGCAT-1	CM
ACGGATTGTGTTGTTG-1	CM
TTTGTGTCAAATGTCC-1	Myeloid
GTGGCGTGTCAGAAAT-1	CM
AGCCTGGAGGCCTCTG-1	Fib
TCACCTGAGGCAGTAC-1	Fib
CATTGGAGTGGCATAG-1	Fib
TAGCTTTTCCCTACGT-1	CM
TTTGGTTTCGCTGATA-1	CM
TTAACGGAGAAAGCAG-1	Myeloid
TTGTTCAGTAAACGGC-1	CM
GCGCCAACAGTCAGCC-1	Fib
TGGCAATAGTGTCCCG-1	Fib
GGGACCTCAACTAGAA-1	Fib
GCTTGCTCAACTAGAA-1	Fib
AGCGTATCAGTAACCT-1	CM
GAGGCTCGTCCCTAAA-1	CM
ACAGACTCACAGCTTA-1	Fib
GATCGTATCCGAATTG-1	CM
GAGTGAGCAACATAAG-1	CM
TGTTAGGTCAAACCAC-1	CM
GTGTCCTTCAACTTGG-1	Fib
AGCCTTCCAAGCAACG-1	CM
GAGGCTCCAATAGCGG-1	CM
CACAACACAGCAACCC-1	CM
GGCACGTAGACCGCAA-1	CM
GAGGTCCCAAGTTGCT-1	Fib
GAAATGACACAGATGG-1	Endo
GTTACGAGTGCCAAGA-1	CM
AGTGCGCTCGTGATAC-1	Fib
TACCTCGAGGTTTCTG-1	CM
GTGGCGTGTTGGCTAT-1	CM
AACCAACCATGTCCCT-1	CM
GGGTGTCCAGGGAGTT-1	CM
TTGAGTGTCTTCCGTG-1	CM
TCAGCTCTCTCGTAGA-1	CM
TTGCCCAGTGGCCTCA-1	CM
TGGCAATAGTGCCCTG-1	CM
CCCTGATCATGTGAGG-1	CM
TCAGGTAAGTACGACG-1	Fib
GAATCTGCAAGGTTCT-1	CM
GTTGGTACATATTGGC-1	CM
CATAACGGTCTGGGCT-1	CM
TGACAACTCCTATCCG-1	CM
CCAGAATTCAAATGGA-1	CM
CGTACAAAGTGGTGTG-1	CM
TTGCAGAAGTTACACC-1	CM
GCGATCGAGACTAATG-1	Pericyte
GGAGTAGGTACATGGG-1	CM
CACCTGTGTAGAGAGA-1	Myeloid
CAGCCTTAGGATATCA-1	CM
CATGTTTGTAAAGCTA-1	Myeloid
CCTCCCTAGTGAAGGA-1	Fib
TCAGCTCGTACAAATG-1	Fib
CCCACATGTGGCCTTG-1	vSMCs
TACTAGGAGTCTGTGT-1	Fib
TCTCTGGTCGACTATG-1	Lymphoid
AATACGCGTAACTCCA-1	CM
CAACGGCAGTAGTGTA-1	CM
TCACAAGGTTGGCTTA-1	CM
TCTCAGCTCGGCATAT-1	CM
TACCTCGAGAGTTTGA-1	CM
TTAGCTTCAGTCAGAG-1	CM
GGTGAAGGTGCACTTA-1	CM
GCGCCAAGTGCATTCA-1	Fib
GGTGTCGAGCTGCCAC-1	Fib
TGACAACAGTTAGAGT-1	CM
TCGATTTCATTGATGC-1	CM
TACTAGGGTCACATTG-1	CM
CTCGCTAAGAACCCGA-1	Fib
GCTGAGCTCGTCAACA-1	CM
TGAGTCAGTGGAAAGA-1	CM
GTTATTCAGAGGCCTA-1	CM
GAAATGACATCGTGAT-1	Fib
TTGTCTAAGGGTTCTT-1	Fib
TTACCGCTCCGGGCAT-1	Fib
GTGTCAAGTAACCCAT-1	CM
TTGCAGACATTGAACC-1	CM
GCGATCGCAAGACTTC-1	Fib
CAGTATGTCCAGCACG-1	CM
CTCGCTATCGGTCTCT-1	Fib
GAGGTCCCATTACACG-1	CM
TTTGAGGCAAGCACTT-1	CM
ACAGCGCCACTGCTCT-1	Fib
CGCTATCAGCAACGGT-1	Endo
GCACCTTGTACATGGG-1	Fib
TCTAGTTCAACGCACC-1	CM
TCCATCGAGACCCTAT-1	CM
GGAACCCAGATGAGGA-1	CM
AGCCTTCTCGCACCTT-1	CM
TCGGGACCAAGCAATA-1	Myeloid
CGCAATAAGCTGAGGT-1	vSMCs
TGGCAATGTGGATTTC-1	Fib
ACTTTCACAATTGCCA-1	CM
AACGTACTCCGAGAGA-1	Myeloid
ACTACGATCCTTCGAC-1	CM
CTCAGAAGTTTAGGAA-1	CM
CCTTGCAGTACGTAAA-1	CM
ACGTGGCGTTTGCATG-1	CM
ACAAGCTAGAGTAAGG-1	CM
AAAGGGCAGTCCCGCA-1	CM
CATGTTTTCTTCTCTC-1	CM
TAGCGGCGTGTTGGTT-1	CM
CGCTAGGGTCAACTAC-1	CM
GATCATGAGGCCTCGT-1	CM
TGGCGCAAGATCGAGC-1	Fib
CCACGTTGTCCACCAG-1	CM
GCGCCAACATCCCGGA-1	CM
AACGAGGTCCAACCTC-1	Myeloid
CCAGATACACTTTGGA-1	Fib
ACATGCAGTGCGACCT-1	Fib
AGACAAATCGCGCTGA-1	CM
AGTTACGAGGGAAATG-1	Fib
TTGGTCCAGCAGAATT-1	CM
CTGTATTCAGCGTCGT-1	CM
CTCTACGCATTACTCT-1	Myeloid
GCACGCACAATTAGGA-1	Pericyte
CAGCCTTTCCCTAAAG-1	Fib
TGTGACATCTGACATG-1	Neuronal
ATGTCTTCAAGACTTC-1	CM
CCTTGCAGTAGGTCTT-1	Fib
TCAGTCCGTGGACCAA-1	Myeloid
TTCGATTTCTTTATCG-1	CM
GCAGCCATCCACGAGC-1	CM
GCTGTTCCACAACGGA-1	CM
CATTCCGCATACCCGG-1	CM
TGATTTCAGCGAGCTA-1	CM
CCAATGACAGCGTCGT-1	Fib
TGGGTGCCAGGTTATC-1	CM
CTCAGCTCACGCTAAT-1	Fib
CCAATGATCCCTACGT-1	Fib
AACCTTTAGGCTTTAC-1	CM
GGGCCATAGTATAGTG-1	Fib
TTTGAGGTCGATATGC-1	CM
TAAGCCAAGCTCGTTA-1	CM
ATCCTGCCAGGTAACG-1	CM
GTGTCCTTCTTCACTA-1	Fib
TAGACTGGTCAACTGT-1	Pericyte
GCGGTGTAGGATGTAT-1	Fib
TGCATTTTCTGCTACC-1	CM
AACAGTCAGCTATCGT-1	CM
CCACGTTTCGGTCTAA-1	CM
AGGACGACATAGCCAT-1	CM
ACTCGGGTCAGTCAAC-1	CM
GAACCGCCAATCCATG-1	CM
CGCGCAAAGAGGAACA-1	CM
TGTACGAAGTGTGTAA-1	Fib
TTAGGTGGTTACCACA-1	CM
CAGTGTAAGTCTCTAG-1	CM
GGTACCGTCCACTAGA-1	CM
TTACTCAGTACGTAAA-1	CM
GTGTGATTCAACACGT-1	CM
GGTACCGAGAGTTCGG-1	CM
TATTGCTGTAACAATG-1	Endo
ACTGCGGAGTAGAAGG-1	CM
ATCCTCGGTGCCAAGA-1	CM
CCAGAATAGCTGAATA-1	CM
CTACTTATCCTGGAAT-1	CM
GTGCACGAGCCATTCA-1	Fib
ACTCGGGTCCATCGAA-1	Myeloid
TGACAACTCCAGCACG-1	Fib
TGCACCTCACGCGTTG-1	CM
CCATACCTCGCTAGTA-1	CM
CGTACAACACTGCTTC-1	CM
AGTGCCGAGCCGCTGT-1	CM
GAGGCTCGTTGGTAAA-1	Myeloid
AGACAAATCCGTTTCG-1	Endo
AGTTACGGTCAGTGTT-1	Fib
CATAACGAGGACCGAT-1	CM
CTTAATCCAATAGCGG-1	Fib
CGCTGGAGTGGTTCTA-1	Endo
ACTTCCGTCAAGGCCC-1	CM
GCATTCCGTCATGAGG-1	Myeloid
TCAAGCACAAGTTGCT-1	Fib
ACGTTAGGTGCTTCCT-1	vSMCs
ATAGGCTCAATGTAAG-1	Fib
ATGTCGAAGTTATGAG-1	CM
CTGCGTTTCCTTTGCG-1	Fib
CCGTAGGGTGGTAAGC-1	Fib
ACAATCGGTGGTCGAA-1	CM
CTTCCAGTCTCTTCCT-1	CM
AGTCCGGGTGCAAGAC-1	CM
GCCTACTTCTTCTTCC-1	Fib
GCTCACTCAGGGCTTC-1	Fib
TTAGGTGGTTCTACGA-1	Neuronal
CCCTCTCCATCGGCTG-1	Fib
CTGTATTTCTATAGGC-1	Fib
TTGCACCCACTAAACC-1	vSMCs
CCGTACTTCTGGCTAA-1	CM
CACGTTCAGGAACCGT-1	Fib
TGGAAGGTCGCTTACC-1	CM
AGCTGATAGCCAGAAC-1	Endo
TGCCTGTCACTCGTGG-1	CM
ACAGACTAGACGTCAG-1	Fib
GCTGTTCGTCTGTTGA-1	CM
AGTTACGTCAGCACTA-1	Endo
TGCTTTAGTAGCGGTA-1	Fib
AATGGAACAAGGTTCT-1	Myeloid
TACTGCCCAAGGAGGG-1	CM
GGGCCATTCTTACGGA-1	Fib
GTCACAAGTAAACGTA-1	CM
TAGCTTTTCGGCATAT-1	Fib
TCGGGACGTCAGAAGC-1	CM
TACCCTGGTCGAGGTA-1	CM
TTACCCGGTAAGCCGA-1	CM
TACTAGGAGTCGAGCA-1	CM
AGCCTGGGTCTGTGTA-1	Fib
CTGCTCACAGTAAGCG-1	CM
GGATAGGGTGATAAGT-1	Myeloid
ACCTGCTAGTGTCACT-1	CM
GGTTGCGTCAGATACC-1	CM
GAACGTTAGCGTCTGC-1	Fib
CTGGGACGTATGTTCG-1	Endo
TTACTCAAGTCTCTAG-1	Myeloid
ACAGGCCAGTTCGCGC-1	CM
TGCATTTCATATACGC-1	Endo
GTGTCAAAGTCCAGAG-1	CM
GGTCATATCAGGCGCT-1	Endo
TACGGATTCGCAACTA-1	CM
ACTTCCGCACGTTGTA-1	Fib
TGTACGAGTTTGCGAT-1	CM
CCGTGAGAGTTATGAG-1	Fib
GTCCATCCATCCCTCA-1	Fib
TCCGACTGTGAGTCGA-1	Fib
CTACAGAGTTACCACA-1	Fib
TAGTCCCGTCCTCAGG-1	Endo
AAACGAACATTCACGA-1	Fib
TATGTGGTCGCAAACT-1	Fib
ATTACTCGTGAATACA-1	CM
GTCACGGGTTGCTTGA-1	Myeloid
CATTCCGAGCTGATTC-1	CM
GGATAGGAGATTCCGT-1	CM
GTAGACTCAATAGTGA-1	CM
TAGCGGCGTTTGCATG-1	CM
CACCTTGTCCGAATTG-1	CM
TGGGTGCGTGCGTCCA-1	CM
CCTGGGAAGAGGAACA-1	CM
ATATTCCTCTGATCTT-1	CM
CTTCTAAGTGGACAGT-1	CM
GGCGTTGAGTATGGGC-1	Fib
GCAGCTGTCATTGCCC-1	CM
CGCAATAGTAGTAACA-1	Myeloid
GGTAGGAGTTGTATCG-1	Myeloid
AATGTCGAGATGGGAA-1	Myeloid
TAGCGGCGTCACCGCA-1	Myeloid
ACTTTCAGTGCTGGCT-1	CM
TTGCTATCAAGCCCTG-1	Endo
TGTACAGTCGCACCTT-1	CM
ATCCCTGAGGCTTCGC-1	Fib
GGAACCCGTTTGTCTT-1	CM
GCTTAAGTCGGACGAA-1	Fib
CCGAAGCCATGGCCTG-1	Endo
TTGAGTGAGTGTAATG-1	Myeloid
AGCCGCATCTACTTTG-1	CM
TACTGCCTCCAGTTAG-1	CM
CACCTTGCACCCTTTG-1	CM
AACTGTGTCTATGAGC-1	CM
ATTACTCAGATGCGCA-1	Fib
TGTGTCCGTTTCACCC-1	Fib
AAACTCGCAATTGCCA-1	Endo
GATGATCAGGTTACAA-1	Endo
TGTACAGAGTGATTAG-1	vSMCs
TCTCAGCGTAGGTGAC-1	CM
GAAATGATCGTTTGAG-1	Fib
AACAGTCAGGCCAATG-1	CM
ACGGATTCACCGTCTT-1	CM
TGATGCACAATTGCCA-1	CM
AACAAAGGTTTCGATG-1	CM
AGCTGATGTTACCACA-1	Fib
TAGACTGTCCGAGAGA-1	Fib
CCACAGGTCCAGTTAG-1	CM
ATTACTCGTCATAGAA-1	CM
CGCTATCTCCATTGAG-1	Fib
CTGGGACGTTCTACGA-1	Endo
GACTAGTGTGCTAGTT-1	CM
GTTATTCCAGTAGGCA-1	Fib
GTAGTACGTATCCCTC-1	Fib
TGAATCGCAGATGGCA-1	Lymphoid
TGGCAATTCGACTTAG-1	Fib
GCAGCCATCGATAGGG-1	Fib
GGAGGATTCATTCATC-1	CM
CCTTGGTTCGTCCCTA-1	Endo
GCTGCGAAGCATTCCA-1	Myeloid
TAGCATGAGTACCACT-1	Endo
ATAGGCTGTCATGAGG-1	CM
GTCCATCGTTAGGAGC-1	CM
TGCTCGTGTTCGGGAA-1	Pericyte
GCGCATGCAACTCAAC-1	CM
TTACTCATCCCGCAAG-1	Fib
CTGGCAGCATCCATAG-1	Endo
TTCATCAGTAGGTGAC-1	CM
CGGTGCATCTCGCGTT-1	Myeloid
ATCCCTGTCTCCCTTT-1	Fib
TGCTCGTTCTCGTAGA-1	vSMCs
AAACGAACAATTCTCT-1	Fib
CATAACGCAACTACTG-1	Fib
AACTTGGTCTCGCGGA-1	Fib
ATTACCTAGCTTCAAC-1	Fib
TCAGGTAGTCCAAGAG-1	CM
GGTGCTGTCTCCAACC-1	Fib
GTAATCGTCTGACATG-1	Neuronal
GCATGATGTCTAACCA-1	Lymphoid
GCGGTGTTCTGGCACG-1	CM
ACAGCGCTCTTAAGCG-1	Lymphoid
CTAGCGGAGAACCATA-1	CM
TCCGACTAGTTGTCCA-1	Fib
CTGTTCGAGTTCAAGA-1	Fib
GCTGTTCAGTCTCGAT-1	Fib
TTTGGCCGTCTAAGAA-1	CM
CCCTCTCAGTTAGAGT-1	CM
GTCACCTGTTCGGGAA-1	CM
GAAGAGCTCGCTAGTA-1	CM
AACAAAGCATTACCTT-1	CM
TCGAGCGCACTCAAGT-1	CM
TTTGGTTCATTAGCCA-1	CM
GTCTACCAGTCTCGAT-1	Endo
TACGGATTCCGAATTG-1	Fib
GAGGCTCTCAGGCCGT-1	CM
GGAATCTGTTAACCGT-1	Fib
TTACTCAGTTTGCGAT-1	Fib
GGAATCTGTTTGTCTT-1	Endo
CACCTGTTCAGTTGAC-1	Endo
TGCTCACAGCTAACAA-1	Endo
AGATAGACATCGAGTT-1	CM
CTGTTCGAGGGAAGCG-1	Fib
GCCCGAATCTGGCTAA-1	Fib
GGGACCTGTTTCGACA-1	Fib
TACCTATAGTATAGTG-1	CM
TGATGCAGTAGCGTTT-1	Fib
GAAACAAAGATTACGA-1	CM
ACAAACCGTACTATGC-1	Fib
TCGAGCGTCCTAAAGC-1	Myeloid
GCTGTTCGTAATGTAG-1	CM
GACCTTCAGATTCCGT-1	CM
TCTAGTTTCACTGATG-1	CM
TTCAACTAGGGTCTGA-1	Endo
AAGGTTCGTGAGTAAT-1	Endo
ACCAAACCAACGGGTA-1	CM
TTGAGTGTCGCCGAAC-1	CM
CACATGAGTGCGCTCA-1	Fib
AGCCTTCGTTAAGGGC-1	Endo
CTACTTAAGTTATGAG-1	Fib
TGGTCAAAGAGATTAC-1	Fib
ATGCATGAGTCGAGCA-1	Fib
TTTGCGCAGTAGCAAT-1	Myeloid
CTTGCTGCAAAGGTCG-1	CM
TACGCCTGTTCCCGGA-1	Endo
AACCTGATCTCCTTAA-1	Myeloid
CTCAGAAAGGTTCTCA-1	CM
CAAGGCCGTAGAAGCC-1	CM
CTACAGAGTCATGAGG-1	CM
CCCGTTACAACAAACA-1	Fib
GTGTCAATCTTAATCC-1	Endo
CAGTATGGTCAGAAGC-1	Endo
GTAGACTCATCAACTG-1	Fib
GGCGAAACAAGCCCTG-1	Fib
GGCACGTGTGCAAGCA-1	CM
CTCAGAAAGAGCAGCT-1	Fib
GAGTGAGGTCCCTTTG-1	CM
CAGTGCGAGAGCGGTT-1	CM
TTCGGTCAGTGCCCTG-1	Fib
TAGCACATCCTTCGAC-1	Fib
CTCAGAAGTAACAATG-1	CM
GCAGATTAGTGGGACT-1	Fib
GCGTAGCCATGGGACA-1	Fib
ATCCCTGTCTGGGCGT-1	CM
GAAAGTAGTTATGCAC-1	Fib
ACTATTCTCGAGGTCC-1	CM
TTACCCGGTCCCTAAA-1	Pericyte
GGAGAACAGGAGTACC-1	Fib
AACTTGGTCAGGCCGT-1	CM
GGAACCCGTTCCCAAA-1	Fib
GGCGTTGGTCACAGGA-1	Myeloid
GCGAGAATCGCTAGTA-1	Fib
TTCGCGTTCGGGCTCA-1	Endo
GGATAGGTCCGAATTG-1	Fib
TACTGCCCACAGAAGC-1	Fib
TCACCACCAAGGAGGG-1	Fib
TTGCCCAAGAGGCCTA-1	Myeloid
AGGCGTCGTGGTTCTA-1	Myeloid
GGGTTATTCCCAGTAA-1	Fib
GAAACAACAGATAAGT-1	CM
AGCCAGCAGATTAGAC-1	CM
AGATAGACACAGTTCA-1	vSMCs
CACAACAAGAAATGGG-1	CM
GAACGTTGTATGAAGT-1	Fib
GAGTGAGAGAAAGGGT-1	Fib
CCTAAAGGTGAGCTAG-1	Myeloid
CATGTTTTCTTCGTTA-1	Myeloid
ATCCTGCTCGAACACT-1	Fib
TTGTCTAGTCTGGTTA-1	CM
ATCCTGCGTTCCTATT-1	CM
CCCTAGTTCTAGCAGT-1	vSMCs
ACCGAATAGTAATGTG-1	Myeloid
GTTGGTACACAGATGG-1	CM
ATCGAGTCACGATATC-1	CM
GCAGCCAGTAGTCTGT-1	Fib
CATTCCGAGGTCTTGT-1	Fib
CGGACCAGTCCTATTT-1	CM
GGGTTATCAAGTAACA-1	CM
AGTGCCGTCCATAACG-1	CM
TCTAGTTCAGGTTATC-1	CM
CAGTGCGTCGATTACG-1	Fib
TTGCACCAGGTCACTT-1	Fib
AGTGCGCGTGATCAGG-1	Myeloid
ACCAAACAGCTCCGGT-1	Fib
TATCTGTTCACTCGGG-1	vSMCs
TCACCACTCCAGTTAG-1	Myeloid
AACTGGTAGTACAGTA-1	CM
TTAGCTTGTTTGTGAC-1	CM
CCGTAGGGTTGGACGA-1	Fib
TGGACATAGGTTCTCA-1	Fib
GCAAAGGTCACTTACT-1	Fib
GGTGTCGAGGCACCTC-1	Pericyte
TTCAACTTCCATCTAT-1	vSMCs
ACAGCGCCAAACCTAC-1	Endo
CCGTAGGAGATGTTCC-1	CM
AGCCGCAAGAAGCCTG-1	Fib
GACCGACTCCGATTGA-1	Endo
TGAGCCGAGAGCCTGA-1	CM
CATTCATGTGCTTTGA-1	CM
TGATGCAAGCACCATT-1	Lymphoid
TTGCTTAAGGAAGAAC-1	Myeloid
ACAAGCTAGACCATAA-1	Myeloid
TCAGCTCAGAACAGGA-1	Myeloid
TCCAGAAAGAACCATA-1	Endo
GACTAGTCACGCTGTG-1	CM
TGCTATTGTGGATTCT-1	Fib
TTTGTGTAGCAGAATT-1	Fib
TCCGACTCAGTAAGCG-1	Fib
TGTGTCCTCTACTGCC-1	CM
GGTGTCGTCTGTTTAC-1	CM
CCCTGATTCCATACGA-1	CM
TAGGTGTGTTCCTATT-1	CM
TGACAACTCGTGGAAG-1	Fib
AACAAAGCATCGTACA-1	Myeloid
AACCTTTAGTTGCCGC-1	CM
TCACCACGTAACACTC-1	Endo
GGGAACACAGCTATAC-1	Endo
GTCACAAGTATGTTCG-1	Lymphoid
TCGGGACGTCCATTGA-1	Myeloid
GCAGCCACAGGATGTG-1	CM
CTTGTCGTCACACGTA-1	Fib
TAGACTGCACTCCTCA-1	Myeloid
AAACTCGGTAGTCCAT-1	CM
CAGCCTTTCGGTTAGT-1	Myeloid
CCTTGGTTCACGTGTA-1	CM
ATCCAGATCCGTTTCG-1	CM
TGATTTCCACTCCACT-1	CM
GCTCAGGCACTAGGAG-1	Fib
GTGATCAGTTGGTAAA-1	Fib
CAGGATTCAGATTTGC-1	Pericyte
GTGTCCTAGTGTCGCC-1	CM
CTCATGCCAATGGTAA-1	CM
CCTGGGATCTGATCCC-1	Pericyte
TAACTTCCACATCATG-1	Myeloid
ACAGGCCGTATCTCAG-1	CM
CAGCTAACAGACTAAA-1	Fib
AAATGAGTCACTGATG-1	Myeloid
ACTGTCCCACTGAAGG-1	Neuronal
GCAAAGGGTAGAGAGA-1	Fib
TTACTTGTCGTCTAGA-1	Fib
CGCTAGGAGACCCTAT-1	Myeloid
GATCATGTCACAACAC-1	Endo
TCTCTGGAGTTCAAGA-1	Myeloid
CAACCAAGTCAACAGG-1	Lymphoid
AGCGTATCATAGACGG-1	Pericyte
GCTCACTCATGGGAAC-1	Fib
TACATTCCAAGTAATG-1	Myeloid
TTGACGAGTTCCCGGA-1	Fib
TTACCGCCATTTGTTC-1	Fib
TGAGCCGAGGTTCTCA-1	CM
AACATCGCATAGCAGG-1	CM
ACCGCAGGTGCATTCA-1	Lymphoid
TACAGCACAACGTCGC-1	CM
ACAAGCTAGCGCGTTC-1	CM
ACGGATTCATGGAGGT-1	Fib
TCGAGCGAGAGAGTAG-1	Fib
CCAGAATAGGTTCGTT-1	CM
GGTTGCGGTATTCTTC-1	Fib
CTTTGCGCAAGGACCA-1	Fib
TTGTTCATCGGGAATG-1	Myeloid
GGGTGTCCACAGGAAC-1	Myeloid
TATTGCTCAATTAGGA-1	Fib
GTGGCGTGTCTGCGCA-1	Fib
GCAAAGGCACATCATG-1	Fib
ATAGTCGAGAGAAGCA-1	Fib
GCTTTCGTCAGAGTGG-1	Fib
GTGTGATCAGTAACGG-1	Myeloid
TTTACGTTCGCTACCT-1	Fib
GAAGTGGGTTCCCGGA-1	Fib
TGCGTAACACCATTCC-1	Fib
ATAGTCGCAAGCAACG-1	Fib
CACCACTGTGAATCGG-1	CM
GTTACTTCATGCGCTG-1	Endo
GATCATGAGGCAGTAC-1	Lymphoid
GGGTCTGTCTCTATTG-1	Myeloid
AACTGTGAGGGTATCG-1	Fib
ACTGCAATCGGGAATG-1	Pericyte
TCTCTGGCACTTGCGG-1	Fib
TCAGTCCGTCAACGGA-1	Myeloid
GGAATCTGTCTGCACG-1	Myeloid
ACAGCGCTCGCAGATT-1	Myeloid
TCAAGCACAAGTTCGT-1	Myeloid
CACCACTTCGATGTGT-1	Fib
GTTCAAGTCTTGTCAT-1	CM
TTTGGTTTCAGAGTGG-1	Endo
GGACACCCATGCGACC-1	Fib
TGGGTTAGTACGTATC-1	CM
AGCGTATAGTACAGAT-1	Fib
TGCATTTCATGGGACA-1	CM
ACAAACCAGACTAGCG-1	Fib
CATGCCTAGTCGTATC-1	CM
GTTGGGCCAATCCATG-1	CM
CAACCAAGTAAGGTCG-1	CM
CATGTTTTCGCTGATA-1	vSMCs
GGAGTAGCACTTGCGG-1	Myeloid
CGGTGCATCTTGCGCT-1	vSMCs
CCAATGATCTTCCAGC-1	Fib
AGCTGTACACGCGATC-1	CM
CAGGATTCAGCTTACA-1	Myeloid
TGTACGAAGTGAGCAC-1	CM
ATAGGCTGTACTTCGA-1	Fib
GCTCCTATCACGTCAA-1	Fib
CTAGCGGTCACTTACT-1	CM
GGTCATAAGTCAACTC-1	Endo
AGTCCGGGTGATAGAT-1	Fib
CATTCCGTCTGGCCAG-1	Fib
ATTGTGGCAGGGAGTT-1	Lymphoid
CCTCCCTGTGCTTTGA-1	Endo
GTGCTGGAGATGCGCA-1	CM
ACTGCGGGTGTTTCTT-1	Fib
GCAACCGGTAACCGAG-1	Fib
CAGCTAATCTGATCCC-1	Myeloid
CTAGGGCGTCTAAGAA-1	Myeloid
GGGCCATAGTAATCAG-1	Endo
TTGAGCAGTTGCTTGA-1	Fib
GAGGTCCCAGCGTCGT-1	Myeloid
AGTGCGCTCGCTGATA-1	CM
GACCAATAGTATACGA-1	Fib
TGCCTGTAGCAACTGG-1	Myeloid
ACATGCAGTGAATACA-1	Fib
TACTAGGAGACGAAAG-1	CM
TGATCAGGTGGTGGTA-1	Endo
CAGCCTTGTATCGCGC-1	Myeloid
TTCGGTCAGGACTTTC-1	Pericyte
GTGTCCTTCGCTTGAA-1	Fib
ACTGCGGTCCATGTTT-1	CM
TTTGCGCAGTATCTGC-1	Fib
AGATAGACAATGGTAA-1	Lymphoid
GGAACCCCATGGGAAC-1	CM
CTCATGCCAACTTGGT-1	Myeloid
CCGAAGCAGCCTCGCA-1	Fib
TACTGCCAGCAGGAGG-1	Endo
AACGGGAAGATCGAGC-1	CM
CTTGTCGCAGGGAGTT-1	Pericyte
TGTGGCGAGAGTCCGA-1	Fib
TCCGACTGTGTGCTTA-1	CM
TGGCAATGTAGCGTTT-1	Pericyte
CAGTGCGAGAGCCACA-1	Fib
TTACGGATCGGGTCCA-1	CM
TATTGCTAGATCTAAG-1	Lymphoid
TTAGGTGGTCTGTTGA-1	CM
ATTACCTTCGTATAGC-1	Fib
GCCCAGAAGCCTTTGA-1	Fib
ACGTTAGGTTTCTTAC-1	Fib
ACATGCACACATTCTT-1	Fib
ACTGTCCTCGCTCTAC-1	Endo
CATTCCGAGTTAGCAA-1	Myeloid
GAAATGACATACTGCA-1	vSMCs
ATTGTCTCACTGCTTC-1	Myeloid
TAAGCCAAGTAGTTCC-1	Myeloid
GCAAAGGTCGGTAGGA-1	Fib
AAAGGGCAGTCAGCCC-1	Lymphoid
CTCAACCGTACTTGAC-1	Lymphoid
CTCTCGACAACCTCTC-1	Endo
CACATGATCGCCTTAC-1	Myeloid
AGTGTACGTTTGACCA-1	CM
GGCGAAAGTCACAGGA-1	Fib
TTGGTCCCAGCAAACG-1	Myeloid
GCGAGTCAGCGGACAT-1	Fib
CACAGATGTCGAGAAC-1	Pericyte
TAAGCCATCGGTCAGC-1	CM
GCCCGAACACGATATC-1	Fib
TGTTAGGAGTGCAACG-1	Endo
GGCACGTTCTGAAAGA-1	Pericyte
TACGCAATCTCGACCT-1	Fib
ACCCAAAAGATAGGTT-1	Fib
GACCGACAGGGCGAAG-1	Lymphoid
CTGGCAGAGAGCCACA-1	Fib
ACAGGCCCAACGTCCG-1	Fib
AGCGATTAGAGCTCCC-1	Fib
TTGCACCTCCCTACGT-1	CM
TGATCAGAGGCTCCTG-1	Lymphoid
TTGAGTGGTTTCTTAC-1	Fib
AAAGGATTCAAACCCA-1	Fib
GTTATGGGTACGGATG-1	CM
TTATGTCTCACATCCC-1	CM
CAGGGCTTCGGGATCC-1	CM
GTGTCCTTCGTCTAGA-1	Endo
AACGAGGCATCGACCG-1	Endo
GTTACTTAGCCTGTAT-1	Fib
TCTCTGGCAGAGAGAA-1	Myeloid
GAACGTTCAAGGTCGA-1	Fib
AGCTGATCACTAGCCG-1	Myeloid
CGAGTTACAGAACAGC-1	Myeloid
CTGCGTTCAAGAAACT-1	Lymphoid
TCTATTGAGCTCCATA-1	Endo
AGCGATTGTAGCATGG-1	Fib
CAGGATTTCAAACCAC-1	Pericyte
CACCTTGGTAGTCTGT-1	CM
ACATGCATCCAGGGAA-1	CM
TTCGCGTTCATCGCTC-1	CM
ACTATTCAGATGGCAC-1	CM
GTTATTCTCGCGTTCT-1	Neuronal
TGGACATCAGAGAGAA-1	vSMCs
CAGTGCGAGGAGTCTG-1	Fib
AAATGAGAGACCATAA-1	Lymphoid
AAACGAATCATGTTCT-1	Myeloid
TGTTAGGGTCAGGCTC-1	CM
ACCGCAGCATTAGCCA-1	CM
GGTACCGGTCAAGACG-1	Fib
GCTTTCGTCGAACCGC-1	CM
ACAGCGCGTGGAAAGA-1	Lymphoid
CTTTGCGTCTTTCGAT-1	Fib
ACCGCAGTCTTCACTA-1	Fib
CTAGGGCTCCGCTCTA-1	Endo
ACAATCGTCATTCTCA-1	Fib
TTGACGAGTGGCCTCA-1	CM
ATTGTGGTCGAGCGCT-1	CM
TTCGGTCGTAGCAGGT-1	Lymphoid
AACTTGGAGTGTTCCA-1	Fib
ACTGCAAAGGACTTTC-1	CM
TAGGAGGGTGATAACA-1	Fib
GGAGGATTCGTCTTAT-1	Myeloid
CGCTGGAGTCCCTTTG-1	CM
CCCTGATCATGCTATG-1	Myeloid
TTGCAGATCGGATCGC-1	Endo
TGCGTAAAGGGTTCCC-1	Myeloid
TCAATTCAGCGCATTT-1	Fib
CGCTGGAGTTAACCAC-1	Myeloid
ACCATCCCAGTTGCAT-1	Fib
ACTAGGTGTATATGGA-1	Lymphoid
AGGACGATCGTTCAGA-1	Fib
TCTATTGTCCATACGA-1	Fib
GCTCCTACAAGGAACC-1	Fib
GCAGCCATCAAGTTGC-1	Fib
AACGTACCACCACAGC-1	Lymphoid
TACCCTGTCTGTGTGA-1	Myeloid
AACCGATGTAGAATAC-1	Endo
CCCTGATGTCTGTGTA-1	Myeloid
ACAAAGACAACTACTG-1	CM
AGTGTACGTAGGTAAT-1	Endo
TTCGGTCTCTATCCTA-1	Lymphoid
TAGCCGGAGTTGTCCA-1	Endo
TGTTAGGCAATGCCAT-1	CM
CCAATGACATACCCGG-1	Fib
CAGGGCTTCAAGAGAT-1	Fib
ACAATCGCAGCGCGTT-1	Pericyte
TATCGAGGTAGGGTTG-1	Myeloid
CCTCCCTGTATTCGAC-1	Fib
CGATGATGTGGCATAG-1	Myeloid
ATTGTCTTCTATCCTA-1	Fib
CTTGCTGCAAATGCTC-1	Pericyte
ACCGGGTCACTGATTG-1	Neuronal
TATCTGTGTATCAGCT-1	Fib
CTCACCACAAATGCTC-1	Fib
GTTATTCAGTCCTTCC-1	Myeloid
GGATAGGCAATTGCCA-1	Fib
TATGTTCAGAGGTACC-1	Endo
AACGGGACATGCGTTA-1	Fib
TACCCTGCAGTAGTCT-1	Endo
TCGCCTACAGGTTATC-1	vSMCs
CCTTGGTAGGCACCTC-1	Endo
GCGGTGTAGCCTCGCA-1	Endo
TGGCCTTCAGCAACCC-1	Fib
TGGCAATAGCATACCT-1	Myeloid
GCGTTGGAGTCATCTG-1	Fib
TGGTCAATCGCCTTAC-1	CM
CCTAAAGAGTTAGCGG-1	Endo
GACTAACAGCTTCAAC-1	Endo
TCCAGAATCTTCTCTC-1	CM
CAGTATGTCTTTCGAT-1	Myeloid
GTAGGAGTCCACGCTT-1	Endo
ATAGGCTCAAGATGCG-1	Endo
TTAGCGAAGAACTAAC-1	Lymphoid
AGCTGTACAAATGTCC-1	Fib
CACTAAGAGGCAGTGT-1	Fib
AACTGTGTCTTAAGCG-1	Fib
ATTGTCTCACTCCACT-1	Fib
AGTTACGCAACGTAGG-1	Fib
GTGTCAATCTTACGGA-1	Myeloid
GACTAACAGAACAGGA-1	Pericyte
GCATGATAGCGCATTT-1	Endo
GGTACCGGTAGCGAGT-1	Fib
TTGCGGGAGCACCATT-1	Lymphoid
CGCTGGAAGGGCGAAG-1	Myeloid
TCTATTGTCGGCTATA-1	Lymphoid
TTGAGCAGTAATGTGA-1	CM
GTGATCACAGCGCGTT-1	CM
GCCATAATCGGCATAT-1	Myeloid
CCACGTTGTCCTTCAC-1	Myeloid
CAACGTATCACTGATG-1	CM
CTGGGACAGTGCAACG-1	CM
ACAAGCTTCATCGCCT-1	Endo
TATCGAGTCGATCGCG-1	Endo
ACCTGCTTCAGAGTGG-1	Myeloid
CAGGGCTGTACGGTTT-1	CM
ACTGCAACAAATTCCG-1	CM
GTTCAAGCAACATAAG-1	Fib
AACCAACCATTCACGA-1	Endo
GCGATCGGTGCGTCCA-1	Myeloid
ACAAAGACAACGTCCG-1	Myeloid
AGCCGCAGTCATTGCA-1	Fib
TCAGGTAGTAACAATG-1	Pericyte
TCGGGACTCAGATACC-1	Fib
GGAACTTTCCTAAGTG-1	CM
ACTTCCGAGGCAGATC-1	CM
TTAGCTTGTACGCAAG-1	Myeloid
TTGCACCGTTGAATAG-1	CM
TTGCACCGTTTAGACC-1	Myeloid
CTGCGTTTCTCTATTG-1	Myeloid
GTTATTCGTGCAAGCA-1	Lymphoid
CCTATTAAGAGCTGTG-1	Fib
CTTGTCGTCCCGGGTA-1	Endo
CCAGAATGTTCTACCC-1	Fib
TTTGGCCTCCGAATTG-1	CM
GGTACCGTCATTCATC-1	Fib
CGTACAATCGAGTGTT-1	Fib
GCGTTGGCAGATAAGT-1	Fib
CTTGCTGAGCTAGTTC-1	Fib
CTTCCAGGTATCGCGC-1	Endo
GCTCAGGGTCGAGAAC-1	Endo
AGCCTGGAGTGCTAGG-1	Fib
GGGTGTCAGTGGTGTG-1	Fib
ATGTACGAGACAACGC-1	Fib
AGCTGTACAAGGAAGA-1	Lymphoid
CGCTGGATCCGCGATG-1	CM
TAACAGCAGGAGAACA-1	Myeloid
CACATGAAGGGCTCTC-1	Neuronal
AACGGGAAGTGATTAG-1	Lymphoid
TCAGGGCGTGGAGTGT-1	Myeloid
TGCTCACAGCCATGGA-1	Myeloid
TAGGTGTCATGGCCGT-1	Myeloid
CCGTACTTCTATTTCG-1	Fib
GGTAGGATCAGTCAAC-1	Lymphoid
CCGTGAGTCGGCAATT-1	CM
CTGGCAGGTGATTCCA-1	Myeloid
AGGCCTGGTCATTGCA-1	Fib
CCACAGGTCGGATAGG-1	Pericyte
GTGTCAACATCAGAAA-1	Pericyte
TTCATCAAGATGGGAA-1	CM
ACCATCCAGGTTGTGG-1	Fib
CCGAAGCTCTTCAGAG-1	Fib
CTGCGTTTCATTCTTG-1	Pericyte
CGCACAGGTACGAGAC-1	Fib
AACGTACGTCCGTAGC-1	Fib
TCTAGTTGTCTGATTG-1	Fib
CCAGAATAGCTACGTT-1	Pericyte
ATAGGCTCAATTCGTG-1	Fib
CTGTTCGTCATCGCAA-1	Fib
TGAGCCGTCCGTACGG-1	Fib
GTGCACGGTTGGCTAT-1	Fib
TCTCAGCAGAAATCTG-1	Endo
GGTGCTGTCACACGTA-1	Myeloid
ACTAACGTCCATACGA-1	Fib
CCATACCGTTTCCGGG-1	Fib
GTCACCTAGCTAACAA-1	Pericyte
GCGCCAAGTAACCCAT-1	Myeloid
TCTCTGGAGAGCGAAA-1	CM
TAGTCCCTCTGTGTGA-1	Neuronal
GATCGTAAGGTTGTTC-1	Pericyte
TTCTAACGTCTGGGAA-1	Pericyte
AACTGTGGTCCTTATT-1	Myeloid
GCAAAGGAGGGTGTTG-1	Endo
CTGTATTAGCAGAGCT-1	Endo
CTGGGACGTATCTAGC-1	Fib
GGTCATATCAATTGGC-1	Lymphoid
TAGCCCTGTTCGGGAA-1	CM
CATTGGATCGATAGGG-1	vSMCs
GCGCATGAGACGCCAA-1	CM
TAGCATGCACTGATTG-1	Myeloid
CACTAAGAGGTGTCGA-1	Fib
GATCGTAAGAGCGGTT-1	Lymphoid
AAACTCGCAAATGTCC-1	CM
TCAGGTAGTTTAGAAG-1	CM
ACTATTCCACGCGTTG-1	Endo
GCGGGTTGTATCAGCT-1	Fib
GGGTTATAGGCGTAGT-1	Endo
TAGCTTTGTTCCGGCA-1	Myeloid
TACAGCAGTATGCTAC-1	Fib
CCATACCGTACGCCCA-1	Pericyte
TGGGTGCAGAAACGCC-1	Fib
GCGCATGCATTCTTTG-1	CM
AGCCCGACAGTTGGAG-1	Lymphoid
TGATGCACATGGGACA-1	Fib
CAATCCCAGAGCTGTG-1	Fib
TAAGTGCTCTGTGTCC-1	Pericyte
TCAATTCCAAAGGAAG-1	Fib
TTCATTGGTCCCGAGT-1	vSMCs
ACAAACCAGTCTCCAA-1	Pericyte
GGGTGTCGTTAGAGAT-1	Pericyte
GCCCGAAGTCCCTTTG-1	Fib
TAGCGGCGTTACTTTC-1	Myeloid
GGTGTCGCACCTATTT-1	Endo
ACTTTCAAGTGAGTTA-1	Myeloid
AGTCAACGTACTAGAA-1	Pericyte
TTACGTTAGAGAGGTA-1	Endo
GCGTTGGGTCAGTGTT-1	CM
CCCTAGTAGTGGACGT-1	Lymphoid
ATGGATCGTGCGCATC-1	CM
GGTGCTGTCGGGAATG-1	CM
GACTAACCAGGATGTG-1	Lymphoid
TAGCACAAGATCGAGC-1	Fib
TAGACTGTCTGTGTGA-1	Fib
GCACGCAAGAACGCCA-1	Endo
TAGACTGAGCAGAATT-1	Fib
AATGGCTTCAGGGTTT-1	Myeloid
CCCTCTCAGTTACACC-1	Fib
AAATGAGCACTAGCCG-1	Endo
CCTTAATTCCAAGAGG-1	Myeloid
GCTCACTAGTCACACT-1	Myeloid
AAATGCCCACGCGATC-1	Myeloid
GCATTCCCATCCCGGA-1	Myeloid
GAATCTGCAGATTAAG-1	Fib
AGCTGATAGGTAGGAA-1	Pericyte
ATTTGTCGTTATGCAC-1	Fib
TTTGCGCAGGCACTAG-1	Lymphoid
TGAATCGGTAACCATC-1	Myeloid
CTCTAGCTCGAGGCTC-1	Fib
TTTGGCCGTAGCTGTT-1	Endo
CTTCTAAGTAGTACAA-1	Myeloid
GAAGAGCTCCTGTAGA-1	Fib
AGGCGAACATCCTGGG-1	Myeloid
ATCCAGACAAAGCATA-1	Myeloid
GAAGTGGGTGAGCTAG-1	Lymphoid
TTCGCGTAGGCCTAAG-1	Myeloid
GCGGGTTGTTAAGGGC-1	Fib
CCATACCTCCAGGTAT-1	Myeloid
GAACCTAGTGCACCCA-1	Pericyte
GGGTCTGTCATCGCCT-1	Myeloid
AAATGCCGTGTGACCC-1	Lymphoid
CCTAAAGGTCGAGGAT-1	Myeloid
TTGAGCAAGGTAAGCC-1	Lymphoid
CGTACAATCCGGAAAG-1	Myeloid
TTGCAGACAGAGCCAA-1	Endo
CACCTTGGTACTAGAA-1	Fib
TATGTGGGTGCGTCCA-1	Myeloid
CTTGCTGTCCCGTATC-1	Fib
GTTACGACAAGCGGTA-1	Lymphoid
TAGGAGGTCCAGGCCA-1	CM
TTTGCGCAGAGTTTGA-1	Lymphoid
CCGTGAGTCTACCCGT-1	Pericyte
CAGCCTTCAGGTGGTA-1	CM
TTACTCATCGGTCTAA-1	CM
TACGCAACACCACCAG-1	Fib
TTGAGTGAGCTGATTC-1	Fib
GGCGTTGTCGGGATCC-1	Endo
AGATAGAAGTACCCAT-1	CM
GTTGGGCCAGCGTCGT-1	Endo
GCCCAGAAGAAAGGGT-1	Fib
CTAGGGCCAAATTCCG-1	Endo
TAAGTGCGTCAGGTGA-1	Endo
ATATTCCGTTATCGAC-1	CM
GATGATCTCGGAAAGC-1	CM
CTAACTTCAAGGAACC-1	Fib
CACCTGTCAACTACTG-1	Fib
CTGTATTTCTCTGACC-1	Endo
TAATCGGGTGCAAAGC-1	CM
CCGTAGGGTTAACCAC-1	Lymphoid
ACAGCGCTCGCGGCAT-1	Pericyte
GCACGGTAGAAACGCC-1	Fib
TGCTATTTCTTCAGAG-1	Lymphoid
CTTCCAGGTCGTAGTT-1	CM
GCACGCACATTGCGAT-1	Pericyte
GTTCAAGAGGGTCTGA-1	Fib
GTCACAACAGTGGTCC-1	CM
CGTAAACGTTATCGAC-1	Lymphoid
ACGGATTAGGATTAAC-1	Endo
TCAGGGCCACTGTAAC-1	Endo
ACGTTAGCAGAAGTGC-1	Lymphoid
TGGCCTTCAGTAGTTC-1	CM
GTCGTAACAGCGCGTT-1	Fib
TTCTAACCAGGCATTT-1	Myeloid
GATGATCAGGGACGTT-1	Fib
TACGCAAGTTCTGAGT-1	Myeloid
AAATGAGCATTATGGC-1	CM
GAAGAGCGTGCATCAT-1	Fib
GGCATTACACGCCGAT-1	Fib
TGATTTCAGGCGCTTC-1	Endo
CAGCCTTGTTTGCGAT-1	Myeloid
CGAGTTAAGGGTAATT-1	Fib
TTATGTCGTTGTCGGC-1	Lymphoid
GCCAGCAAGCTAGCAG-1	Pericyte
TCACAGAGTCTGTGTA-1	CM
TAATTCCCAACGTCCG-1	CM
ATTTGTCGTAGAGAGA-1	Fib
TAACTTCCAGGGCTTC-1	CM
TCAGTCCCAAGACACG-1	Fib
AGGCCTGGTACGGATG-1	Fib
CCAGATAGTTGCCTGG-1	Fib
ACAAAGAGTATCATGC-1	Fib
ACCATCCTCTTACGGA-1	Myeloid
CCACAGGGTCAGAAAT-1	CM
GTGCCAGGTCAGGTGA-1	Myeloid
GGCATTAAGGGATCCA-1	Fib
GAATCTGTCTTCGTTA-1	Fib
TCACCTGTCACAAGCT-1	Myeloid
GGGCCATCAACGTCGC-1	Myeloid
TGGGTTATCGCAAACT-1	Fib
ATGGATCCACTTTGGA-1	Fib
GACTAGTCATCCCTCA-1	Endo
CACAACACAACTGCGC-1	Fib
TCTCAGCTCTACCCGT-1	Myeloid
TGGCGCAAGCGTCTGC-1	Fib
TACGGATTCTCTGAGA-1	Fib
TGTACGAAGTTACCAC-1	Fib
AGCTGTATCTCCCTTT-1	Endo
CTGTATTAGATCGATA-1	Pericyte
CACAGATCACTTACAG-1	Pericyte
AACGAGGTCGGGACAA-1	Fib
CTAGCGGCAGTAACGG-1	Endo
GAACGTTTCCCACTTG-1	Pericyte
CGCGCAAAGTATCTGC-1	Lymphoid
AACCAACCACCTATTT-1	Endo
GTCTACCGTTGGAGGT-1	Endo
AAACTGCCACTGAAGG-1	Fib
TGGGTTACACTGTAAC-1	Endo
TAGCGGCCAACTACTG-1	Endo
TGGCCTTAGCTAGTTC-1	Endo
CAATCCCAGCATACCT-1	Fib
GAGATTCAGGGATCCA-1	Fib
TATGTGGCATACCCGG-1	Pericyte
GCGCATGGTATTCGCA-1	Fib
TTCGATTCAGGCACAA-1	Lymphoid
TTTGGTTCAACTAGAA-1	Pericyte
TCGATTTAGTACTCTG-1	Fib
AACATCGAGGCCTAAG-1	Fib
TAGGTGTAGTGTAATG-1	Fib
GTTGGGCGTGGTACTT-1	Lymphoid
GAACCGCAGGAGAACA-1	Myeloid
GAGCGCTGTGTCGTCG-1	Myeloid
TTCATCAAGCTGAAAT-1	Fib
TCCATCGGTATTTGCG-1	Endo
CTTGTCGGTACAAATG-1	Lymphoid
TAGCGGCGTTCCCAAA-1	CM
TCGAGCGAGCCATTCA-1	Myeloid
TCACCACAGTCGTACT-1	Myeloid
GGCGAAAGTTCTACCC-1	Pericyte
AGGCCTGGTGCCCAGT-1	Lymphoid
GGATGAGGTGCTGGCT-1	Endo
TGCCTCACATGGGTGA-1	Fib
ACCCAAATCGTGTGCG-1	Endo
ACTCGGGGTAAGCCTT-1	Pericyte
CATGTTTGTAGACGCA-1	Fib
CCCAGAGTCCCTACGT-1	Lymphoid
TACTCGCCACCTCGTT-1	CM
CTGTTCGCAAGATGCG-1	Endo
CAAGGCCAGTAGTGTA-1	CM
ATAGTCGGTCGATAGG-1	Myeloid
CTGGCAGCACTGTTAG-1	Fib
GATTAGCGTTCGGGAA-1	Lymphoid
ACATGGTGTGCATTCA-1	Fib
TAGGTGTAGCGCGTTC-1	Myeloid
TATCTGTCAGTTAAAG-1	CM
TAGGTCACATTACCTT-1	Fib
CACTGAACATCCGTGG-1	vSMCs
GTCTACCGTGCCCAGT-1	Fib
AGCTGGCTCATGAACC-1	Myeloid
CTAGGGCAGCTAACAA-1	Lymphoid
CCTTGCAAGTAGACCG-1	Lymphoid
TTACGGAGTCTCTGGG-1	Endo
CAGCTGGGTTTCGACA-1	Lymphoid
CCAGATACAAGAGATT-1	Fib
ATCGAGTAGGCATGCA-1	Myeloid
TAAGTGCGTCTGGTCG-1	Fib
ACTACCCAGGTTGTTC-1	Endo
GTTGGTAGTTTCGATG-1	Fib
GCATTGAGTCAATCCA-1	Lymphoid
CAGGGCTCATGCACTA-1	Myeloid
AACAAAGCAAGCCCTG-1	Lymphoid
GAGCATTAGGATGTAT-1	Endo
TGTGACATCCCGCAAG-1	vSMCs
CTAACTTTCCTGGGAC-1	CM
CACAACACATGCTATG-1	Endo
CCGAAGCGTAGCGTTT-1	Endo
TGTGTCCGTGGACAGT-1	vSMCs
GACTAACAGTAGTCGG-1	Fib
CAAGGCCGTTACGCTA-1	Myeloid
CAGCCTTAGGTTACAA-1	Fib
TGGTCCTCATTTGGCA-1	Endo
CTAACTTGTCTGGATT-1	Endo
TCAAGGTGTACCAAGG-1	Endo
AGATTCGTCGATATGC-1	Myeloid
ATGTCTTCAGCAAACG-1	Endo
GCTGAGCAGTGTCGGA-1	CM
AACGGGAGTGTCGTCG-1	CM
TCTATTGCAGGAGCAT-1	Fib
GTGGATTTCGGCATAT-1	Lymphoid
AGCCTGGAGGAGTAGA-1	Myeloid
GCATTGACACAGTAGG-1	Endo
TGGACATAGTCTGGGA-1	Fib
TTAGGTGTCGGATGTT-1	Fib
GCGCATGAGAATCAAC-1	Lymphoid
AGCCCGATCGAGTTAC-1	Myeloid
ACGGATTAGCGTGTTT-1	Endo
GCATTGATCTGGAAGG-1	Myeloid
TAACGGTGTGATAGAT-1	Myeloid
CTCTACGTCCCGTATC-1	Fib
TAATCGGGTTAACCGT-1	Myeloid
ATTGTCTAGCAACGGT-1	CM
GCCTACTCAGGGTAAC-1	Lymphoid
CGTGGCAGTTGTGACT-1	Fib
TGCACCTAGTAGACCG-1	Myeloid
CGAGTTATCTCCACTG-1	Pericyte
GCCTACTCAAGCCCTG-1	Lymphoid
GCGATCGGTGCAAGCA-1	Endo
CGCTATCTCCGTTAGA-1	Fib
CTCTCGAAGTAGTCGG-1	Myeloid
ACGTGGCGTCTGTTGA-1	Endo
AGCTGGCTCTGGAAGG-1	Lymphoid
GAGGTCCGTGCATTCA-1	Endo
TCAGGGCAGTCGATAA-1	Fib
CACAGATTCTAAACGC-1	Endo
TCTAGTTTCATTCTCA-1	vSMCs
GAACGTTAGACCCATT-1	Pericyte
GCATTGACAGCGTGAA-1	Fib
ACAAACCGTAGTCTGT-1	Endo
GAGGTCCGTTTCTTAC-1	Fib
GGGAACACACTGGGCT-1	Myeloid
CTTTGCGGTCAGAAGC-1	Endo
GCTCACTCAACGGACA-1	Myeloid
CGGTGCAGTGCACCCA-1	CM
TGGTCAATCAGATACC-1	Pericyte
TGCTATTTCCGAGGAA-1	Myeloid
GCTGTTCAGTAACTCC-1	Endo
TGCCTCACAAACCCTA-1	Pericyte
GGCGTTGAGCCTTTGA-1	Lymphoid
TCCATCGTCGGATAAA-1	Fib
CTAGGATTCGTCCCTA-1	Endo
GTGTGATCAACTACTG-1	Endo
TGCATTTGTTACGGAG-1	Endo
GAGGTCCTCTGACTTT-1	Pericyte
TTTGGTTGTAAAGGCC-1	Fib
GTCACTCGTTCTTATC-1	Myeloid
CGTACAAGTTAACCGT-1	Fib
CCAGATACAATGATGA-1	Endo
ATAGTCGGTTCCCTTG-1	Fib
GTTACTTTCTATGAGC-1	Myeloid
CCTTGGTTCCAGTTAG-1	Pericyte
TAGCTTTGTGGCCTTG-1	Lymphoid
CCCTCTCTCCGCTCTA-1	Endo
TCTCTGGAGTCCGTGC-1	CM
GCCCGAAAGTCCCTCT-1	Fib
CTAACTTTCGGATCGC-1	Myeloid
TCGAGCGAGCCATGGA-1	Fib
TTTACGTAGACGACTG-1	Myeloid
TCTAGTTAGACACGGT-1	Fib
CTCTCAGGTCTCTGCT-1	Pericyte
TGATTTCCAAGCTTTG-1	Endo
AGGACGAAGTAACACA-1	Lymphoid
TGCTTCGTCTTTATCG-1	Lymphoid
CAAGAAACATGGGTGA-1	Endo
TCCAGAAGTCTGGGCT-1	Pericyte
CAGCCTTAGACAGCTG-1	Myeloid
AGTCAACTCTAGCAGT-1	Myeloid
TTTGGTTCACAGCCAC-1	vSMCs
GCAGCCACAGCGTAGA-1	Myeloid
ACAGGCCCACGATTAC-1	Fib
AGGCGTCAGAGTGGTC-1	Fib
CCTAAAGAGTTCGACT-1	Fib
CTCATGCCATCAACTG-1	Endo
GAGGATGAGAGCGGTT-1	Endo
GATGATCCAACGGGTA-1	Endo
ACAGGCCTCTGGCGCA-1	Myeloid
TACTGCCAGTTCAGGG-1	Lymphoid
CGGTGCATCGACTCGG-1	Pericyte
GAGTGAGCACCGTCTT-1	Pericyte
GTGGCGTAGAGAAGCA-1	Myeloid
GGCATTATCCCGGGTA-1	Lymphoid
ATAGGCTTCAGTCAAC-1	Myeloid
TCAAGGTGTGAGTCGA-1	Endo
GCGAGAACATATTGGC-1	Fib
ACAATCGCAATTGGCT-1	Myeloid
TCGATTTGTGAATACA-1	Pericyte
ACTCGGGTCATCGCCT-1	CM
TGTACAGCATACCCGG-1	Myeloid
TAGCACAGTCTTAGCA-1	Endo
TGGTCAAAGGAGAACA-1	Myeloid
TCAAGGTGTCCGCTTT-1	Neuronal
TCAGTCCTCCATTGTT-1	Endo
CTTGTCGGTGCACTTA-1	Myeloid
GATCGTACAATTGTGC-1	Fib
AACGGGAGTCAATCCA-1	CM
GCTGAGCAGGTTGTTC-1	vSMCs
TCAGGTAGTGAGGTCA-1	Myeloid
TACCTCGCACACACCG-1	Endo
TACTGCCGTTACACTG-1	Myeloid
CTGCTCACACACACAT-1	Endo
ATGGATCCAGTAGGCA-1	Myeloid
GCTCGAGCAGTATCTG-1	Endo
TTGCGAATCACCCGGA-1	Fib
CACTAAGGTGCTTGAT-1	Myeloid
CCCAGAGCATACAACC-1	Endo
GAGTGAGCAATTGGCT-1	Endo
AATGGAACATACCCGG-1	Fib
CTCTACGAGGAGTCTG-1	Endo
CGCTAGGCAGCAAACG-1	Myeloid
GATTGACGTAGTCTGT-1	Fib
ACTGCAAGTCACCGCA-1	Endo
AACCTGAGTTGGGAAC-1	CM
TGAGTCAAGATCTCAC-1	Endo
CAGCCTTGTAGACGCA-1	CM
CCACAGGAGTGTTCCA-1	Myeloid
GTCTACCCATCCCAAA-1	Lymphoid
TGATCAGTCGGTTCCT-1	Myeloid
CACCTGTGTCAAACAA-1	Endo
GTCACAAGTACCTATG-1	Myeloid
CTTGTCGCATTATGGC-1	Endo
TTGTCTACATCAACTG-1	Fib
TAAGTGCCAGCAAACG-1	Lymphoid
ACTTCCGGTGCTGTGC-1	CM
TAGCCCTCACCATTCC-1	Pericyte
TGTACGACATGGGAAC-1	Pericyte
GAAAGTACATAGTCCA-1	Fib
TTGCACCAGACCGCAA-1	Myeloid
GTCACTCCACGCTCAG-1	Fib
ATCCCTGGTCAGGCTC-1	Lymphoid
GCTGTTCAGGGTTCCC-1	Lymphoid
TTACTCATCCGATGCG-1	Fib
TCGAGCGGTAGTCTGT-1	Lymphoid
TTGCTATAGCGCGTTC-1	CM
GACCTTCGTTTGCGAT-1	Lymphoid
TGTGTCCTCATGAACC-1	Lymphoid
CATTCCGTCTAGTCGA-1	Lymphoid
CACATGAGTTCCATCC-1	Lymphoid
AACAAAGTCTCTGAGA-1	CM
CAGTGCGAGCTAACAA-1	Pericyte
GCGTTGGCACTTGCGG-1	Fib
GCGTTGGGTTCTGAGT-1	Lymphoid
CCGAAGCCACCCATCT-1	Fib
AGGCGAATCTCTATCA-1	Neuronal
GGGCCATTCATGAACC-1	CM
AAAGGGCCATGGGACA-1	CM
ACCGGGTCACCACCAG-1	Myeloid
GAACGTTAGAAGAGTG-1	Endo
TGGCAATGTCTAAGAA-1	Pericyte
CCGAAGCGTGCATTGT-1	Fib
TGGGTGCCAGCGCGTT-1	Pericyte
TGCACCTGTAGAACGC-1	Pericyte
CATGTTTTCGCTTACC-1	Pericyte
TCAGTTTCAGCTGATT-1	Endo
GATTAGCAGATGCGCA-1	Lymphoid
AACATCGGTGCAGACA-1	Fib
GAAGAGCGTTAACCAC-1	Myeloid
ACAGAAAGTCACCGCA-1	Lymphoid
CTTGAAGTCCGTTAGA-1	Pericyte
CGTGGCATCTATGAGC-1	CM
TTGTCTAGTAAGTCTC-1	Myeloid
AGATAGACAGTGGTCC-1	Myeloid
TGGACATTCGTTCAGA-1	CM
TAAGTGCTCCAGTACA-1	CM
TTACCCGGTATCACAC-1	Endo
AGTTACGCAACGCAAG-1	Myeloid
GCAAAGGGTATGGTTC-1	Endo
TTCTGTAAGGCTGGAT-1	Lymphoid
CGGTGCAAGAATGCTA-1	Pericyte
GGTGTCGCAAGGACCA-1	Endo
TTGACGAGTTATAGAG-1	Lymphoid
GCTCACTAGTCGTACT-1	Endo
GAAAGTAAGTATAGTG-1	Lymphoid
TTTACGTAGGCAGTAC-1	Neuronal
TATGTGGTCCCTACGT-1	Fib
ATGTCGAGTGAATACA-1	Fib
CTGTTCGCAGGCTACC-1	Myeloid
GTGCTGGGTCAGAAGC-1	Lymphoid
GTTACTTCATCAGCTA-1	Myeloid
AGTGTACAGGCATGCA-1	Pericyte
GCAAAGGAGATATGAC-1	Pericyte
ATCCTGCCACACATTG-1	Lymphoid
TACGCCTGTAGGTAAT-1	Fib
CAGGATTGTGAATACA-1	Lymphoid
GGTGTCGCATCCGTGG-1	Pericyte
CACTAAGCAGGCAGAT-1	Myeloid
CGGACCATCAGCCGGT-1	Fib
TGCCTGTTCTAGTCGA-1	Myeloid
AGCCAGCGTGCTTTGA-1	Endo
CGAGTTAGTCTCTAAG-1	Fib
TTCATTGAGTCTGCTA-1	Endo
TCAAGACAGCGTCAAG-1	Endo
ATTCGTTAGACAGTGC-1	Fib
GCACGGTGTAACGTAA-1	Endo
TCTAGTTGTCAACTGT-1	vSMCs
CATTGGACACTTTGGA-1	Pericyte
TGCTTCGTCATTGCCC-1	Fib
AGTTTGGGTGCGCTCA-1	Lymphoid
TATCGAGCATTATGGC-1	Lymphoid
ACAAACCTCTGAGTAC-1	Myeloid
GGTGAAGCATGCGTTA-1	Fib
AGCTGTAAGCGGACAT-1	Pericyte
AGCCGCAAGACTAGGC-1	Myeloid
GGTGAAGGTAAGTCTC-1	Lymphoid
TAGGTCAGTTTCAGCA-1	Lymphoid
TTTGCGCGTCTGGGAA-1	Endo
GGGTTATTCCTATCAT-1	vSMCs
AGCGTGCTCTTAACGG-1	Pericyte
GCTTGCTAGATTCCGT-1	Endo
GTAGGAGAGTCACGCC-1	Endo
CAAGGCCCAGAGCCAA-1	Lymphoid
CGAGTTAAGTTACCAC-1	Endo
GTGCACGCACCTACCT-1	Myeloid
AACAAAGAGACTAATG-1	Myeloid
AACGAGGTCTTACCTA-1	CM
CCAGAATAGGATTGCG-1	Endo
TGCTATTTCCGTTTCG-1	Lymphoid
GGTACCGCAAGTCTGT-1	Pericyte
GAGTGAGCACTGCTCT-1	Myeloid
TTGCGAATCCATATCT-1	Lymphoid
CACCTGTAGCCCATGC-1	Pericyte
ACTGCGGCACACATTG-1	Myeloid
GCCAGACCAAACCCTA-1	Pericyte
GATCGTAGTTTCTCTA-1	Endo
AGCTGGCTCCCGTATC-1	Myeloid
AGCTGATCAAGCAGGT-1	Endo
TGTAAGCGTTTAGACC-1	Lymphoid
TGACTCCGTTCAGTTG-1	CM
GAACCGCCACAATAAG-1	Endo
ACCGCAGCACGTTACA-1	Lymphoid
TCGAGCGAGGCAGATC-1	Lymphoid
GTAATCGGTACGGATG-1	Pericyte
TCGATTTGTATTCGAC-1	Myeloid
CGGTGCATCCCTAAAG-1	Pericyte
GTGTCCTGTGTTGTTG-1	Fib
CTCTACGGTGCAAGAC-1	Myeloid
AGTGCCGAGTGTAATG-1	vSMCs
CCCTCTCTCTTCCACG-1	Lymphoid
TGTGGCGCAAACGACG-1	Pericyte
GTTATTCGTCCGTGCA-1	CM
TGAGTCATCTCTTCTC-1	Fib
GACCCAGCAGTAACGG-1	Fib
AAATGCCCAGGGTAAC-1	Endo
TCTCTGGAGGTCTTGT-1	Pericyte
GCTCCTAAGAGAGTAG-1	Pericyte
GCCTACTGTTCAGTAC-1	Lymphoid
GGCACGTGTCATCAAC-1	Endo
TCAAGCACACTGTTAG-1	CM
AGCGATTTCAACTTGG-1	Fib
TGCTCACCACGCGCAT-1	Lymphoid
AATGGCTTCTATCTAC-1	Fib
AACTGGTCACGCGATC-1	Myeloid
ACCAAACGTAGTATCC-1	Endo
AAATGCCCAATGAAAC-1	Myeloid
TCGGGACAGGTAAGCC-1	Neuronal
TGCATTTAGCTCCGGT-1	Fib
TAGCTTTAGTGATTAG-1	Myeloid
CAACGGCGTTGTATCG-1	Myeloid
TCAATTCGTGTCTACA-1	Fib
AGCCTGGGTAGTCTGT-1	Lymphoid
ACAAGCTCACCTCGTT-1	Pericyte
GTCACTCGTGTCCAGC-1	Myeloid
GAACCGCAGCCGCAAA-1	CM
TGCTATTCAGTAACTC-1	Lymphoid
ACTATTCAGGTACATA-1	Endo
CACAACATCCGAATTG-1	Lymphoid
ACTAACGCAGGCAGAT-1	Endo
AGACAAAAGTCCGATT-1	Lymphoid
AGGCGAAGTCCCGTGA-1	Lymphoid
TTATGTCTCGCGCCAA-1	Fib
TGTGTCCAGACGTCAG-1	Fib
GGTTGCGGTGAATGTA-1	Lymphoid
ACAGCGCTCAAGGCCC-1	CM
TTGTTGTAGCGCATTT-1	Endo
TCCGACTAGCCTTTGA-1	Fib
ACGTTAGTCTTCTTCC-1	Lymphoid
GAACCTATCGTGATAC-1	Lymphoid
GTAGTACCAAGGAGTC-1	CM
TCAATTCTCTGTAGAC-1	vSMCs
AGGCCTGCAGCTATAC-1	Myeloid
ATTGTGGCAAGTTGCT-1	Lymphoid
TTGTCTACAAGTTGCT-1	Endo
GAAGTGGAGTGCTAGG-1	Lymphoid
TGCCTCACAGAACAGC-1	Pericyte
CGTTCCACAAACCCTA-1	Myeloid
GCGAGAACAAGGTTCT-1	Lymphoid
CAGCTGGCAAGGTTCT-1	Endo
CCACGTTGTCGATAGG-1	CM
AAATGAGGTCCAAGAG-1	Endo
TGCTATTAGTGTAATG-1	Fib
ATGTTTCTCTACATCT-1	Fib
TAACTTCAGTAGGTCG-1	Fib
CTTGTCGCATCGTACA-1	Lymphoid
CTCAGAACAAACCCTA-1	Endo
TGGTCAATCAGAATGA-1	Lymphoid
CTGTATTTCTGAGTAC-1	Endo
CCTCCCTAGACCTATC-1	Lymphoid
AAAGGATAGCTAGCAG-1	Neuronal
GCAGCCAGTCTGGGCT-1	Myeloid
ATTGTCTAGGGTCCCT-1	vSMCs
GTCACAAGTTTAGGAA-1	Endo
TCAAAGCGTTACGCTA-1	Endo
CAACGGCGTGTGTGCC-1	Myeloid
TCGGGACCAGACCTGC-1	Lymphoid
TGCGTAACACCGATCG-1	Neuronal
GCACCTTAGCTGATTC-1	Pericyte
GCCAGCATCGAACCGC-1	Lymphoid
AGATAGAGTTCAGAAA-1	Fib
CACCACTAGATCTAAG-1	Lymphoid
CTCTCAGCAGTAACGG-1	Lymphoid
CGTACAATCTCCTTGG-1	Myeloid
TACATGGGTCGCTAGC-1	CM
TCACAAGAGACGTCAG-1	Endo
TATGTTCAGAACGCCA-1	Endo
CAACGGCAGGCTTCGC-1	Lymphoid
TTGTCTAAGTACAGAT-1	Fib
GATTGACGTAAGTCTC-1	Myeloid
AACCTGAAGGGTCTGA-1	Lymphoid
AGCCGCAAGAGAGTTT-1	vSMCs
GGCGAAATCGGATGTT-1	Endo
ACCGAATTCTCATATC-1	Myeloid
GGAGTAGTCCCAGCGA-1	Lymphoid
GCTGCGAAGCGTGTTT-1	Endo
CCGTGAGTCGTGATAC-1	Fib
ACCATCCGTTGTGAGG-1	Lymphoid
GCGCATGCATAGACGG-1	Fib
CCAGATAGTAACGGAC-1	Endo
CCTATTATCCTGTAGA-1	CM
ATCCAGACAGTTCGGC-1	CM
ACTGCGGGTATGTCCA-1	Pericyte
ATGTCGAAGTCCCGCA-1	Pericyte
GGTCATAGTCAGTGTT-1	Lymphoid
CACATGAGTGTGAGGT-1	Endo
AAAGATGTCGAACACT-1	Fib
TCAAGGTGTTCCGCGA-1	Myeloid
GATTGACCAGTTAAAG-1	Endo
ATAGGCTAGACCATAA-1	Lymphoid
TGGCAATGTTAGAGAT-1	Endo
CGCTAGGGTTTAAGGA-1	Pericyte
TACGCAACAAAGAAGG-1	Endo
AAACGAAAGCTGAATA-1	Lymphoid
AGCGTGCTCCGTGCGA-1	Lymphoid
CTTGAAGCATAGCCAT-1	Fib
TCCATCGAGAGGTGGG-1	CM
TACCCTGGTCGCTAGC-1	CM
CCCACATTCCATAACG-1	Lymphoid
GTAGTACCAGAAGTGC-1	Lymphoid
GGTAGGACATGTATCG-1	Lymphoid
TCAGTTTTCGCGGCAT-1	Lymphoid
GTCGTAACATCCCGGA-1	Lymphoid
GTGTCAAAGACACGGT-1	Lymphoid
AGCCCGAGTAAAGGCC-1	Myeloid
TAGACTGTCCAGTACA-1	Lymphoid
TATGTTCTCCGGCGAT-1	Lymphoid
AGTCAACAGTTGTCCA-1	Endo
GCGATTAGTACGGAGT-1	CM
GATCATGTCCACGGCA-1	Lymphoid
AGTCCGGAGAGTGGTC-1	Fib
AGTCAACAGGCTAAAT-1	CM
ACGGATTGTTGGACGA-1	Pericyte
GTGCCAGGTCCGTAGC-1	Myeloid
CCCACATGTCGCTAGC-1	vSMCs
TGGACATCACGATATC-1	Lymphoid
GAACCGCCACAAGTGG-1	Lymphoid
CCGTGAGCAAACCCTA-1	CM
CGTTCCAAGGAATGGA-1	Lymphoid
ACTACGACAAGCAATA-1	CM
CTAGGGCCAAGCCAGA-1	Myeloid
CTACTTACAAGGGAGG-1	vSMCs
CTGTATTCACGCGACT-1	Myeloid
TCTCTGGGTTCACGTA-1	Fib
AAATGAGTCGAACACT-1	Lymphoid
ACTACGAAGAGTTCGG-1	CM
AACCGATCAAGCCAGA-1	Myeloid
TGAGCCGGTGGTAAGC-1	Lymphoid
GTGACATAGCAAGGTC-1	CM
AGCTGGCGTGATGCGA-1	Pericyte
GAGCGCTGTCAACAGG-1	Fib
TACTCGCCAGAGCCAA-1	Lymphoid
TCAGGGCCAGAGATGC-1	Pericyte
TGCTCACTCCTATCAT-1	Endo
TTCGTTAAGGACCGAT-1	Myeloid
TTCTGTATCTAGCAGT-1	Myeloid
ACCCAAAGTCAACTAC-1	Lymphoid
CTGGGACCAGGACTGA-1	Myeloid
TACTAGGGTGCAAGAC-1	Lymphoid
AGCCGCAGTAAGCCTT-1	Fib
ATCCTCGAGAATCAAC-1	Lymphoid
CCTAAAGCAAGTTGCT-1	Lymphoid
GCGCATGAGCGCCTAC-1	Pericyte
CTGTATTTCTTCCACG-1	Fib
ACTACGAAGCGGACAT-1	Neuronal
CTGTTCGCAAGCAATA-1	CM
TAGGTCAAGGACTAGC-1	Pericyte
GGAGTAGCAACTAGAA-1	CM
GTGTCAATCCTTTGAT-1	Endo
TTCATTGTCAGTTGAC-1	Lymphoid
GACTAACAGTCGTATC-1	Myeloid
GTGTCAATCATCGCCT-1	Lymphoid
GGGTTATAGGGTAGTC-1	CM
CTCAGAACAGAACAGC-1	Endo
AATGGAATCGATCGCG-1	Lymphoid
AGTCCGGCAGCGTCGT-1	CM
CTGGCAGCATCATAGC-1	Fib
CTAACTTGTTACACTG-1	Lymphoid
AGGCGTCAGCTGAGGT-1	vSMCs
TCACAGAAGAACAGGA-1	Myeloid
CCAGATATCCTGGGAC-1	Myeloid
GGTCATATCATTCGGA-1	Myeloid
TTCAACTGTTTGAAGA-1	vSMCs
TCAGTCCTCCCGTAGG-1	CM
ACGGATTTCCCTACGT-1	Lymphoid
CCGCATTAGAGGTACC-1	Endo
CGTACAAAGGAGTACC-1	Endo
AACGAGGGTTGTGAGG-1	Myeloid
AAATGAGCAAACCTAC-1	CM
TGTGTCCGTGAGTCGA-1	CM
GAACCGCAGCGAATAT-1	Endo
GTGTGATTCTATAGGC-1	Lymphoid
CCGTAGGCACGGCCAT-1	CM
CTAGGGCCAATGTAAG-1	Lymphoid
CGGTGCATCTTTGCAT-1	Endo
TTACTTGTCCCGTAGG-1	Fib
TGATGCAAGTGAACCG-1	Lymphoid
AATGGCTCAATTAGGA-1	Fib
AAACGAATCCGTGCGA-1	Myeloid
GAGGCTCTCATCGCAA-1	Endo
GGTGAAGGTCGCTAGC-1	Fib
GGGTTATGTGTCCAGC-1	Fib
GAGACTTAGTCTCGAT-1	Myeloid
GGAGTAGCAAGTTGCT-1	Endo
TCACTCGGTCATCGTA-1	Myeloid
GTGATCAAGCCTCGCA-1	CM
TATCTGTCATCTCTCG-1	Lymphoid
CACCTTGGTCAGTGTT-1	CM
CGTACAACACACATTG-1	Fib
TGCATTTCAGGTAACG-1	CM
TGCCTCACATCGGCCA-1	Pericyte
AGTCAACGTACGCCCA-1	CM
GTCGTAAAGTGGTGTG-1	Endo
CGCACAGTCCCACTAC-1	Lymphoid
CTAACTTGTGGTAGAC-1	Lymphoid
CTAGGATTCACCACAA-1	Lymphoid
CAGCCTTGTTCCTGTC-1	CM
GATGATCTCATGAACC-1	CM
AGTGCCGCAGAAGTGC-1	Endo
CAACCAATCGGCAATT-1	CM
GCGGAAATCGAGAAGC-1	Myeloid
TCGCAGGAGATGTTGA-1	Myeloid
TACATGGTCGACTTAG-1	Fib
CTAACTTTCACCACAA-1	Lymphoid
TCCCACAGTCAAGACG-1	Myeloid
ATCCAGACACTAGGAG-1	Endo
CTAACTTGTCGCTAGC-1	CM
CAGGATTAGTAGACCG-1	Fib
TCAGGTAAGCGAGCTA-1	Lymphoid
CACATGAAGAGAGTTT-1	CM
GAACGTTAGGACTAGC-1	Lymphoid
TCACAAGGTGTGACCC-1	Fib
GCAGCCAGTCAGTGTT-1	Fib
CCGTGAGTCGCTGATA-1	CM
CGAGTTAGTGCACCCA-1	Pericyte
TGGAAGGCATTTAGGC-1	Lymphoid
TTGCAGATCCCATAGA-1	Lymphoid
AACCGATGTCCGTGCA-1	CM
AATGGAAAGAGCAGCT-1	Lymphoid
GAACGTTGTCTGAGCC-1	Endo
TCACAAGTCAGGTCTA-1	Lymphoid
GTTACTTCAGAGTCGA-1	Lymphoid
ACTACCCGTACGTAAA-1	CM
GCGGTGTGTATGGTTC-1	Fib
CCAGATAGTACGCAAG-1	Fib
CCCTAACGTTCATTTC-1	Neuronal
TTGTCTAAGACTTCCA-1	Endo
TTGAGTGTCTGGCCAG-1	Lymphoid
GCTCCTACATCCGTGG-1	Fib
TTTGGTTCAAGCAACG-1	Myeloid
CTACAGACATGATCGT-1	Endo
AGTGTACCAATTGCCA-1	Lymphoid
TGGGTTAGTCGATAGG-1	CM
CCCGTTATCCCATAGA-1	Lymphoid
CCTCCCTTCCGTACGG-1	Fib
CAAGGCCGTTACGGAG-1	Myeloid
GGTAGGATCATCGCCT-1	Lymphoid
GGTGTCGGTATTTGCG-1	CM
GGGTTATCAACTGCGC-1	Fib
ATCCTCGCAGACTAAA-1	Fib
GTCCATCCATGCGTTA-1	CM
CGCAGGTTCTCGACCT-1	Lymphoid
GCTGAGCGTGCAAGCA-1	CM
CGCTGGACACAGTAGG-1	CM
TATCGAGAGCACACCC-1	Myeloid
TGTAAGCCACAAGTGG-1	Myeloid
CAGCTGGGTCACCGCA-1	Myeloid
TACCTCGCACTGCTTC-1	CM
CCAGATAGTCAACAGG-1	Fib
AGTTTGGTCCGCTATC-1	Neuronal
AGCTGGCCACCTCGTT-1	CM
CCGTGAGCAGAACAGC-1	CM
TACCTCGCAACACGGA-1	Myeloid
GACTAGTCAGCCACGT-1	Fib
GGAATCTGTTAAGGGC-1	Fib
CTACTTAGTCTAACCA-1	Myeloid
CTGTTCGCACGCCGAT-1	Endo
GCACGGTCATGCGTTA-1	Lymphoid
TCGAGCGCAGTTACAC-1	Lymphoid
ACTCGGGTCTGACATG-1	Fib
GAACCTATCTGGCACG-1	Myeloid
GGAACTTCAGCGTCGT-1	CM
GCCCGAACAGGTGGTA-1	CM
CAAAGCTAGAAGCCGT-1	Endo
AGCCTGGGTAATGTAG-1	Endo
CCGTAGGCAGTCAGCC-1	Lymphoid
GTCCATCAGACACGGT-1	Myeloid
TGATCAGTCCTTCGAC-1	CM
CTCAGAACAGTTCGGC-1	Endo
TCACCACGTATGGGTG-1	Pericyte
GTGCTGGGTCCGAGCT-1	Fib
ATTGTGGGTCCGTAGC-1	Lymphoid
GCAGCCAGTAGACACG-1	Fib
CCTTGGTGTTTGTAGC-1	Myeloid
CGCTAGGAGAGGTGGG-1	Myeloid
TAGGAGGCATCGACGC-1	Endo
TGGGTTAGTACGACCC-1	CM
CGAGTTATCCACCTAC-1	Myeloid
TGTAAGCCACTGTAAC-1	Myeloid
CAGCTGGTCACATTCT-1	Fib
CATGTTTGTGATGCTT-1	Myeloid
CAATCCCCAAACCGAG-1	Lymphoid
AACTGTGTCGTGGGTC-1	CM
GGGCCATAGGATCCTT-1	Pericyte
CCGTGAGCATCGGCCA-1	CM
TATCGAGTCACGGGTC-1	Pericyte
TTACTCAGTAGACGCA-1	Lymphoid
GAACCTATCGATCTTT-1	Myeloid
ACAGACTTCGTTGTAG-1	Lymphoid
CCCACATAGTCGCCTG-1	Endo
GATGATCTCAGCACGC-1	Fib
CCTGGGATCATCGCAA-1	Fib
TTCGGTCGTTAACCAC-1	Endo
CAGCTAACATGCCTTC-1	Pericyte
TGCCTCACAAGTCTGT-1	Pericyte
CACAGATAGCGTCTGC-1	Fib
GCGCCAATCGGATGTT-1	CM
ACTAACGCATCCCGGA-1	Myeloid
TCCATCGAGGGCTTCC-1	CM
TCGAGCGGTCAGTGTT-1	Lymphoid
CGCTAGGAGGGCTTCC-1	Myeloid
GCCCGAACAACGTAGG-1	Myeloid
TGCACCTAGCGTCTGC-1	Fib
CACCTGTGTGAGGTCA-1	CM
AGGCCTGCACGGCCAT-1	CM
GCCCGAAAGGCGTCCT-1	Endo
AGGCGTCCAATTCAGC-1	Fib
TCCAGAACACTACACA-1	CM
GCTGTTCCATACCCGG-1	CM
TTACCCGAGGTAAGTT-1	Fib
TAGCTTTGTACGCCCA-1	Myeloid
GCGAGAACACAGTAGG-1	Myeloid
ACCCAAACAGGAGCAT-1	Myeloid
GGGTCTGTCACTCGTC-1	Endo
CCTTGGTGTCACTCTC-1	Myeloid
CAGTGTAAGAGCTGTG-1	Endo
TACCTCGTCCCTATTA-1	CM
TACCTCGCAAGATGCG-1	Endo
GTCACGGGTAGCAGCA-1	Lymphoid
CTCAGAACATCGGCCA-1	Endo
GCGCATGCATTAACGC-1	CM
GTGCTGGGTGGTGGTA-1	Myeloid
AGTCCGGCAATGACTC-1	Fib
TGCCTCAAGAGCCACA-1	Lymphoid
AACTTGGCAGTGGTCC-1	Endo
GAGATTCAGCCTGTAT-1	Fib
TGTAAGCTCCTTCGAC-1	CM
ACCGGGTAGAAAGGGT-1	Pericyte
TTGTCTAAGGGTCTGA-1	Lymphoid
CACCTTGGTAGACACG-1	CM
ACAAACCGTCAGTGTT-1	Endo
GTGTGATGTGCTTCCT-1	Fib
GCGATCGAGCTACGCC-1	Lymphoid
CTTGTCGCAAACCTAC-1	Endo
AGGCCTGTCCTGGGAC-1	CM
CTCAACCTCGCAAGCC-1	Endo
TAACTTCCAGACCTGC-1	CM
AACATCGCACTCGTGG-1	CM
CCACAGGTCCGTACGG-1	Fib
GCTCCTACAAGTCTGT-1	Pericyte
TCAAAGCAGTCACGCC-1	Lymphoid
TAACGGTTCTTAGTGG-1	Endo
CGGTGCAGTAGGGTCA-1	Myeloid
ACTACCCAGAAAGGGT-1	Fib
AACAGTCGTCACATTG-1	Endo
GCTCCTATCAAAGTAG-1	CM
TTCGTTACATTTGTTC-1	Fib
AGTCAACGTGTCTCGG-1	CM
ACGGATTTCTGACATG-1	Neuronal
CAGTGTAAGGGAGATA-1	Pericyte
GTCACAAAGTTGAATG-1	Fib
TCAGTTTTCAGTAGTC-1	Endo
TGGCGCATCACCGCGA-1	Lymphoid
TTTGGCCCAGCAACCC-1	Lymphoid
CCTGGGAAGATTCCGT-1	Lymphoid
CAGCTGGAGGCACCTC-1	Lymphoid
CATTGGAAGATCTAAG-1	Lymphoid
GTTACTTCACGGTGTC-1	Myeloid
TAAGCCAAGCCTCGCA-1	CM
CTTGAAGCAGAGCCAA-1	Lymphoid
TAAGTGCGTCACCCGA-1	Myeloid
AGGACGAGTGGTGGTA-1	Pericyte
AGCTGATCAGATTGTC-1	CM
CCGTGAGCAGTTCGGC-1	CM
CCGTACTTCTCGACAA-1	Fib
GATTGACGTCAGTGTT-1	Fib
CAGCTGGGTTTGCATG-1	CM
TGTTAGGTCTCGCGGA-1	Fib
CCTTAATTCGCGTTCT-1	Myeloid
ACTACGACACGCCGAT-1	Endo
GGAGGATTCCAACAAC-1	CM
TCAAAGCGTTACGGAG-1	Endo
CCCTAGTGTCCGTAGC-1	Fib
AAATGCCTCAGTCAAC-1	CM
GCTCCTATCGCAACTA-1	CM
CTCAGCTGTAGCAGCA-1	Lymphoid
GCGAGAATCCCAATGA-1	Fib
GATGATCCATGGGACA-1	Fib
TCAGTTTCAACTACTG-1	Fib
CGGTGCAGTTGGAGGT-1	CM
CTGTTCGCACACATTG-1	Fib
TAGTCCCGTATTCTGG-1	Myeloid
TGCCTCACACAGTAGG-1	Pericyte
TACGGATCACAGTAGG-1	CM
ATAGGCTTCATCGCCT-1	Myeloid
AGGCGAAAGATCTAAG-1	Lymphoid
TACGGATTCTTACGGA-1	Fib
CAGGATTCATTACTCT-1	CM
CGGTGCAGTCGCGCTA-1	CM
GTCCATCTCTTAGTGG-1	Endo
TATCGAGTCGATGAAA-1	Pericyte
CCGTGAGCACAGTAGG-1	CM
TACCTCGCAGGCTACC-1	Myeloid
CTAACTTGTGTCTCGG-1	Fib
AGTTACGCATGCGCTG-1	Pericyte
CGCAGGTAGATCACCT-1	Fib
GTTATTCGTCGGCTGT-1	CM
AACATCGCAAGTCTGT-1	Pericyte
GCTCCTATCCGAATTG-1	Fib
CATTGGAGTGCTTCCT-1	Fib
CAACCAATCGTGATAC-1	Fib
GCTTAAGTCGTCCCTA-1	Endo
TAATTCCCATTTGGCA-1	Endo
CAGCCTTAGCTCGGCT-1	CM
ACAAACCAGCCCATTA-1	Myeloid
GTGTCCTTCCCGTAGG-1	Endo
AGTGTACGTTGGAGGT-1	CM
CTGTTCGCATGGGACA-1	Fib
TAGGTCATCATGTTCT-1	Fib
ATGTACGAGTATGCTC-1	CM
GTTATTCGTCAACTAC-1	CM
GTGCTGGTCTCGACAA-1	Lymphoid
GTGACATCAACTACTG-1	Fib
GTGGATTTCACAACAC-1	Endo
GGCACGTAGAGAAGCA-1	Fib
CTCAGAACACAGTAGG-1	Endo
TAACGGTCACCTCGTT-1	CM
TAACTTCCACTGGGCT-1	Fib
GTGACATCACTTTGGA-1	Fib
AGTTTGGTCGCGGCAT-1	Lymphoid
TCACTCGTCCGTTAGA-1	Endo
CGGTGCAGTCAACTAC-1	Myeloid
CCAGAATCAGATTGTC-1	Lymphoid
TCAATTCGTTGCCGCA-1	Endo
CCGTAGGCAACTACTG-1	Fib
TGCCTCACACGAACGA-1	Pericyte
CTCAGAACAAGTCTGT-1	Endo
CTTCCAGGTTGCAGAG-1	CM
CGTTCCATCCCTAAAG-1	Fib
ACAATCGCATCTCACC-1	CM
GCCATAAGTCCGTCGA-1	Myeloid
ACAAACCGTAGACACG-1	Endo
TAGCTTTGTGTCTCGG-1	Myeloid
CCGTGAGCAAGTCTGT-1	CM
GGTAGGACAATGCACT-1	Fib
TACCTCGTCCTTCGAC-1	CM
AGCTGGCCAGAGCCAA-1	Lymphoid
TAATCGGGTTAAGGGC-1	Myeloid
AAATGAGCAACTTGGT-1	CM
AGTCCGGCACGATATC-1	Fib
CAAGGCCGTCAATACC-1	Myeloid
ACCAAACCAAAGACGC-1	CM
CGATGATGTGCTTCCT-1	Myeloid
CATAACGAGCTAGCAG-1	Neuronal
TTGCTATTCCTTCGAC-1	CM
TCAGTTTCACTTTGGA-1	Fib
GGAATCTAGATCTAAG-1	Lymphoid
CGTACAAAGGGAAGCG-1	Fib
