Barcode	cell_type
GGTGAAGTCGTCTTAT-1	CM
ATCCAGAAGCAACGGT-1	CM
ACTAGGTCAGATGGCA-1	CM
TGGTCAACAAAGAGAG-1	CM
TCCGACTAGGTCTTGT-1	CM
TGGAAGGAGGCGATTG-1	CM
TACTCGCAGTCCCTCT-1	CM
TAGCATGCAATTCAGC-1	CM
TTCAACTAGACACAAT-1	CM
TACTAGGCACAGGTAG-1	CM
GCGAGTCGTGGTGGTA-1	CM
ATTGTGGGTCTGGTTA-1	CM
TAGCCCTCAACGCACC-1	CM
GCATTGAAGAACCCGA-1	CM
ACAAGCTGTTTGTACG-1	CM
GCTTGCTAGATATGTG-1	CM
CGGACCACACAGTTCA-1	CM
GCAACCGTCTTATCAC-1	CM
TGCATGAGTCGGCTGT-1	CM
TTAACGGAGGAGTCTG-1	CM
AGTGCGCCACTGTCGG-1	CM
TTCGTTATCCAAGAGG-1	CM
GCCTAGGAGGATGTAT-1	CM
CCACGTTGTCACAGGA-1	CM
TTCATTGAGTGGGACT-1	CM
TAGACTGAGATATGTG-1	CM
TTCGATTAGCAGAATT-1	CM
GAAGAGCTCCCGGGTA-1	CM
AAGGTTCCAGGGTAAC-1	CM
TTGAGTGAGCGTGTTT-1	CM
TTTGGTTGTTTGGATC-1	CM
TTTGGCCTCGAACACT-1	CM
TAGGTCACAGTAACTC-1	CM
TTCTGTAGTCAACGGA-1	CM
ATGTTTCCAAGGGAGG-1	CM
CTCTCGAGTTCAGTAC-1	CM
GTTGGGCTCTTCCACG-1	CM
AAGGTTCCAGTCAGAG-1	CM
TGGGTGCGTAGCAGCA-1	CM
TACCTCGAGTTCAAGA-1	CM
GTTACGAAGGTCTTTG-1	CM
CACAGATTCGCTCGGA-1	Fib
TTGCTATTCGCAACTA-1	Fib
AAGGAGCCACCGTTGG-1	CM
CCAGATACAGTAAGAT-1	CM
TCAGGGCAGTCCAGAG-1	CM
CCACGTTTCTGCTACC-1	CM
GGATAGGTCGTGGTAT-1	CM
GGCGAAACAGGCATTT-1	CM
TGCCTGTTCTTCACTA-1	CM
TGTACAGTCTACATCT-1	CM
TTACGTTCATAAAGTG-1	CM
TGCCTGTAGAATATCG-1	CM
GTCACAAGTTGCAGAG-1	CM
GGCGAAAAGGGCATTG-1	CM
GTTGGGCAGGAGTACC-1	CM
CTCCCAACATCTGCAA-1	CM
GAAACAAAGGGTTCCC-1	CM
GTGTCAACAGGTGGTA-1	CM
ACGGATTTCTTACTCA-1	CM
CATTCCGAGTGAATAC-1	CM
TGATGCATCATCATGG-1	CM
ACTCGGGGTTTGTCTT-1	CM
TTCGCGTTCAGTGGTT-1	CM
GCCCAGACACCTACCT-1	CM
GAAATGACAGAAGTGC-1	CM
TACCTCGGTCCTCAGG-1	CM
TGGCGCATCTATCTTG-1	CM
TCCCACATCAAGTTGC-1	CM
GGCGAAATCTTCCAGC-1	CM
GAAAGTATCTCGCGTT-1	CM
CTTAATCTCAGATACC-1	CM
TTGTTCACATACCCGG-1	CM
GAGGTCCCAGGATAGC-1	CM
TACATGGGTGTCCTTC-1	CM
AAACTGCAGTCTCGAT-1	CM
TACATTCCATTACACG-1	CM
AAAGATGCAGAACGAC-1	CM
AACTTGGAGCACCATT-1	CM
CCGTGAGGTGTCCTTC-1	CM
GTTGGTAGTTAAGTCC-1	CM
AGTCAACAGCAGAATT-1	CM
GTGTGATAGTAACATG-1	CM
TAAGCCATCCCGTAGG-1	CM
CTGCGTTCACTACACA-1	CM
CTAACTTTCATCGCCT-1	CM
AACCAACAGTCTGGGA-1	CM
TTAGCTTGTTTGATCG-1	CM
TTAACGGTCGTGCTTC-1	CM
GTAGACTGTTTGACCA-1	CM
TTAGCTTAGTCCGATT-1	CM
GCGGGTTGTATTGTCG-1	CM
GATTGACTCACTTACT-1	CM
TACATGGCATTCACCC-1	CM
AACCTTTTCTACTGCC-1	CM
AGCTGTAAGAAAGCAG-1	CM
ACTATTCTCGACTCGG-1	CM
ATGTTTCCAAGTGGCA-1	CM
GAATCTGTCACAACAC-1	CM
CACCTGTCATCATAGC-1	Myeloid
CCTGCTATCTGGCCAG-1	CM
TCCCACACAGAACAGC-1	CM
GAGGTCCGTATTCGAC-1	CM
GGGTTATCACTGTTAG-1	CM
GAGCATTTCGCATACA-1	Fib
CCTTGGTTCTCCTTGG-1	CM
CCTGCTACAGGATGTG-1	CM
GGGAACAAGTGAGCAC-1	CM
ACAAACCTCCTCAAGA-1	CM
TAGCCGGAGTGAACCG-1	CM
CAGCCTTGTGCAAGCA-1	CM
GACCCAGCACGCTAAT-1	CM
TTCATTGCATGGAGGT-1	CM
ATTCGTTGTCTGCACG-1	CM
GTAGGAGCAGTCAGAG-1	CM
AATACGCTCAAATGGA-1	CM
TTGCTATAGGACTTTC-1	CM
GTGTCCTGTCGAGAAC-1	CM
AACGGGACAGAACTTC-1	CM
AGGCCCAGTGCTTACA-1	CM
GTTCAAGGTTCCAATG-1	CM
CCGCATTGTAATGTAG-1	CM
TCAGGGCTCCCAGCAG-1	CM
GGAACTTAGATCTCAC-1	CM
GAACCTATCTGAAAGA-1	CM
ATAGGCTTCGGCTATA-1	CM
AGTGTACGTCAACTAC-1	CM
TGCTCGTTCCGATGCG-1	CM
ATCCCTGGTGTTGTTG-1	CM
TTCATCAAGTCTGTGT-1	CM
GTGACATTCAAGAGAT-1	CM
GGTGAAGAGAACCCGA-1	Fib
GCAGCCATCTGTTGCC-1	CM
TCGCCTATCGAGGCTC-1	CM
GTTATTCTCGACTTAG-1	CM
CCGCATTAGTTAGAGT-1	CM
CCTGGGAGTACTATGC-1	CM
ATATTCCGTCGACTGC-1	CM
TGCTATTCAAGGAACC-1	CM
AACCTTTAGTGAACCG-1	CM
GCCAGCAAGACCAATA-1	CM
CGCTAGGGTGAGGTCA-1	CM
GGAACCCGTGTCTACA-1	CM
GTTGGTAAGCAGGAGG-1	CM
TACCTCGAGCAACGGT-1	CM
ACTAACGGTCTTAGCA-1	CM
AGCTGATAGCGTATCT-1	CM
CACGTTCCAAAGAAGG-1	CM
GCCATAATCTTGTCAT-1	CM
AAACTGCGTCATCGTA-1	CM
ACGGATTGTAGTTTGC-1	CM
CAGTATGTCGTGAACT-1	CM
TCACCTGTCGCAAGCC-1	CM
GGAACTTGTTTGCGAT-1	CM
CCAGATAAGCTCCGGT-1	CM
CTTGCCATCCAAGTCA-1	CM
GCGCCAAGTGTCCCAG-1	CM
CCAGAATTCCCTAAAG-1	CM
CTCATGCAGGATGCCA-1	CM
GCTCACTGTGATAAGT-1	CM
ACCAAACAGCGTTAGG-1	CM
TCAGGGCCAGTTGCAT-1	CM
AACGAGGTCGAGAACG-1	CM
AAGGTTCTCGCCAGAC-1	CM
CTCTCGATCGCAGATT-1	CM
GGTAGGATCTGTGTCC-1	CM
AGATTCGGTCGTCGCA-1	CM
CATGTTTCACAGTTCA-1	CM
TGCTATTTCAATCGTG-1	CM
CAGGGCTTCCATTGTT-1	CM
GAACGTTTCCAGGTCG-1	CM
CGAGTTACAAGGGTAC-1	CM
TATGTGGAGAGTAAGG-1	CM
AGCTATGAGCAGAATT-1	CM
GTACTTTGTTTAAGGA-1	CM
ATTACTCCAGGTGTCC-1	CM
GCTTAAGAGGCATGCA-1	CM
ATATTCCGTTAAGTCC-1	CM
TGCCTGTGTTTGCGAT-1	CM
TAGTCCCGTAAACGTA-1	CM
GATTAGCTCTCCTTAA-1	CM
ACTTCCGTCACCGCGA-1	CM
GCGAGTCAGACCCATT-1	CM
AATGGAACAAGCTTTG-1	Myeloid
TAGGTCATCTCTGACC-1	CM
TGACAACCAAGGCGTA-1	CM
TTACCCGGTTCCCGGA-1	CM
GGTGTCGCAAGAGATT-1	CM
ATTTGTCCAAGTAACA-1	CM
TTAGCTTAGGTTCGTT-1	CM
GGATAGGTCCTCCTGA-1	CM
TAGCCGGTCCCAGCGA-1	CM
GCGATCGTCAGAGTGG-1	CM
TCTAGTTAGACACTTC-1	CM
GCCAGACAGATATGTG-1	CM
TATGTGGTCAGAATGA-1	CM
GATGGCCGTGAGGGTT-1	CM
TTCGATTTCCATAACG-1	CM
TAGCGGCGTCCTCAGG-1	CM
TTCAACTGTCTGGATT-1	CM
AACCTTTTCGGTGATT-1	CM
CATAACGAGTAGAAGG-1	Fib
CTACTTATCTCTATCA-1	CM
TGGAAGGAGCTTCAAC-1	CM
ACTGTCCCACCCATCT-1	CM
AGGCGTCCAGAAGTGC-1	CM
CCTATTATCGAGGTAG-1	CM
CAGTGCGAGTACAGTA-1	CM
CTCAGCTTCGAGCGCT-1	CM
AAATGAGAGCTAACAA-1	CM
TGGTCCTCAAGATGCG-1	CM
ACTGTCCGTCTGGTTA-1	CM
TCGAGCGCACAACGGA-1	CM
TGCGTAAAGGTTGTGG-1	CM
CTCTAGCCATGCCCTT-1	CM
TTTGCGCAGTATACGA-1	CM
TGCCTGTGTGTGACCC-1	CM
AGCCTTCGTCATAGAA-1	CM
TACGGATGTACAAATG-1	CM
TTTGCGCCACTCCACT-1	CM
TATGTTCTCGCGATGC-1	CM
GGGAACAGTTGAATAG-1	CM
GATTGACAGGTTCGAG-1	CM
TGATCAGTCATGCTTT-1	CM
GTCACTCAGGCGTCCT-1	CM
GTGCTGGCATACAACC-1	CM
CTACAGACAGTAACGG-1	Fib
ACCGAATAGTTAGAGT-1	CM
CACCTTGTCAGAACGG-1	CM
GGACACCAGATATGAC-1	CM
AGCCCGAAGTGCCCTG-1	CM
CCTGCTAGTGGTTCTA-1	CM
ACAAACCTCTCATATC-1	CM
AACGAGGAGAACGTCG-1	CM
CTCATGCGTGCTTTGA-1	CM
GAAGTGGGTCCAAGAG-1	CM
GGCACGTTCTATCCTA-1	CM
CCACGTTCATGCTATG-1	CM
TTACCGCAGGTAAGCC-1	CM
GCACGGTGTCGTCGCA-1	CM
CCTGCTAGTTATGCAC-1	CM
GGAACTTGTAGTTTGC-1	CM
ATGGATCGTGGCCTCA-1	Fib
GCACCTTAGTTAGAGT-1	CM
GGAACCCTCAATGCAC-1	CM
CGGACCAGTTTGACCA-1	CM
GTGATCAAGCTCCGGT-1	CM
CGCAGGTTCGTGATAC-1	CM
CCGTGAGTCACAACAC-1	CM
AATGGCTAGGAAGGTA-1	CM
GACCCAGTCTCGCGGA-1	CM
AGTTACGCAGTAACTC-1	CM
GCTCAGGGTACCCACG-1	CM
GGGTTATAGCTCGGCT-1	CM
CCCACATTCTGGCTAA-1	CM
ATTGTCTTCGATTACG-1	CM
GCCAGCACACTTTGGA-1	CM
TGGAAGGAGGTTGTTC-1	CM
GCGGAAAAGAGTTTGA-1	Myeloid
TGTGGCGGTCTTAGCA-1	CM
TTAACGGAGCGCAATG-1	Fib
ACTGCGGGTACGAGAC-1	CM
GGGAACAGTAGCATGG-1	CM
CGTTCCACAAGTTCGT-1	CM
GATCGTATCGCTATAG-1	CM
GTGGATTGTGATTCCA-1	CM
ACTTTCAGTGCGCTCA-1	CM
TTGAGCAGTATCTAGC-1	CM
TAAACCGCAAGCGACA-1	CM
CACTAAGAGGCTTTAC-1	CM
AGCTGATCATAGTCCA-1	Fib
TTCTAACAGGCGACTA-1	CM
TATGTGGAGAGAGTTT-1	CM
CACCACTAGAGGCAGG-1	CM
ACGGATTAGGAGTCTG-1	CM
CCTAAAGGTCCCTAAA-1	CM
GAGATTCCACAACGGA-1	CM
TGGCAATAGAGCGAAA-1	CM
CGAGTTAAGGCCAATG-1	CM
TTACCCGGTATGGGTG-1	CM
CTGGCAGAGTGTGTAA-1	Fib
AGGACGACAAATGCTC-1	CM
TAACGGTAGACTCGGA-1	CM
TAAACCGTCGGAAAGC-1	CM
GACTAACAGTGTCGCC-1	CM
GATTGACAGTTGCTTG-1	CM
GAGCATTGTCAACTAC-1	CM
GAAGAGCAGTACCTCA-1	CM
TGTAGCACAAGACACG-1	CM
AACGAGGAGCAACTGG-1	CM
TTTGGCCGTCTCTGCT-1	CM
ATAGTCGAGACTAATG-1	CM
AGGCGAAAGACGTCAG-1	CM
GTACTTTCATTGCACA-1	CM
TAAACCGTCCTAGAGT-1	CM
GAGGTCCTCCGCGATG-1	CM
GTGATCAGTGATCAGG-1	CM
TTTGTGTGTCCCTAAA-1	Fib
GCATTGAAGGCGCTTC-1	CM
CCTAAAGGTTGGCTAT-1	Myeloid
CAGGGCTGTGCTTGAT-1	Myeloid
TTGACGAAGTCCGATT-1	CM
CGCACAGGTAGCGAGT-1	CM
TCACAAGAGGATTGCG-1	CM
TATCTGTTCTTGTACT-1	Fib
TGTAGCAGTACGCCCA-1	CM
TTAGCGATCACAACAC-1	CM
TTGCACCCACCAAGGA-1	CM
AACTGTGAGACGTCAG-1	CM
GAGCATTAGGAAGAAC-1	vSMCs
GCTCAGGCAGAGAGAA-1	Fib
CACCTTGTCAGCACTA-1	CM
TGCCTGTAGACAGCTG-1	Endo
CGCTGGATCGCTCTAC-1	CM
CCATACCGTACCGGCT-1	CM
CTGTATTGTCAGAGTG-1	CM
AACGTACTCTCCAACC-1	Fib
TTACTCAGTTTCTACT-1	CM
CCGTACTTCGTTACAG-1	CM
AAACGAAGTAGCTGTT-1	CM
TCAGCTCTCAAACCAC-1	CM
TAGGTGTTCCGGCTGA-1	CM
CAACCAACAATTCTCT-1	CM
ACTGCGGAGATCCGAG-1	CM
CGCTATCCAAGCTTTG-1	CM
TGCCTCAAGAGCGGTT-1	CM
GTTGGGCTCGTTCTAT-1	CM
ACAGACTTCGCAAGCC-1	CM
GTGGCGTGTCAACAGG-1	CM
CCGTAGGAGAAACGCC-1	CM
CGAGTTACAATGTAAG-1	CM
GCTGAGCCAGTATACC-1	CM
TGTACAGTCCCGCAAG-1	CM
GAGGATGGTTTAAGCC-1	CM
TTCGATTAGCGCACAA-1	CM
TTCATTGTCCTTTGCG-1	CM
GTCACAACAGTATACC-1	CM
TTGCGAACAAAGCATA-1	CM
AAAGGATCAACGGACA-1	CM
TTGCGAAAGTCATACC-1	CM
GCTTAAGTCCCGGGTA-1	CM
ATGTCGAAGCCGCAAA-1	CM
TGAATCGTCCTCTCTT-1	CM
GCCTAGGAGAAATTCG-1	CM
AAGGTTCTCCAGGGAA-1	CM
AACCGATGTTCTTATC-1	CM
TTCATCATCTAAACGC-1	CM
GTAGGAGTCAGGCGCT-1	CM
GATCGTACATTGCACA-1	CM
AACCTGACAACCTCCT-1	CM
CATAACGCACCTGGTG-1	CM
TACGGATGTATGTCCA-1	CM
ACCCAAAAGTAGACCG-1	CM
CAAGAAATCATTGCCC-1	CM
CTAGGATTCCCTATTA-1	CM
CTTGCTGTCGGTCAGC-1	CM
TTTGTGTTCCCGTATC-1	CM
CACATGAAGTCCAGAG-1	CM
TATCTGTGTGATCAGG-1	CM
GCTTGCTGTTCAGAAA-1	CM
CCTTGCACAAGTCTGT-1	CM
TGGCCTTCACCTGAAT-1	CM
ATCCTCGCAAGTAACA-1	CM
CATAACGTCTACCCGT-1	CM
GACTAGTGTGGCATAG-1	CM
CTTTGCGAGATACCAA-1	CM
GCATGATGTTTGTGAC-1	CM
AAAGGATCAAGCCTTA-1	CM
CTTGTCGGTTAGTAGA-1	CM
ACGTGGCTCTTGTCAT-1	Fib
CCCTGATAGTCTAGAA-1	CM
TACGGATAGAAGGGCG-1	Fib
ATTGTCTAGACGCCAA-1	CM
CGTACAACATTACACG-1	CM
ATCCAGACAGTTCGGC-1	CM
TGTACGATCAGAATGA-1	CM
TGCGTAATCCTGGAAT-1	Fib
TCAGCTCGTAAGTCTC-1	CM
TGGACATAGTATGCTC-1	CM
AGCTATGAGAGAGTTT-1	CM
GAAACAAAGCGTAGCA-1	Myeloid
AAACTCGCACTCCACT-1	CM
GCTTAAGTCGGACGAA-1	CM
ACAAACCTCGCGTGAC-1	Fib
ACTACGAAGTGCAACG-1	Fib
GGAGAACGTTTAGGAA-1	CM
TACATGGCAGAATGCG-1	CM
GGCGAAACATCGTGAT-1	CM
AGTGCGCGTGCGTAGA-1	CM
ACCGGGTAGAGCGGTT-1	CM
CTGTATTCATGGCCGT-1	CM
TAGTCCCTCCTAGAGT-1	CM
TTGCCCAAGTCAACTC-1	Fib
GTAGACTGTGGGTAGT-1	Fib
TTTGGCCGTGGTAGAC-1	CM
CGCTATCTCGGATCGC-1	CM
AACTGTGCACAGTTCA-1	CM
CCAATGAGTACTTCAG-1	CM
GGGAACACAAGCAACG-1	Neuronal
CGTGGCATCCACGGCA-1	Myeloid
TGCATGAAGGTTACAA-1	CM
TGTACAGTCTTCTTCC-1	CM
TTACGGAGTCAACTAC-1	CM
ACTAGGTAGGTACATA-1	CM
GCAACCGTCCTCCCAA-1	CM
TACATTCTCGTGGTAT-1	CM
AAGGTTCGTATCAGCT-1	CM
ATTGTGGCAGTTGCAT-1	Fib
TCGATTTCAAAGGAAG-1	CM
TAATTCCAGTATAGTG-1	CM
TGGACATGTACGTATC-1	CM
GACTAGTGTTCATTTC-1	CM
CAAAGCTCAAAGGTCG-1	CM
GCGAGTCAGAGCCACA-1	CM
CTTTGCGGTTTCTCTA-1	Fib
CCATACCGTGCTGTGC-1	CM
CTTCTAACAAATGCTC-1	Fib
TGCATTTAGTCTAGAA-1	CM
GAGATTCGTGGTAGAC-1	CM
GTGGCGTCATTAGCAC-1	CM
GAGCATTAGTCTGGGA-1	CM
GGAGGATCACATGATC-1	CM
AGGCCTGAGCTTTCCC-1	CM
AACCTGAAGGCAGATC-1	CM
AGCCAGCCATCATAGC-1	CM
TTAGGTGAGTCAGGAC-1	Fib
TCAGGGCAGTCATACC-1	CM
TAAGTGCGTTGGAGGT-1	CM
TTGAGCACAGTTACAC-1	CM
CGCTATCGTATTCTGG-1	CM
AGTCAACCAACTCGTA-1	CM
GCGAGAAGTGTGAGGT-1	CM
GCACGCAAGCACCATT-1	CM
ACAAGCTGTAACACTC-1	Myeloid
AACCTGAAGACCGCAA-1	CM
CCATACCAGACACAAT-1	CM
CCACGTTTCCCAATGA-1	CM
ACCTGCTGTTTGCGAT-1	CM
TGCTTTACAACGCAAG-1	CM
GGAGAACCAATTGCCA-1	Endo
TAACTTCCAATAGTGA-1	CM
CCACGTTTCTGGCCAG-1	CM
GCTTTCGGTAATGCAA-1	CM
ACAGACTCAAAGGTCG-1	Fib
ACTACCCCAACTCAAC-1	Fib
CTCTCAGTCGCGTGAC-1	Fib
TAAACCGTCGAGGCTC-1	CM
AAACGAAGTTAACTCG-1	CM
GATGATCAGACGTCAG-1	CM
GTTCAAGAGTGCTAGG-1	CM
GCTTAAGTCTGATCTT-1	Fib
GGCGTTGAGCGGACAT-1	CM
TATTGCTGTGGACAGT-1	CM
GCTTAAGTCCATGACA-1	Fib
GCGTTGGGTCTGTCCT-1	CM
CCCTAGTAGGCAAGGG-1	Fib
TGTACAGGTTTCAGCA-1	CM
GTCTACCCAAGTAACA-1	Fib
CCTATTACAGCAACCC-1	CM
TTCGCGTCAGTTGCAT-1	Fib
CATTGGAAGAGGAAGT-1	Fib
TACTAGGTCAGGAAGC-1	CM
CAAAGCTGTTGCAGAG-1	Pericyte
CGTACAACATAGGCGA-1	Fib
CCATACCCATCAGCTA-1	Fib
TTGTCTAGTGCATTCA-1	CM
GCGGGTTGTGTGTGTT-1	Fib
ATGTCGATCAGTGTGT-1	CM
GCGTAGCCATCGACGC-1	CM
TCGCCTACAGATTTGC-1	CM
GCTGTTCGTGATAACA-1	CM
TCAAGGTTCCGCTCTA-1	CM
CTAACTTTCCAATCCC-1	CM
GAAAGTAGTCTAAGAA-1	CM
GTCACGGTCATTCTTG-1	CM
GCCCGAACAAACCGAG-1	CM
TCACCACTCCATACGA-1	Fib
GCGTAGCAGCAGGACT-1	Myeloid
CAGTATGGTCGAGGAT-1	Fib
GGCGAAATCCAGAGAG-1	CM
TTGAGCACACGGTTAT-1	Pericyte
GTTACTTGTCAGAAAT-1	Fib
TGCCTGTTCTGATCCC-1	CM
ACATGGTGTCCCTTTG-1	CM
CCAATGACATAGGCGA-1	CM
TTTACGTGTCCCGAGT-1	CM
AGATAGAGTTCTACGA-1	CM
TACGCAACATGTCCCT-1	Fib
GTAGACTCAATACTGC-1	CM
TTGGTCCCAGCTATAC-1	CM
GGTTGCGTCTTAACGG-1	Fib
TGTACAGTCGGGACAA-1	Fib
TAACAGCCATTACACG-1	Pericyte
ACTAACGAGCGATACG-1	CM
GTCTACCAGTCAGGAC-1	CM
AGGCGTCCATAGCAGG-1	Pericyte
AGATAGAAGGGAAATG-1	Fib
TAACTTCAGAAGCCTG-1	CM
TTGCAGAGTCCAACCG-1	CM
GGAGTAGAGTTGCGCC-1	CM
TAGCTTTTCCAACGCG-1	CM
TCAAGCATCACAGGGA-1	CM
TGTACGACATTGTGAC-1	Fib
TTCGATTCAGATGGCA-1	Fib
AACAAAGAGTAACACA-1	Fib
TCAGTTTTCGGGTCCA-1	CM
GTAGACTAGTTACCAC-1	Fib
ATGTCTTAGCTGAATA-1	Fib
TTGAGTGCAGGCAAGT-1	Fib
CCTCCCTTCAGTGGTT-1	Fib
TCGATTTGTCTAAGAA-1	CM
AGCGTGCCAATTCGTG-1	CM
GAAACAACACCCATCT-1	Fib
CTTGCCACAGTCAGCC-1	CM
CCGTACTGTTAGGAGC-1	CM
CTCAGAATCACTACCC-1	CM
TCCATCGCACCTGTGG-1	CM
CATTCCGAGCCATGGA-1	CM
CCGAAGCGTTAACCAC-1	Pericyte
AATGGAACATGCTATG-1	CM
GTTGGGCAGCTTACCA-1	Fib
CCGTACTGTATACGCT-1	Fib
ATATTCCTCACAGGGA-1	CM
TTCATCAAGTCAGCCC-1	Fib
CAATCCCGTGCTGTCG-1	Fib
ATTACCTTCTCCTTGG-1	CM
ACTCGGGAGGAAGGTA-1	CM
CCTTGGTCACGCGACT-1	CM
ACTACCCCAGTAGTCT-1	CM
CATTGGATCCATCTAT-1	Fib
ACCATCCTCCGGCGAT-1	CM
ACTACCCTCAGTCAAC-1	CM
TATTGCTGTTTGCGAT-1	Fib
TTCATCACAAGACACG-1	Pericyte
ATGCATGTCCTATCCG-1	CM
TTCATTGAGTGCTGAG-1	Myeloid
TGTACGAGTATGGTTC-1	CM
TAGCCCTTCACCACAA-1	Fib
TGGCCTTGTAACGGCA-1	Fib
TGGCCTTGTTTCGTTT-1	Fib
GCGAGTCCATGGGTGA-1	Fib
TGGGTTATCAATCGTG-1	Fib
TTAGCTTAGACTCTTG-1	CM
AGTCAACTCTTTATCG-1	CM
GGATGAGTCTTACTCA-1	CM
AATGTCGAGACCAATA-1	CM
GGAATCTAGGAAGAAC-1	Fib
GGAACTTAGGCATGCA-1	CM
CTTGCCATCTTAAGCG-1	CM
CACTAAGCAAGACTAA-1	CM
CGTACAAGTACGCAAG-1	Endo
ACAGGCCGTGCCCTAG-1	CM
CTAACTTGTAGTTTGC-1	Fib
CAGCTGGTCGTTACAG-1	CM
GTTACTTAGCCGCTGT-1	CM
AATACGCGTATTCGCA-1	CM
ACCGAATAGTTCGACT-1	CM
ACCATCCAGCCATGGA-1	Myeloid
TAGCACAAGATATGTG-1	Fib
CGTGGCAAGTGATAAC-1	Myeloid
TTCGCGTGTCCTATTT-1	Endo
TTCTGTATCGTGATAC-1	CM
ACAAGCTTCAGTTGAC-1	Fib
ATTACCTAGGCAGATC-1	CM
TAGGAGGTCGATTACG-1	CM
CTCTACGAGTGAGTGC-1	CM
GGGTCTGGTGTCCCAG-1	Endo
AAAGGATAGTTCAAGA-1	Fib
CCCTAGTAGTCCAGAG-1	CM
GACCCAGCACAGCTTA-1	CM
GAAGAGCGTAAACGTA-1	CM
GGTGCTGGTCAAACAA-1	Fib
GATCGTAAGACGACTG-1	Myeloid
GCTCAGGGTCAGGCTC-1	CM
CACAGATAGTGATAAC-1	CM
AGTGTACCACCTGAAT-1	CM
GAGGATGCACCTACCT-1	CM
GCGGGTTGTATGGATA-1	Endo
TTGTCTATCGTTGTAG-1	CM
TGGAAGGCACCCATCT-1	Fib
TAGCCGGGTTTGTCTT-1	CM
AAGATAGAGCGCACAA-1	Fib
GTCACAAAGGCGTAGT-1	Fib
GAGATTCAGAGGCGGA-1	CM
CTCGCTAAGGTGTTGG-1	Fib
CAGCTAATCTGTGTGA-1	Endo
GTGTCAAAGGGTAATT-1	Fib
GCCAGCACAAAGAAGG-1	CM
GCTGAGCGTCACCCGA-1	CM
GCGTTGGAGGTAAGCC-1	Fib
ACCATCCCAACGACAG-1	CM
CAGTGCGGTACGGAGT-1	Fib
CAGTGCGGTTCATTTC-1	Endo
TACATGGTCCTAAAGC-1	Myeloid
TTGCGGGGTACGGATG-1	CM
GGGACCTTCTTGTCGC-1	CM
CACATGAAGACCCTAT-1	CM
ACAAGCTCAACTGCGC-1	Endo
TGGCCTTCAGGTGTGA-1	Fib
AACAGTCCAGCTGATT-1	Fib
TTGTTGTAGCAATGTA-1	Fib
GTAGACTTCGCTCTAC-1	CM
GTAGTACTCTTAACGG-1	CM
GCTTGCTTCTAAACGC-1	CM
TCACAGACAAGGCGTA-1	Fib
AATGGCTGTCCGTGCA-1	Fib
CCGTGAGGTAGATTAG-1	CM
GGTGCTGTCTATATCC-1	Fib
TACCCTGCAAGAGATT-1	CM
TTTGGCCTCATCGCCT-1	CM
GCATTCCTCCAATAGC-1	Endo
GGGACCTTCCTAAGTG-1	CM
TTCGGTCCAATTCGTG-1	Pericyte
TATCGAGCACAAACGG-1	Endo
GAAATGACAAGTAATG-1	CM
GGCATTAAGCCCATTA-1	CM
CATTCATAGCGTTAGG-1	Myeloid
GGGCCATTCCCGGGTA-1	CM
GTGTGATGTCAAATCC-1	CM
CTGGCAGCATGGTATC-1	Endo
ACTTCCGCATTGCGAT-1	Fib
GTTATGGAGTGTGTAA-1	CM
GCTCAGGGTAACCATC-1	CM
CTGTATTAGGTGAACC-1	CM
CACTAAGAGATGTTGA-1	Fib
AACCGATGTGTCCAGC-1	CM
AGCGTGCAGCGCCTAC-1	CM
GATCATGAGTCCGGAA-1	CM
TGCCTGTCAAGCCCTG-1	CM
TAGCCGGGTAATGTAG-1	Neuronal
TGGTCCTTCAGCCGGT-1	Fib
CTTGCCAGTACGGTTT-1	CM
GAGAACGTCCAAGTCA-1	CM
TCGATTTCATTGCACA-1	CM
TCAAGGTAGTCGTACT-1	Fib
TGCTTCGAGCTGAATA-1	Myeloid
AGTGTACGTGAATCGG-1	CM
GTGTCAACAAGCAGGT-1	CM
CCTAAAGCAAGACACG-1	Pericyte
CATTCCGTCACTCGGG-1	CM
TCAGGTACAAGTTGCT-1	Fib
GTTACTTGTAGTGATA-1	CM
TGATCAGTCAACTTGG-1	Fib
GGTACCGCAATTGTGC-1	Fib
AGCGTATAGTTCGCGC-1	Pericyte
ATGGATCGTAGTTTGC-1	Fib
GAACTTGCAATTCAGC-1	CM
ACCGGGTAGCTCGGCT-1	CM
GTAGGAGAGGTTAGTA-1	Endo
GCCTAGGCATCATCGA-1	Fib
CGGTGCAAGGTCACTT-1	Myeloid
CCTCCCTGTCGAGAAC-1	CM
CCTGGGAGTATTCTCT-1	Fib
GTGATCAAGCCATCAT-1	Myeloid
AGACAAAAGAGATTAC-1	Myeloid
TCCATCGAGGGTCCCT-1	CM
AGCCGCACAAATGCTC-1	Myeloid
TCGTTCGGTTCTTATC-1	CM
GACCGACGTGACAAGC-1	Endo
GGGAACATCCTCCTGA-1	Fib
AGCTGTATCTTCATAC-1	Endo
TCACCACAGTCTCGAT-1	Fib
TACATGGAGAGAAGCA-1	vSMCs
GCGGTGTAGAAGCCTG-1	Lymphoid
TTCATTGGTTTGACCA-1	Endo
GCGAGTCCATCCCTCA-1	Fib
TTGTTGTCAGTAGTTC-1	Fib
TTGTCTAGTTCCCAAA-1	Fib
CCCACATGTGCGTAGA-1	Myeloid
TTTGAGGCAAGTCCTA-1	Endo
GTCACTCTCACATCCC-1	CM
CCTATTAAGTGAGTTA-1	Fib
CTGTTCGCATGGTTTG-1	CM
GACTAGTCAACAAACA-1	Pericyte
CCTGCTAGTGATGCGA-1	Endo
CTGTTCGAGAAGAGTG-1	Fib
CACAACAAGAACTCCT-1	CM
TGACTCCGTTGGACGA-1	Fib
CCCAGAGGTACTTCGA-1	Fib
CAAGCTATCCCGTATC-1	CM
TAGGAGGAGTCTCTAG-1	CM
CCGTACTAGGACTTTC-1	Endo
AGCCTCTTCGCTCGGA-1	CM
AGTGTACCAAGACTAA-1	Endo
TACCTATGTCGGCTGT-1	Endo
ATTACTCCATAGGCGA-1	CM
GCGGAAATCATACTTC-1	Fib
CCGTACTGTGGACAGT-1	CM
ACAGACTGTCAACGGA-1	CM
TCGGGACAGCCTGTAT-1	Endo
GTGACATAGCTAGCAG-1	Pericyte
GCAAAGGCATCGGCTG-1	Pericyte
TTCATTGCACTAGGAG-1	Pericyte
ACTGTCCAGGATGTAT-1	Endo
CGCACAGTCTTCCAGC-1	CM
AGCTGATGTATTCACG-1	Fib
AGTCCGGAGGCGCTTC-1	Myeloid
TCACAAGTCGGGACAA-1	CM
GATGGCCCAATACTGC-1	CM
GACCCAGGTTTGCCAA-1	CM
ACCGAATTCAATCGTG-1	Myeloid
TGTACAGGTTTGGATC-1	CM
CGCACAGTCTGCCGAG-1	CM
CGAGTTAAGGAGTAGA-1	Endo
CCGTGAGTCCAAGTCA-1	CM
GCCCGAACACATGATC-1	CM
TGCTCGTAGTATGGGC-1	CM
TACTGCCTCCTTGACC-1	Myeloid
ATCCTGCCAAGTCCTA-1	CM
CAATCCCTCTCTGACC-1	CM
GATGGCCAGCTGGAGT-1	Endo
ATTGTCTGTGCCCAGT-1	Fib
GATGGCCCAGCGTCGT-1	Endo
GTGATCACACTGATTG-1	Endo
GATTAGCAGTCCGTGC-1	Endo
GGTGAAGTCGCTTACC-1	CM
GACTAACGTTCACGTA-1	Endo
GAAGTCTGTCGCGCTA-1	CM
GGATAGGTCCCAGCGA-1	Endo
TGCTCGTTCCACGGCA-1	CM
GACCTTCTCGCTTGAA-1	CM
GCGATCGTCTCCTTAA-1	CM
TGTAAGCAGTGAGTGC-1	Endo
AAAGGATCAAGTAATG-1	Myeloid
ACCGCAGTCGGTCAGC-1	CM
AAAGGATCACGCTAAT-1	Myeloid
ACTACCCAGATGGCAC-1	Fib
TCTATTGTCTGAGTCA-1	Fib
GAAACAACATAGCCAT-1	CM
GCATGATAGTTGTCCA-1	CM
GCCTACTGTCTCAAAC-1	Fib
GGATGAGCACAACGGA-1	Pericyte
ACTCGGGAGGGTGTTG-1	Endo
ATGTTTCCAGTCAGAG-1	Neuronal
TACATTCGTGTGAGGT-1	Myeloid
ACGTGGCAGTCTTAGC-1	Myeloid
CTTAATCGTGCACTTA-1	CM
CTGCGTTGTTACGCTA-1	CM
CCGTGAGTCGATAGGG-1	CM
TGCTCACTCGGAAAGC-1	Fib
ACAGGCCGTAGAACGC-1	CM
TAAGTGCCATGTCCCT-1	Endo
GAACCTAGTGATAAGT-1	CM
TTGTCTACAATCAGGG-1	Lymphoid
TCAAGACAGCCATTCA-1	CM
ATCCAGACATTATGGC-1	CM
TAGGTCACAGGCATCC-1	CM
TCGGGACCAGAGAGAA-1	Pericyte
AATGGCTAGTGGTGTG-1	Neuronal
ATAGTCGCACGGCCAT-1	Fib
TGCCTGTAGATATGTG-1	Pericyte
CTGTATTCATGCGCTG-1	CM
TCAAGGTGTTTGATCG-1	Endo
GTACTTTAGTGATTAG-1	CM
TCGCAGGCACTACACA-1	Endo
AACCGATTCCACCTAC-1	Endo
TTAGCTTGTGCTTGAT-1	CM
ACGTGGCGTACAAGCG-1	Endo
GGAACTTGTGTCGTGC-1	Myeloid
TACTAGGAGTCGTACT-1	vSMCs
TGTAAGCCATCCCTTG-1	CM
CCTGGGAAGACACTTC-1	CM
ACTACGACACCTACCT-1	Pericyte
TCGTTCGGTGTCCAGC-1	CM
CCTAAAGCAGAGTCGA-1	CM
GAAGAGCAGGCTTCGC-1	CM
GCTGCGACACTGGGCT-1	CM
GCACCTTCAGGTCCTG-1	Pericyte
CAGCCTTAGTCATCTG-1	Fib
GAATCTGAGACTCGGA-1	Endo
AATGCCACAGGTGTCC-1	Myeloid
AACTGTGTCTATTTCG-1	CM
GTTATTCAGTACAGAT-1	CM
TATCGAGCATTCACGA-1	CM
CTTCTAATCAACACGT-1	Endo
GGTTGCGAGGCGACTA-1	Fib
GCGGTGTGTGTCCTTC-1	CM
CCTATTACAGGGCTTC-1	Fib
ATTTGTCTCAGTCTTT-1	Endo
AGCTATGTCAATCGTG-1	CM
AAGGAGCTCGACTCGG-1	Fib
TATGTTCGTCATTGCA-1	Endo
CTGCGTTGTTACGGAG-1	CM
TTTGTGTTCCTGTGGG-1	CM
TGCACCTTCTATATCC-1	Endo
CGTTCCAGTGGAAAGA-1	Endo
TGATGCAGTTCCGCGA-1	CM
CTTGTCGAGCCGCAAA-1	CM
CAGCTGGGTACAAGCG-1	CM
TTGCAGAAGATCTCAC-1	Fib
TAATTCCAGTGCACAG-1	Pericyte
AAGGTTCAGCGTTAGG-1	Lymphoid
CCTATTACAGCCGAAA-1	Myeloid
GTGGATTCATCGACCG-1	Fib
GAAGAGCGTCATAGAA-1	CM
TCTCAGCGTACGCCCA-1	Endo
GAACCTAAGTAGTGTA-1	Endo
GCGATCGCATTACTTC-1	Pericyte
TGCTCACCAACGTCGC-1	Fib
GAAGTCTCAACGCACC-1	Myeloid
GTCACTCTCCCGATTC-1	Myeloid
CTCTCGATCCAGGCCA-1	Fib
CAGCCTTAGTGATCTC-1	Pericyte
CAAAGCTGTAGCGGTA-1	Fib
TTAGCTTTCAGTTGAC-1	CM
ATGGATCCACTTATGG-1	CM
AGTGCCGTCTTCCAGC-1	CM
AAGGTTCAGACTCGGA-1	Pericyte
TATGTTCAGTCGTACT-1	CM
TTGGTCCGTCTCGGGT-1	Endo
ACAAGCTCACCACGAC-1	Fib
CTTGCCACACCGTTGG-1	Fib
TCAGCTCGTCCTATTT-1	Fib
TCACTCGTCGTTACAG-1	Fib
TTTGGCCGTCTGAGCC-1	CM
AGTTTGGTCGGGTCCA-1	CM
ATTGTGGCAACGGACA-1	Endo
GTACTTTCAACTCGAT-1	Fib
TGCATTTAGGATGTCG-1	Fib
TTTGTGTCATTTGTTC-1	Myeloid
TTGCAGACACTGATTG-1	Lymphoid
CCAATGAGTGGCATAG-1	CM
AGCCAGCGTCAAGACG-1	Myeloid
CATTCCGAGCACGTAG-1	CM
TGTGACAGTTCCATCC-1	Fib
GGCATTATCGACTGGC-1	Endo
GAGTGAGCATCCCTTG-1	Pericyte
GACCTTCTCTCATATC-1	CM
GGATGAGAGTCTAGAA-1	Endo
AGCTGGCCACACATGT-1	Endo
AATGTCGGTCACAGTT-1	CM
GACCTTCGTATTGTGC-1	Endo
GCACGGTTCTATGAGC-1	Endo
GGCGAAATCCGAGGAA-1	Fib
GAAGTGGCATCGAGTT-1	Endo
GGCGAAATCGCGTGAC-1	CM
AGCCTCTTCGAACCGC-1	Endo
CGTACAAAGTGCTGAG-1	Fib
GCTGCGAAGGTGTCGA-1	CM
AATGCCATCGTTCCGT-1	Fib
TGGACATGTACGACCC-1	CM
GGGACCTTCTTCTCTC-1	Fib
GAATCTGCAATGGCAG-1	Myeloid
GCATTGAAGTTGCGCC-1	CM
CCCAGAGTCCTGGGAC-1	Endo
CTTGTCGCACTTTGGA-1	Myeloid
TGAATCGGTCCTATTT-1	Myeloid
AGCCGCACAATCCATG-1	Endo
CTAGGATCATGCACTA-1	Endo
GAGATTCAGAGTGGTC-1	CM
TGGCGCATCGCTGATA-1	Endo
GCATTGACACTAGCCG-1	CM
GGAATCTGTTCCGCGA-1	CM
TGGACATGTCGATAGG-1	CM
ACAGGCCGTTACTACG-1	CM
AAACGAAGTTGGGAAC-1	CM
CTAACTTAGGGCGAAG-1	Endo
TCAAGACGTTATCGAC-1	Fib
CAAGGCCTCTCTGTTA-1	Endo
GTCTACCGTTGCCGCA-1	CM
GCTCGAGAGACAGTGC-1	Pericyte
TTTGAGGGTGCCGGTT-1	CM
CCCTCTCAGAGAGTAG-1	CM
GTGCCAGCAAACCCTA-1	Pericyte
TAATCGGTCGTGCTTC-1	CM
TTGCTTAAGCGAGAAA-1	Endo
GTGCTGGGTACGAGAC-1	Endo
TCTAGTTTCCACGAGC-1	Fib
CAGCTGGGTCCTCAGG-1	Fib
TTTGAGGAGCGCATTT-1	Fib
CTACTTATCGAGGTCC-1	CM
TAATCGGTCCGTCAAA-1	Fib
TACCTATCAGTCAGCC-1	Endo
TAGCTTTGTCCCGTGA-1	CM
ACTACCCTCATCGCCT-1	CM
AGCGTGCCAGAACAGC-1	CM
GCTCCTACAATTGTGC-1	Fib
TTACGGAAGCTACGCC-1	Pericyte
AGTCCGGCATGGCCGT-1	CM
CATAACGAGTTCAAGA-1	Fib
TCAATTCTCGTTGTAG-1	Myeloid
TAAACCGAGTCGCGTC-1	CM
GAGCGCTTCACGGGTC-1	CM
GAGACTTAGTCAGGAC-1	CM
GCGAGTCGTACGTATC-1	Endo
GTCACCTAGTTCAAGA-1	Fib
ACGTTAGTCAGGTTTG-1	Endo
AGCGTGCCAAACCCTA-1	Fib
CGCTAGGCACATGATC-1	Pericyte
CTAGGATTCAGCGGTC-1	Fib
ACTAGGTAGGGCGAAG-1	Endo
TAAACCGTCCTTTGCG-1	CM
TACTAGGTCTGTCGTC-1	CM
GGTGAAGGTCAGCTTA-1	Endo
GATCATGTCAGTAGTC-1	CM
AGCGTGCGTCGCTAGC-1	CM
ATCCAGACAAACCTAC-1	CM
AACATCGCAATTGTGC-1	Fib
CAGTGTAAGTCACGCC-1	Endo
TGAGTCACATTGAACC-1	Endo
AGCCAGCCAGATTGTC-1	Fib
TGGCAATGTTAGGAAT-1	Endo
CTAGGGCCAACCTCCT-1	CM
TACCTCGAGACACAAT-1	Endo
GAGCGCTTCTTGTCGC-1	Endo
GGCACGTAGACTAATG-1	CM
AACCGATCAACCTCCT-1	CM
CACATGAAGAGGTGGG-1	CM
TGCCTGTGTCGCTAGC-1	CM
TACCTCGCATTACACG-1	CM
AACCTGAAGTCAGGAC-1	CM
ATTCGTTTCAGCGGTC-1	Fib
GAGATTCCATACCCGG-1	CM
GATGATCCACCCATCT-1	Fib
GAGATTCAGCCGCTGT-1	CM
CGCGCAATCAGCCGGT-1	Fib
GGAACTTCATGGCCGT-1	CM
CACATGAAGGGCTTCC-1	CM
AGTGCCGTCAAATGGA-1	Endo
GTGCCAGCAGAACAGC-1	Pericyte
AGTCCGGCAAACCGAG-1	CM
CCGAAGCGTATTTGCG-1	Endo
AACGGGACACCTACCT-1	CM
TGTAGCAGTGTCTCGG-1	CM
CATGTTTTCGTCTAGA-1	Fib
GCGGAAAGTTAACCAC-1	CM
TCGAGCGCATACCCGG-1	CM
GATCATGGTCGGCTGT-1	Endo
CTGCGTTGTCAATACC-1	CM
CAAGGCCAGGTTCGAG-1	CM
TACCTCGCATGGTTTG-1	CM
TGCCTGTGTGTGTGTT-1	CM
TACCTCGCATAGGCGA-1	Fib
TACCTCGTCATGCTTT-1	CM
CTCAACCAGTAACACA-1	Endo
AGGCGAAAGAGAAGCA-1	CM
TTCATTGCACCCATCT-1	Fib
TACGGATCAATTGTGC-1	Fib
TCCATCGGTGTCGGTC-1	Pericyte
CCCACATTCTATTGTC-1	CM
CCTTGCACACAGTAGG-1	CM
CGAGTTATCGGGAAAC-1	CM
CTTGTCGCACACGGTC-1	Myeloid
AACATCGCAAGCCCTG-1	CM
TGCATGAGTCCGTGCA-1	CM
