Barcode	cell_type
ATGTACGCAGCGTGAA-1	CM
TAAGTGCAGGGTTCCC-1	CM
CTTGTCGAGATTAGAC-1	CM
CGCAATACAACTCGAT-1	CM
GGAGAACCACAGGAAC-1	CM
TGTAAGCCAAGGACCA-1	CM
AGACAAAGTGCGTAGA-1	CM
CAGCTGGGTAGCTGTT-1	CM
TGATTTCGTCCGGTAC-1	CM
CTCTCAGTCAGCACGC-1	CM
TGGTCCTAGAAGCCGT-1	CM
TGGCAATGTGGCCTTG-1	CM
AACAGTCTCGCAGATT-1	CM
TCTAGTTCATTTGGCA-1	CM
AACTGGTGTAAGTGCG-1	CM
ATCGAGTTCGCCACTT-1	CM
ATCGAGTAGAAGCCTG-1	CM
GGCGAAATCCTTACGC-1	CM
TTCTAACCATAGCCAT-1	CM
CCACGTTCAACAAACA-1	CM
GCCCAGATCCATGACA-1	CM
GCAAAGGCACTAAACC-1	CM
CGTAAACCAGGACCTC-1	Endo
TTTACGTTCCATACGA-1	CM
TTACGTTGTCAACAGG-1	CM
CGCTATCCATGGTTTG-1	CM
CCTCCCTTCCACACCT-1	CM
ATCCTGCTCAGCACTA-1	CM
AAGGTTCAGGGACGTT-1	Pericyte
TTGTTCATCGCTCGGA-1	CM
GGGTCTGTCAAACCCA-1	CM
GACCCAGAGAGGTGGG-1	CM
TGTGGCGTCCTCCTGA-1	CM
AATGCCATCCGCCTAT-1	CM
GTTGGTACATAGAATG-1	CM
TGAATCGCAGTCCTGG-1	CM
TGGTCAAAGGCTTTAC-1	CM
AACAGTCAGTTTACGC-1	CM
CTCAACCGTGGCGCTT-1	CM
AAATGAGTCAAATGGA-1	CM
AACTGGTCAAGGCTTT-1	CM
CCATACCAGACCAATA-1	CM
AAACTGCGTAAACCCT-1	CM
ACATGGTTCTGATCCC-1	CM
CTGGCAGGTTGCTTGA-1	CM
TCAGGGCAGCCTTTGA-1	CM
ATCCTCGCACGCTCAG-1	CM
TCAGGTAAGTGTGTAA-1	CM
GAGAACGTCTCTATTG-1	CM
GTTATTCTCTACATCT-1	CM
GCGGTGTAGCAGAGCT-1	CM
TTCTGTATCAATCGTG-1	CM
GTTGGGCCAAGCGAAC-1	CM
TTGCGAATCTATTTCG-1	CM
ACTAGGTCAACGACAG-1	CM
TTAGGTGGTCTGCACG-1	CM
GCGTAGCTCTAGTCGA-1	CM
TGACTCCTCGTGGAAG-1	CM
ATAGGCTGTTAAGTCC-1	CM
AATGGCTAGCGTGTTT-1	CM
GAGCATTGTAACATAG-1	CM
GCAAAGGCATAGCCGC-1	CM
CTCAGAAAGGTGAACC-1	CM
CATAACGTCCGGCGAT-1	CM
TCAGGGCTCGTTGTAG-1	CM
TGGTCCTGTACAAATG-1	CM
AACAGTCGTTTGAAGA-1	CM
AAGGTTCCAAAGAGAG-1	CM
TGGACATAGAACTAAC-1	CM
GGATGAGAGGGTCTGA-1	CM
TCAGTCCCAGAACGAC-1	CM
GATCATGCACACATGT-1	CM
TGTAGCAAGTATGGGC-1	CM
TATCTGTGTAAAGGCC-1	CM
CTCAACCGTATGGTTC-1	CM
AGGCGAACACATTCTT-1	CM
GGAGAACGTACCTATG-1	CM
CGAGTTAAGGGTGTTG-1	CM
GTTATTCTCTGGTACA-1	CM
CTGGCAGAGTAACTCC-1	CM
TGAGTCACACTCAGCG-1	CM
ACAAAGATCGCTACCT-1	CM
CTTCTAAAGCATTCCA-1	CM
CTCAGCTAGACGCCCT-1	CM
TCTCAGCCATCCGTGG-1	CM
CCAGAATGTGGCATAG-1	CM
GAGGATGAGTAGTGTA-1	CM
CATTCCGAGTCACACT-1	CM
GTCACAATCAGGCCGT-1	CM
GAGTGAGAGAAGAGTG-1	CM
ACAGCGCCACTGGGCT-1	CM
AGCCTGGAGACACGGT-1	CM
GCAGCCAGTCTAACCA-1	CM
GGCATTATCTTACCTA-1	CM
AGGCCCAAGAGCGAAA-1	CM
GGTCATATCGGCTATA-1	CM
GTGGCGTCAAATTCCG-1	CM
GGAGAACGTGCATTCA-1	CM
ATTTGTCCACCGTCTT-1	CM
GGATAGGAGCTGCTCG-1	CM
GAAACAAAGACGCCAA-1	CM
TAGCGGCTCTGGCTAA-1	CM
TCGCAGGCACTCGCAG-1	CM
GACCTTCGTTCCATCC-1	CM
GAAATGAAGCTCCGGT-1	CM
CCGTACTTCCTAAAGC-1	CM
TACTAGGCAACACGGA-1	CM
CCGTACTAGTTCAACC-1	Fib
AAGGTTCAGTCAGGAC-1	CM
GTCGTAACAGTTGCAT-1	CM
TTGAGTGCATCGGCCA-1	CM
TATGTTCCAGATTAAG-1	CM
TATTGCTCAATGGTCT-1	CM
TCACTCGTCACAACAC-1	CM
TGTACAGCACAGATGG-1	CM
GGGTTATTCATGCTTT-1	CM
TCGCAGGAGTATGGGC-1	CM
AGACAAAAGATTAGAC-1	CM
TGCATGACAATACTGC-1	CM
AGCTGTACAAGATGCG-1	CM
CACGTTCAGTTACCAC-1	CM
TTAGCGATCGCTTGAA-1	CM
AATGTCGCACTGGGCT-1	CM
GCAACCGCAGAACGAC-1	CM
GCTCGAGCACTGCTCT-1	CM
GCGATCGAGGTGATGC-1	CM
TCAAGACTCCTTTGCG-1	CM
TGGACATCACAGGAAC-1	CM
CAAGCTATCTCTTCTC-1	CM
TAAGTGCCAGTCAGCC-1	CM
TGGACATGTTGGGAAC-1	CM
CGCTGGAGTAGCAGGT-1	CM
AAATGAGGTAACGGTG-1	CM
CTAACTTGTGGATTTC-1	CM
CAAGCTACAGGCATTT-1	CM
TTACCGCAGGAGTACC-1	CM
AATGGCTCATGTGAGG-1	CM
GCACCTTAGATGGCAC-1	CM
TATCGAGAGTCAGGAC-1	CM
CGCGCAAGTATTGTCG-1	CM
CGCAATACACCTATTT-1	CM
GAAGAGCAGACCGCAA-1	CM
TCAGCTCAGCTTTCCC-1	CM
TCGCCTATCTCTGAGA-1	CM
CCTTAATCACGCGTTG-1	CM
TTCTGTAGTGGTCGAA-1	CM
AAGGAGCGTATCCTTT-1	CM
GTAATCGAGTCGTGAG-1	CM
AAACTGCTCCGGCGAT-1	CM
GTGTCCTGTACCAAGG-1	CM
GGATAGGAGAGAGTAG-1	CM
CTGAATGTCACTTACT-1	CM
ATTACCTGTCAGGTGA-1	CM
GCTCACTCACTGATTG-1	CM
ACTATTCTCACTTACT-1	CM
GAACCTAAGGGTTCCC-1	CM
GATCGTAGTGCGTAGA-1	CM
GGAGTAGAGAACGCCA-1	CM
CCTGGGATCGGTCTAA-1	CM
AATGTCGGTGAGTCGA-1	CM
TAACAGCTCGAGCGCT-1	CM
CTACTTAAGCAGAATT-1	CM
TATCGAGGTCTGGGAA-1	CM
AAGGAGCCAAGGCGTA-1	CM
TGCTATTAGCCTGTAT-1	CM
TCACTCGGTGGACAGT-1	CM
CTCACCAAGGTCTTTG-1	CM
ACTTCCGCACACACCG-1	CM
TTACTCAGTAGACACG-1	CM
GGTAGGATCTTAGTGG-1	CM
GAGGATGTCCCGAAGC-1	CM
TGCTTCGGTGCTGGCT-1	CM
CCACGTTTCCAACAAC-1	CM
CATAACGAGTGTCCCG-1	CM
CTACAGACAGTTCGGC-1	CM
GCGGTGTTCGCACCGA-1	CM
ATGTACGTCTGGAAGG-1	CM
GTGTCCTCATCATAGC-1	CM
AGATAGATCCATACGA-1	CM
TCGAGCGAGAGCACTG-1	CM
ATGGATCGTGATCAGG-1	CM
GCCAGCACATTAGCCA-1	CM
GAACGTTCATTACTCT-1	CM
AACCTTTCAGCAATGG-1	CM
GGGTGTCAGAAGCCTG-1	CM
CTTCTAATCGGTGATT-1	CM
AGCCAGCGTGTGTGTT-1	CM
GGGAACACATGGCCCA-1	CM
TATCGAGGTAACCGAG-1	CM
GAGCATTAGTGAAACT-1	CM
CTACTTAGTCAACTAC-1	CM
ACTTTCAGTTCCCAAA-1	CM
CTGTATTAGTTACACC-1	CM
CACTAAGAGATGTTGA-1	CM
CATGTTTTCTGTGTGA-1	CM
CAACCAAGTATTCTTC-1	CM
GCGGGTTCATAGTCCA-1	CM
AAATGAGAGTTACACC-1	CM
CTAGCGGCAACCTCTC-1	CM
CGGACCAAGGTTGACG-1	CM
TCACCACGTTCTGATG-1	CM
CCCTCTCCAAATTGAG-1	CM
TAGGTGTTCTTCATAC-1	Fib
AATGGAATCCTCATTA-1	CM
GTGTCCTTCCCAATAG-1	CM
TGCGTAAGTGGACTGA-1	CM
GCTCACTAGTAACATG-1	CM
AGCTATGTCGCGGCAT-1	CM
GTTATTCAGTTTGGAA-1	CM
CCTAAAGAGCGAATAT-1	CM
GTAGGAGAGGGTATCG-1	CM
CTGGGACTCCCTACGT-1	CM
TTTGTGTAGACTAATG-1	CM
CGTGGCATCGACTGGC-1	Myeloid
GATTAGCAGATCGATA-1	CM
TTAACGGAGATTGACA-1	CM
TTGTTCACATCCCGGA-1	CM
TAAGTGCGTCGACTGC-1	CM
TACGGATCATTACACG-1	CM
AGCTGGCCAACTCGTA-1	CM
TGCCTCAGTTTGTCTT-1	CM
TGACAACCAAGGTTCT-1	CM
TTGCGGGCATGGGTGA-1	vSMCs
CTTAATCGTGCATTCA-1	CM
CGTAAACGTACCAAGG-1	CM
ACCAAACCACGTACAT-1	CM
CCCTAACTCTGACTTT-1	CM
TCTCTGGCACTCAGCG-1	CM
TGGAAGGCATTTGGTG-1	CM
AAACTGCCACTCAAGT-1	CM
CAGTGTATCTTGTGCC-1	CM
TTGACGAGTGAGGGTT-1	CM
GTGACATTCAACACGT-1	CM
AGTCAACCAAGGAACC-1	CM
GTGTCAACAGCCACGT-1	CM
CTAGGATCAAATGTCC-1	CM
GGAGGATCAGTTGGAG-1	CM
TCCAGAACACCCATCT-1	CM
CCCGTTAAGGCTTAAA-1	CM
TTACTTGAGAGAATTC-1	CM
CTCTCAGGTAATGCAA-1	CM
TTCTGTATCTCTGAGA-1	Fib
ATGTACGTCCCAATAG-1	CM
GAAGTCTAGAGCCTGA-1	CM
TCACAAGCAGGACCTC-1	CM
GTGTGATGTTGGCGAA-1	Endo
GATCATGTCCTGTGGG-1	CM
TCAGTTTAGAATGCTA-1	CM
AACCTTTTCCAACGCG-1	CM
GCTCGAGAGGATGTAT-1	CM
TCACTCGGTATGAAGT-1	Fib
AAGGAGCTCAAGTTGC-1	CM
AAACTCGAGTGCTCGC-1	CM
CCTTAATCAATTCGTG-1	CM
TGGTCAAGTTGGCTAT-1	CM
AACCGATGTGCGTTTA-1	CM
CAACGTACATTAAGGA-1	CM
AATGCCATCTATCCTA-1	CM
CAGCCTTTCCTCCTGA-1	CM
AGCCCGAAGTAATCAG-1	CM
GGAATCTCATAGGCGA-1	Myeloid
GCCTAGGCACAGATGG-1	CM
ACAATCGGTTCCTATT-1	CM
ACCGAATCAGCGCGTT-1	CM
GTACTTTAGGATTAAC-1	CM
TTCTGTATCGGGACAA-1	Myeloid
ATTCGTTAGATCTCAC-1	CM
GCACCTTGTCCGTAGC-1	CM
AAAGATGTCTGTGTGA-1	CM
CTTGCCATCTCGACCT-1	CM
CACTAAGTCTCTGACC-1	CM
GCACGCACAATCAGGG-1	CM
TTTACGTCATAGTCCA-1	CM
CAGTATGCAGGGTAAC-1	CM
AGGCGAAAGATGCGCA-1	CM
TCAATTCTCCTCCCAA-1	CM
TCCATCGAGTAGTTCC-1	CM
GCACGCAGTAGTAACA-1	CM
GGTGTCGCACATTCTT-1	CM
TCAAGCAAGCCTTTGA-1	CM
TCGTTCGTCAACTTGG-1	CM
AACCTTTTCATTCTTG-1	CM
TTCGGTCCAAATTGAG-1	CM
GCGCATGAGTAATCAG-1	CM
GCTGAGCCAAGCAGGT-1	CM
TGAGTCAAGAGACTCG-1	CM
TCTCAGCAGTCTTAGC-1	CM
AAGGAGCCATATACGC-1	CM
GCGCCAAGTATTCTTC-1	CM
CCTATTAAGAACAGGA-1	CM
TCTAGTTAGGGAGATA-1	CM
AAGGAGCAGATACCAA-1	CM
TTGCGGGGTTCCAATG-1	CM
AATGGAAGTAGCGTTT-1	CM
AACTGTGAGGATCCTT-1	CM
AAACGAAAGTCGACCC-1	CM
GAGGCTCAGCCATGGA-1	CM
CTAGGATAGGCAGTAC-1	CM
GCATGATCAAGATTAG-1	CM
GAGAACGGTTGGCTTA-1	CM
TGCTCGTTCAATGCAC-1	CM
GCTTGCTCATGTATCG-1	CM
GGAGAACCAAGGATGC-1	CM
AATGCCAAGTGATTAG-1	CM
TTAACGGAGGGTTCCC-1	CM
ACCAAACTCAGTCTTT-1	CM
TACGCCTGTTTGCCAA-1	CM
GAGCATTAGTCCCGCA-1	CM
CATTCCGTCACAAGCT-1	CM
GCCCAGAGTGCTGAAG-1	CM
TGGCCTTCAGTAGGCA-1	CM
GCTGAGCCATCACAGT-1	CM
TCTAGTTGTCCTTATT-1	CM
GCTTTCGGTGTCCCAG-1	CM
CAACGTAAGTGTGTAA-1	CM
AAACTCGGTATTCTCT-1	CM
GGGAACAGTTCCCGGA-1	CM
TGCTTTAGTTAACCGT-1	CM
ATTACTCCAAGCAATA-1	CM
TGCATGATCTCTATCA-1	CM
TGGCCTTCATAGCCAT-1	CM
TTGCTATGTAAGCCTT-1	CM
TTGTTCAGTGAAACAT-1	CM
ATGTCTTTCGAGAAGC-1	CM
GCACGGTGTAAACGTA-1	CM
GAAGTCTGTCAACGGA-1	CM
GCAAAGGCAAGAGATT-1	CM
TTCGATTTCGAACCGC-1	CM
TGGAAGGGTGAGCTAG-1	CM
GAACTTGCAGGTGTGA-1	CM
CTCTCGATCGGGTCCA-1	CM
TCAAGACAGTAACTCC-1	CM
CTGGGACCAGAACAGC-1	CM
GGTAGGAGTGTCCTTC-1	CM
GCGAGAAGTTGGACGA-1	CM
CAACGTAAGGTCGTTT-1	CM
TGGCCTTAGGGTTCTT-1	CM
CTGAATGAGAGGAAGT-1	CM
TAATCGGTCCATGACA-1	CM
GCGCCAACAATAGTGA-1	CM
ACATGCATCGGCAATT-1	CM
ATTCGTTCACCCTTTG-1	CM
GCCAGACAGGATGTAT-1	CM
TTGACGAGTAAACGAT-1	CM
GGCACGTGTTGTATCG-1	CM
GCGCCAAAGGTTGACG-1	CM
GCTTTCGAGTCTGCTA-1	CM
TCGGGACGTCTGATTG-1	CM
CAACGGCGTTCTGAAC-1	CM
CCTGGGAGTTACTACG-1	CM
ACAGAAAAGTGTTCCA-1	CM
GAGTGAGTCGCTCTAC-1	CM
CTCCCAAAGGCAGATC-1	CM
AAACTCGTCCGGGCAT-1	CM
ATCCTCGTCGGGACAA-1	CM
CTCCCAAAGTGAAGGA-1	Fib
TGCATTTAGGCCAGTA-1	CM
GTTATGGAGTCATCTG-1	CM
GACCTTCAGTCTGTGT-1	CM
AAAGGATCATTGCCTC-1	CM
GTCACAAAGAGAACCC-1	CM
GCTTAAGCACGTTACA-1	CM
CTGCTCAAGTTCGCGC-1	CM
TGTAGCACAAAGCTTC-1	CM
TCAGTTTTCGTTACAG-1	CM
TAGGAGGGTGCATCAT-1	CM
AACAAAGCATGATTGC-1	CM
TGTGGCGGTAAACGGC-1	CM
GAAATGAAGTGTCCCG-1	CM
GCGATCGAGAGGAAGT-1	CM
CCCACATTCCTTTGCG-1	CM
ATTGTCTCACGCGACT-1	CM
CAGCTGGGTGAAACAT-1	Fib
ATTCGTTCACATATCG-1	CM
TTCAACTCAGTATCTG-1	CM
CTTTGCGTCTCTATTG-1	CM
CTACTTATCCTTCGAC-1	CM
GGGTGTCGTAGGGTCA-1	CM
ATATTCCGTCCACCAG-1	Pericyte
CTTCTAACACAAGGGT-1	CM
AAGATAGCATCACAAC-1	Fib
TGGACATCATGCCCTT-1	CM
AATACGCTCCCGTAGG-1	Fib
ACTAACGCAGTTGGAG-1	CM
GAACGTTAGTTCAAGA-1	CM
TTCATTGTCTCTATTG-1	CM
GAGTGAGTCGTGGTAT-1	CM
GTCGTAATCATTGCCC-1	CM
GGGACCTTCTTCATAC-1	CM
TTACGGACATCGCCTT-1	CM
GAACTTGTCGAGTTAC-1	CM
CAAAGCTGTATCTAGC-1	CM
GTGCCAGCAGGTTATC-1	CM
TTAACGGTCGAACCGC-1	CM
TGGCCTTCATCGAGTT-1	CM
ATAGTCGAGCTGAGGT-1	CM
TTGAGCACAGGGCTTC-1	CM
CGCAGGTCACACACCG-1	CM
CTAGGATTCCCTACGT-1	CM
CACATGAAGTTACCAC-1	CM
GACCGACTCGGTCTAA-1	CM
GTACTTTAGTTTACGC-1	CM
TATTGCTCAAGCCCTG-1	CM
AGCCAGCTCAGTCACA-1	CM
TACAGCACACGCTCAG-1	CM
TCGCAGGGTGGCGCTT-1	Fib
AATACGCAGCTGAGGT-1	CM
TATGTGGCAAACCCTA-1	CM
AAGATAGTCGCACCTT-1	CM
TTACTTGCAACGGACA-1	CM
GTCTACCAGTTATGAG-1	CM
TACATTCGTGGTTCTA-1	CM
CGCGCAATCAAACCAC-1	Pericyte
GCATTCCGTGCCCAGT-1	CM
CTAGGATAGCGCAATG-1	CM
CATGTTTGTACCGGCT-1	CM
TGCCTGTGTGACAAGC-1	CM
CCCTAACGTGGACGAT-1	CM
TACGCAATCTCGTAGA-1	CM
GCTGTTCAGTGTCACT-1	CM
TAGACTGAGCCGCTGT-1	CM
AGCGATTCATTCTTTG-1	CM
TCCATCGGTAGCAGGT-1	CM
GAACGTTCAACGCACC-1	CM
GGTGCTGTCACCGCGA-1	CM
TTCGCGTCAGCGCGTT-1	CM
AATGTCGCACCGTTGG-1	CM
CTCTCAGAGCCTGTAT-1	Fib
CTGAATGTCACACGTA-1	CM
CCGTACTGTCGAGGTA-1	CM
AGTGCCGTCACTCGGG-1	CM
TCAATTCGTGAGGTCA-1	CM
CACAACAGTTACACTG-1	CM
GCGAGTCGTTCAGTTG-1	CM
ACTAACGTCTCGACAA-1	CM
CGTACAATCAGTGTAC-1	CM
GTCACCTAGATGTTGA-1	CM
TGCTTTACAGTTGGAG-1	CM
GAGACTTTCTTGCGCT-1	CM
CGAGTTAAGTAGCAAT-1	CM
AGCCAGCGTCACATTG-1	CM
ATTACTCCAGTAACCT-1	Fib
TGCTATTAGCATGATA-1	CM
ATATTCCGTTTGACCA-1	CM
ACATGGTCACCACAGC-1	Fib
TCTATTGCAAAGCATA-1	Myeloid
AGTGTACGTACGCCCA-1	CM
GCTTAAGAGGCCAATG-1	CM
ATCCTGCTCAAACCCA-1	CM
TGCTTTAAGCGTTAGG-1	CM
GGCGAAAGTGACAAGC-1	CM
AATGGCTTCGCTTACC-1	Fib
CCGTACTGTCTGGGAA-1	CM
GCTTTCGGTGAAACAT-1	CM
ACTCGGGCAGCAGGTA-1	Fib
CTGTTCGTCCCTAAAG-1	CM
TCGTTCGGTAGAAAGG-1	CM
GAACTTGAGGAGACTC-1	CM
TTGCTATCACTACACA-1	Fib
ACCCAAATCGTGCTTC-1	CM
AGTCCGGTCTGGCCAG-1	CM
CATGTTTCATCGACCG-1	Fib
TTAACGGTCCTCCTGA-1	CM
TTACTTGGTTCTTTCA-1	CM
CAACGTACAATGCCAT-1	CM
GAACCGCTCCGATGCG-1	CM
GTTACTTAGACGCCCT-1	CM
TTAGGTGTCCAACCTC-1	CM
GTGACATAGTTTACGC-1	CM
AGTTTGGAGAGGTGGG-1	CM
GGTGCTGAGATGGCAC-1	CM
GCGTTGGAGGAGTAGA-1	CM
CTCACCAAGAGTGGAA-1	CM
TTCGATTAGCACCATT-1	Endo
ACTTTCAAGTTTACGC-1	CM
GTCACAACAGGTGGTA-1	Fib
TTACGTTTCCAATAGC-1	CM
ACAAAGAGTGCACTTA-1	CM
ACTATTCAGGTAAGTT-1	Fib
TGGACATAGGTCACTT-1	CM
CAAGGCCCAATTGTGC-1	CM
AAAGGATGTAGCCATT-1	Myeloid
CCGTGAGCATTTGTTC-1	CM
ATAGTCGAGCAGTAGC-1	CM
TGGCGCATCCAACCTC-1	CM
GTGCACGTCACTGGTA-1	Fib
AGCTATGAGCGTCTGC-1	CM
GCGATCGTCGGATCGC-1	CM
GGCGAAAAGTACCACT-1	CM
TAGCGGCGTACCAAGG-1	CM
AACGAGGAGTCAACTC-1	Fib
AACCGATTCACTAGCA-1	CM
GGTAGGAAGTCGCCTG-1	Endo
TTCGCGTTCCACCTAC-1	CM
GACCGACAGCCGCAAA-1	Pericyte
ATCCTCGGTGACCAGA-1	CM
TGGACATAGCGCGTTC-1	CM
AAATGCCGTGGACTGA-1	CM
GCCAGCACAAACTACC-1	Myeloid
AAGATAGGTTGGACGA-1	CM
AGCTGTAAGGCTCAGA-1	CM
TAGTCCCGTATCTAGC-1	Fib
ACTTTCAGTCCCGAGT-1	CM
GAGAACGGTACTTGAC-1	Pericyte
CGTGGCACAGCTGATT-1	CM
GTGCTGGAGCCAGAAC-1	CM
CACGTTCAGGTTGTTC-1	CM
GTGCTGGGTTCTTAGG-1	Endo
AGGCCCAGTAACTGAA-1	Pericyte
CGTAAACGTTTGCATG-1	CM
CTTCTAACAATTCGTG-1	CM
GCATTGAAGCAATGTA-1	CM
CAAGCTAGTGTGCTTA-1	Endo
GTTCAAGCAAGGTCGA-1	CM
TGCCTGTAGCAATAAC-1	CM
CAGCTAATCTGGGCGT-1	CM
ATGTCTTTCCTCTCTT-1	Fib
GATCGTAGTATTCACG-1	CM
AACAGTCAGGAGTAGA-1	CM
CCCTAGTTCCGAGAGA-1	CM
TGCCTCACACCGTCTT-1	CM
TATCGAGGTCTAACCA-1	Fib
CCTTGGTTCTGGCACG-1	CM
GTGTCAAGTGGACGAT-1	CM
TTGCGAAGTTCAGTTG-1	CM
ATGTTTCAGAACGCCA-1	CM
TTGACGACATGTGAGG-1	Endo
AAAGATGAGCGTATCT-1	Fib
AGGACGAAGGAACCGT-1	CM
TGTGGCGAGGACTAGC-1	CM
GCTTAAGAGTCGATAA-1	CM
GATCGTACATGGAGGT-1	CM
TAACGGTGTCACCGCA-1	Myeloid
GGTGAAGTCTGGGCGT-1	Endo
TGTGTCCTCACACGTA-1	CM
CAAGAAATCGGGACAA-1	Fib
GAAACAAGTGCTGTCG-1	CM
CAGTATGCATCTCACC-1	Endo
TGACAACTCTACTGCC-1	CM
TAGTCCCTCACAACAC-1	CM
CAACCAAAGTGCTAGG-1	CM
GACCTTCCATCCCGGA-1	Fib
TTACGGATCCGTCAAA-1	Fib
TACTAGGAGGGATCCA-1	Fib
CTAGGGCCAGATTGTC-1	CM
ATGTCTTTCCGGAAAG-1	CM
CGGACCAGTAGGGTTG-1	CM
GCTTTCGTCAGGGTTT-1	Lymphoid
ACGTGGCAGTAACATG-1	Fib
ATTGTGGCAATCATCG-1	CM
GAAGTGGGTGCACATT-1	CM
TTTACGTTCTGAGTAC-1	Fib
ACCCAAAGTGGACCAA-1	Fib
GCATTGATCACGATTG-1	Endo
GCACCTTGTCTGGATT-1	Fib
GTGCCAGAGACTAGGC-1	CM
TAGCATGAGGATTTGA-1	CM
ACTAGGTAGTTGAATG-1	Fib
TGCTCACAGGCTAAAT-1	CM
GATCGTAGTTCCCGGA-1	Fib
GAGGTCCCATGATTGC-1	Pericyte
GTAGTACCAGGTGGTA-1	Fib
TTGCGGGTCCCGATTC-1	CM
GTCGTAAGTAGTGATA-1	Fib
AAAGATGCATAGATAG-1	Fib
TAAGCCAGTGCATTGT-1	CM
TGCATTTAGCGCATTT-1	Fib
AATGGCTTCCAGTACA-1	Endo
GCCATAAGTGGAAAGA-1	CM
GAGGATGAGAGAACCC-1	Fib
GAAGTCTAGGAAGACA-1	CM
CTCACCATCACCCGGA-1	CM
GCCCGAATCGACTTAG-1	Fib
AGATTCGGTACGCAAG-1	CM
GACTAGTCACACACCG-1	CM
GGACACCCACGCGTTG-1	Myeloid
ATGTACGCAACGCACC-1	CM
CTAGGATGTCCCTTTG-1	CM
ATGCATGAGTTCAACC-1	Fib
GACCTTCTCACGTCAA-1	CM
GCAACCGCATTGATGC-1	Fib
GAGATTCGTTTGTACG-1	Fib
TGTGGCGGTCTGGGCT-1	Endo
TCCCACATCCATATCT-1	CM
GGGACCTGTGCACTTA-1	CM
AAACTCGGTCAAACAA-1	Myeloid
GCCATAACAGATGGCA-1	Endo
TACTGCCGTAACACTC-1	CM
ACTAACGAGCTAGCAG-1	CM
AACGGGATCTGATCTT-1	Myeloid
ACAGACTCAGCAACAG-1	CM
TCCCACACATCCCTCA-1	Fib
CGCTGGATCGAACACT-1	Pericyte
GTAATCGGTTTAGGAA-1	Myeloid
AACGAGGCACAGTTAC-1	CM
TCCAGAATCTCAGATG-1	CM
GCGAGAATCGATAGCT-1	Fib
CGGACCAGTTACGGAG-1	CM
TTGTCTAGTAGAACGC-1	Fib
TTGCTATTCTGCGTCT-1	CM
AATGCCAAGTAGGTCG-1	Fib
AAACGAACAATCCATG-1	Myeloid
AACCTTTGTTGGCTAT-1	CM
CGCTAGGGTTTCCTAT-1	Fib
ATCCCTGCAAAGAAGG-1	Pericyte
AATGGAATCTTCAGAG-1	CM
TAGACTGTCTGGAAGG-1	Fib
GGAGTAGTCCAGGTAT-1	Fib
AAAGGGCAGTGCACAG-1	Myeloid
CACATGAGTTCTTATC-1	CM
GAGGCTCAGTGTAATG-1	Fib
ACTTCCGGTACTTCGA-1	Endo
GACTAACTCCAGGGAA-1	Fib
CAGGGCTAGTATAGTG-1	Myeloid
GAAAGTATCGCGATGC-1	CM
GCAACCGCAGGATAGC-1	CM
CTTGCCAAGAAAGCAG-1	Neuronal
CTTTGCGAGTCGAAAT-1	Fib
GGCACGTCACTCAAGT-1	CM
GCTTGCTAGTCGTATC-1	Fib
AAAGGGCAGAGAGTTT-1	Endo
GCGATCGAGTCGTGAG-1	Fib
CAGCTAAGTGCTGTCG-1	CM
AAACTGCGTTGGAGGT-1	Endo
TACTCGCCATCAGAAA-1	CM
AACAAAGAGGTACATA-1	CM
AGGCGTCAGACCGCAA-1	Fib
GCAGATTGTTGGAGGT-1	Endo
GAAAGTATCGCAAACT-1	Endo
GAACCGCCAAGAGATT-1	CM
TGGCAATCATTACACG-1	Pericyte
TTCATCAGTTCCAATG-1	CM
CATGCCTAGTGTCGCC-1	CM
GCGATCGCAACGCACC-1	CM
GATGGCCCATGGGTGA-1	Endo
GCGGAAATCTCATCCG-1	Fib
ACAAGCTGTTCTGAAC-1	Endo
TGGACATGTAACGTAA-1	CM
CTACTTACATGCGACC-1	Fib
GCTTTCGCACGTTACA-1	Endo
TAGCACAGTTCCATCC-1	Myeloid
CCTGCTAGTTCAGTTG-1	Fib
TATGTGGGTCCTATTT-1	Fib
ACTGTCCGTTCTTATC-1	CM
TTGCTTACACTCGTGG-1	CM
ATATTCCGTTACGGAG-1	Fib
GAAGTCTTCCTTGACC-1	Lymphoid
TTCGGTCAGAGGTGGG-1	Fib
CAACGGCTCCATAACG-1	CM
TACAGCAAGCAGAAAG-1	Fib
CTCCCAACATTACTCT-1	Fib
CCCGTTATCCTTTGAT-1	Pericyte
CCTTGGTTCGAGCGCT-1	CM
ACTACCCCAAATTCCG-1	Myeloid
AATACGCCATCGGCTG-1	Neuronal
CAGGGCTAGCTGAGGT-1	Endo
ACAGCGCGTGTGCTTA-1	Fib
GCCCGAAGTTCGGGAA-1	Fib
TTCAACTCAGGTGGTA-1	Fib
TCAAGCATCCGAGAGA-1	CM
AGCCAGCCAGGTCCTG-1	Myeloid
TGGCAATCACCTACCT-1	Fib
TTCATCAGTGCATTCA-1	Myeloid
AGGCCCAGTTCTTATC-1	CM
TAGGTGTAGAACTCCT-1	Fib
TTGCTTACACATATCG-1	CM
CCCTAGTAGGATGCCA-1	Endo
GTTGGGCGTGTGTGTT-1	Fib
CAATCCCCAGGCACAA-1	Myeloid
GCCATAATCCGATGCG-1	Pericyte
GTAGGAGGTGATAGAT-1	Pericyte
TATGTTCTCTGAAAGA-1	Pericyte
CACTAAGCACGCTAAT-1	Endo
CTTGCTGAGGTTCGTT-1	Fib
GCGAGAACAAGACACG-1	Fib
TGATGCACAGAAGTGC-1	Pericyte
AGTCCGGCAACGAGGT-1	CM
GAAAGTAAGTCTTAGC-1	Neuronal
CGCGCAAAGTTAGAGT-1	Fib
ACTCGGGAGATATGAC-1	Myeloid
ACCATCCAGCGCAATG-1	Fib
CATAACGTCCGGGCAT-1	CM
CCTCCCTAGGTTGACG-1	Endo
ACTATTCGTGTCCCAG-1	Myeloid
GTGCACGTCAGGGTTT-1	Fib
AGCTATGCACGCTCAG-1	Fib
CCTTGCACAGCAATGG-1	Myeloid
GCGGAAAGTGGCCTCA-1	Endo
GGCACGTAGTGAAGGA-1	CM
ACTTTCAGTAACCCAT-1	Pericyte
TTACCGCGTTTGCCCT-1	Endo
TAGTCCCAGGGAAATG-1	Pericyte
TGTACGACATCGGCTG-1	Pericyte
TAACTTCTCTATGAGC-1	Fib
GTACTTTTCGCATAAC-1	Endo
TTACTTGAGGATGTAT-1	Myeloid
CCTTAATCATCTCTCG-1	Fib
TTCTGTAGTACGGAGT-1	Fib
CCTGCTATCGCCCTTA-1	Lymphoid
TCACCACCATATTGGC-1	Pericyte
TAACAGCGTGAGTCGA-1	CM
CCAATGATCATGCTTT-1	CM
TAATTCCGTAAGCCGA-1	Endo
GGTACCGTCTCCTTAA-1	Endo
AACAAAGTCAAACCAC-1	Endo
CGTGGCACAACCTCTC-1	Fib
ACGTGGCCAGGGTAAC-1	Myeloid
CAAGAAAAGATTGACA-1	Pericyte
TACTGCCCAGCAACGA-1	CM
AAAGGGCAGTGAGTGC-1	Fib
TTGACGAAGTTCGCGC-1	Neuronal
AATGGCTAGACCCTAT-1	Pericyte
GAACGTTTCGGGAATG-1	Myeloid
ACTTTCATCAAACCCA-1	Myeloid
AACCTGAGTGAGCTAG-1	Myeloid
CGTGGCACATGCGACC-1	Pericyte
GATGATCCAGGCATCC-1	CM
CTCGCTAGTGGTAAGC-1	Fib
GCCCAGAAGATCCGAG-1	Endo
TTCGTTAGTCAACGGA-1	Endo
GCCAGCAAGCGCAATG-1	CM
CCCAGAGGTAACTCCA-1	Myeloid
TTCAACTGTACCCACG-1	Pericyte
TAAGCCAAGCGCAATG-1	Fib
CTCACCAGTCCCTTTG-1	Endo
ACTACGAGTAACGGAC-1	CM
GGTCATATCGCTCTAC-1	Pericyte
TGGCAATAGCGAATAT-1	CM
TTAGCGATCTTAGTGG-1	Fib
GAGCGCTCACTGTCAA-1	Pericyte
AAATGCCTCTCGACAA-1	vSMCs
CGTACAACACCACAGC-1	Fib
GCCAGACAGCTGGAGT-1	Myeloid
GGAGAACTCTTGTGCC-1	Myeloid
TGCTTTAAGATACCAA-1	Neuronal
TACATGGCATTCACCC-1	Fib
TGCTTCGAGGTGAACC-1	CM
TCAAGGTCACAACGGA-1	Myeloid
AGCCGCAAGAGTGGAA-1	Fib
AGATAGATCGGATGTT-1	CM
ACAGAAAGTATCACAC-1	Myeloid
ATTTGTCCAACTAGAA-1	Fib
CCAATGAAGGCAAGCT-1	Fib
AACCAACCATATAGAG-1	Fib
AGTTTGGAGTCTAGAA-1	Fib
GGTTGCGAGTACGCGA-1	Endo
CATTCCGAGTGGTGTG-1	Pericyte
CCGTACTTCCACACCT-1	Endo
ACTATTCGTTTGTACG-1	Fib
TGGAAGGCAGCTATAC-1	Pericyte
GTGGATTAGCATGATA-1	CM
TATGTGGAGCTAGTTC-1	Fib
GCACCTTAGGTTGACG-1	Endo
CACTGAAAGGGACGTT-1	Endo
CCTTAATTCGCTCTAC-1	Fib
TTCGCGTCAAGTCCTA-1	Pericyte
GGCATTAGTTGCAGCC-1	Endo
GTACTTTGTTAACCGT-1	Endo
TCACCACGTTGGGAAC-1	CM
CCTGGGAAGGTGAACC-1	Myeloid
GAAATGAGTGAGTTGG-1	CM
TGTAGCATCGGCTATA-1	Endo
CATGTTTAGCTAGTTC-1	Endo
TGCTATTCATGTATCG-1	Endo
GGAGGATAGGTAGGAA-1	Pericyte
TTTGTGTCATCATAGC-1	CM
GGGCCATCAAGGTCGA-1	vSMCs
GGGACCTAGTTCTCCC-1	CM
TTCTGTAAGTCTAGAA-1	Lymphoid
CTACAGAAGTGATAAC-1	Myeloid
GCACCTTGTACTTCAG-1	Pericyte
GCCTAGGCAACGGACA-1	Endo
GCTCGAGCAGTAACTC-1	Endo
GATGGCCTCCGTTTCG-1	Pericyte
GAGGTCCAGAAGAGTG-1	Myeloid
TTGTTGTCAAATGCTC-1	Endo
CATTCCGTCACTTACT-1	Endo
CTTAATCAGTTGTCCA-1	Myeloid
CCAATGAGTCCGTGCA-1	Fib
TGTACGATCAGTCACA-1	Fib
GGGAACATCTTGTCAT-1	Endo
CTAGGATAGATTCCGT-1	Myeloid
CCGTGAGCACGCTAAT-1	Myeloid
TGCTCACAGTATAGTG-1	Myeloid
TATTGCTCATCGAGTT-1	Endo
GGAGGATGTGGAAGCT-1	Endo
GTGTCCTAGATGTTCC-1	CM
AATACGCTCCCGAAGC-1	Fib
CATTCCGAGTCGATAA-1	CM
TCAATTCAGACCAATA-1	Myeloid
TCCAGAAAGCTTACCA-1	Myeloid
CTAACTTAGGTTAACA-1	Endo
CGTACAACAGGACCTC-1	Myeloid
CCACAGGGTTCCATCC-1	Pericyte
TGCTATTCAGGTGGTA-1	Endo
AGCGATTAGTTCTCCC-1	CM
GGCGAAATCCTGTAGA-1	Fib
TTACCCGTCAAAGTAG-1	Pericyte
GGCGTTGTCTGGACAT-1	Pericyte
TTTACGTCAAGCGGTA-1	Endo
ATGGATCCAGTATACC-1	Endo
GTGCCAGGTGATAACA-1	Endo
TTTACGTAGGAAACTT-1	Endo
TAGCTTTAGACCCATT-1	Endo
AGCTGTAGTTGTGACT-1	Fib
GGAACTTAGTAATCAG-1	Pericyte
ATAGTCGAGCGAGAAA-1	Fib
AATGGCTCAATGGTCT-1	CM
TGATCAGCATTACACG-1	Fib
GAACCTACACGGTTAT-1	Pericyte
CTTTGCGTCCACGCTT-1	Myeloid
TGAGTCAAGGAGGCGA-1	Endo
CCACGTTAGGATTGAT-1	Lymphoid
TTAGCTTCAGCCACGT-1	Fib
TAGACTGTCGTGGTAT-1	Endo
AGCCAGCAGCCTTTGA-1	Endo
TATCGAGGTATCATGC-1	Pericyte
ATAGTCGGTATTCTCT-1	Pericyte
TATGTTCCAGCGTAGA-1	Myeloid
CCCACATCACAGCCAC-1	Fib
AATGCCAGTAGCAGCA-1	Endo
AACCTTTAGACCATAA-1	Endo
TTGTCTACAAGGAAGA-1	Pericyte
TTGCAGACATTGCGAT-1	CM
CACCTTGCAGTGCTCG-1	Fib
CTTCTAAGTCCTTCAC-1	Endo
AACATCGTCTTTCGAT-1	Myeloid
AGTTTGGTCGTTACAG-1	CM
ACAGACTCAAGGTTCT-1	Myeloid
TCAGTCCCAAGATTAG-1	Fib
CTTGTCGCACATTGCA-1	Myeloid
CCAGATAAGCATACCT-1	Fib
TGGCCTTAGCGTAGCA-1	Endo
TTAGCGAAGTTACCAC-1	Myeloid
ATGTCGATCGTGGCGT-1	Fib
CTTGTCGCAAGTCCTA-1	Myeloid
GGGTGTCGTACGACCC-1	Pericyte
AATGCCAAGCAGGAGG-1	Endo
GGTGTCGCACGTACAT-1	CM
TACGCAATCATGCTTT-1	Endo
TGTACAGTCTCCTTAA-1	Pericyte
ATATTCCAGAACGCCA-1	Pericyte
GTCCATCAGGATTTGA-1	Endo
GAGAACGAGGTAGGCT-1	Fib
TGGCAATCAGCTTACA-1	Fib
TATGTTCAGGGCTCTC-1	CM
TGAGTCATCACTAGCA-1	Pericyte
ATTTGTCGTCACCGCA-1	Myeloid
GTCACGGGTCTGTGTA-1	Endo
GCCTAGGGTGCACTTA-1	vSMCs
CTAACTTTCGCGTGAC-1	Endo
CCTAAAGGTTTAGAAG-1	Fib
CCAATGAGTACAAGCG-1	Myeloid
TGTGTCCAGTACAACA-1	Pericyte
GCTTTCGCAAGTGGCA-1	Endo
AACGAGGAGAGGTGGG-1	Myeloid
TTAACGGTCGCTGATA-1	Myeloid
GCACCTTTCCTGGGAC-1	Fib
GGAACTTCAACGAGGT-1	CM
GAGACTTCAAGGAACC-1	Endo
ATCGAGTTCTCCCTTT-1	CM
AATGGAAAGAGCAGCT-1	Pericyte
CAGTGCGAGTCGTACT-1	Endo
TTCATTGCAGGCATCC-1	CM
TCAAAGCCAAGCAGGT-1	Neuronal
TCAGCTCCAATAGTGA-1	Pericyte
GAGGATGCATATACGC-1	Fib
TGTTAGGTCAGCGGTC-1	CM
AAACTGCTCGGCTATA-1	Myeloid
ACATGCATCTGGCTAA-1	Endo
GCTTGCTCAAGCGACA-1	Fib
GAACGTTAGGTACATA-1	Endo
TTGCGAAAGGCGCTTC-1	Myeloid
GCTTTCGTCACGGGTC-1	CM
CACGTTCAGAGACTCG-1	CM
GTGTGATAGAGGAACA-1	Fib
CCTGCTACAGGCTACC-1	Fib
AACATCGTCTCATCCG-1	CM
TGTACGAGTTTCTTAC-1	Pericyte
AAATGAGGTTGAAGCG-1	Endo
TCACAAGAGTTGCGCC-1	Myeloid
AGCTGATAGTCAGGAC-1	Endo
GCCATAATCCACGCTT-1	Endo
AAGGTTCCATGGTAAA-1	Pericyte
CATTCCGAGAGGCCTA-1	Pericyte
GCTTGCTTCTGTCGGG-1	Endo
AGGCCCAGTGTCCAGC-1	CM
ACTGCAAGTAACCGAG-1	Pericyte
CACATGAGTGTCCAGC-1	CM
GCGCATGAGTTGCCGC-1	CM
CTGTTCGAGACTAGGC-1	Endo
GCAAAGGAGAGGAAGT-1	Pericyte
CAACGGCCACTAGGAG-1	Myeloid
GTTACGACACATAAAG-1	CM
TGCCTCACAGGCACAA-1	Fib
ATTCGTTAGGGAGTTC-1	Endo
GCTGCGAAGATCGATA-1	CM
TGGTCCTCATTCACCC-1	Pericyte
AGCCTCTCACATCATG-1	Endo
TTACCGCTCTATGAGC-1	Myeloid
GCACGGTTCGCCACTT-1	Endo
TTAACGGAGGCAGTAC-1	Myeloid
ATGTCTTCATTGTTCT-1	CM
GGATGAGCATATTGGC-1	Pericyte
GAACGTTAGTACAACA-1	Fib
TAACTTCCAAGATTAG-1	Myeloid
AGCCTCTAGCTAACAA-1	Pericyte
TTGTCTATCTCTGACC-1	Myeloid
CAACCAAGTCAATCCA-1	Fib
TGCGTAAGTTATGCAC-1	Pericyte
GGTCATATCATGCTTT-1	Endo
GTGGATTGTCCCGAGT-1	Neuronal
GCTGAGCGTAAGTCTC-1	Fib
TGTTAGGCAGCAGGTA-1	Endo
TGGCCTTAGCGATACG-1	Pericyte
TGGCAATGTCGCTAGC-1	CM
TTGCCCATCTGAGTCA-1	Endo
AAACTGCCAAACCCTA-1	CM
CAACGGCGTGCTGAAG-1	Pericyte
ACAGACTAGCTGATTC-1	Endo
CCTGGGAAGGCAATTA-1	Pericyte
TTGCACCGTCTGATTG-1	CM
ACTACGAGTCCCGTGA-1	Endo
GAAAGTACAAGGAAGA-1	Fib
TGACTCCCAATGGCTT-1	Endo
CGTAAACGTATGGATA-1	CM
ACTTCCGGTAGGTGAC-1	Endo
TTTGGCCCAGTAACGG-1	Endo
AGTGCGCTCTCCCTTT-1	Fib
TGTGTCCCATCGGCTG-1	Endo
CGGACCATCGACCCGA-1	Myeloid
TAGTCCCCACTGATAC-1	CM
GCAGCCACAACTCAAC-1	Endo
TAACAGCGTCTCTAAG-1	Endo
CCTTAATAGATGCGAC-1	CM
TGCTCGTTCGAGAACG-1	Endo
ACTACCCCATTGCCTC-1	Pericyte
CCGTGAGTCCTAAAGC-1	Pericyte
TCACCTGGTAGGGTTG-1	Myeloid
TACTGCCAGTAGACCG-1	Endo
ATTCGTTAGTCGTACT-1	Pericyte
TACCCTGAGGATGTCG-1	CM
AGCCTCTTCATTCGGA-1	Lymphoid
ACTGTCCGTGTCCAGC-1	CM
TTGCACCTCCTTCGAC-1	Pericyte
TTATGTCGTCCAACCG-1	Endo
CTACTTAGTTCCCTTG-1	Fib
TATCGAGTCTAGCAAC-1	Endo
GTGGATTGTTAGCTCA-1	CM
CAAGCTAAGTATACGA-1	CM
GGGTGTCAGAGGAAGT-1	Endo
GTCGTAAAGAAGAGTG-1	Pericyte
ATCGAGTTCCTAGAGT-1	Pericyte
GCACGGTAGACTAGGC-1	Pericyte
CTCTCGAAGGCTCAGA-1	CM
TCACAAGTCTCCCTTT-1	Myeloid
GCGCCAACACCACAGC-1	Fib
AGCCGCACACCTCGTT-1	Endo
GCGTTGGTCCCGATTC-1	Endo
CGAGTTAAGGTGTTGG-1	Endo
CTAACTTTCGTGGCGT-1	Endo
TTAGCTTCATTGCCTC-1	Endo
TCAAAGCAGTACAGTA-1	Pericyte
GAATCTGTCTTAACGG-1	Pericyte
CACAACAAGGTAAGTT-1	CM
GCCATAAGTAGTTTGC-1	Endo
ACTGCGGAGCAGAGCT-1	Myeloid
AGCCCGAGTTAACTCG-1	Endo
CTGGCAGTCGAGTTAC-1	vSMCs
GCTCACTAGCTACGTT-1	Myeloid
CAACCAACAAGCGGTA-1	CM
AACGGGACAGTAGGCA-1	Pericyte
TTTGTGTCATTACCTT-1	vSMCs
CGCTAGGTCCCATAGA-1	CM
CCGTAGGTCACTCGTC-1	CM
TTACGTTGTCATAGAA-1	Fib
CGTTCCAAGAGGTGGG-1	Fib
TACTAGGGTAGACGCA-1	Fib
ACAAACCCAAATGCTC-1	Endo
AACAAAGCACTCGTGG-1	Lymphoid
GTGACATAGCCTATAC-1	Fib
GAACCGCTCTTCAGAG-1	Lymphoid
CTCACCATCCAATAGC-1	CM
GCGTTGGGTCAAGACG-1	Pericyte
GAGTGAGTCCTTACGC-1	Endo
CTAACTTGTTCCCAAA-1	Endo
AGATAGACAGCTGATT-1	Lymphoid
GATCGTAAGATCGCCC-1	CM
TCCAGAAAGGTCGTTT-1	CM
TCCAGAAAGTGTGTAA-1	CM
TGCATGAGTGCTGTGC-1	Fib
GTGACATAGGGTCTGA-1	Pericyte
GTGCACGAGTGTCGGA-1	CM
GAGGTCCCAGCTATAC-1	Myeloid
GAGGTCCAGTTTACGC-1	CM
TATCGAGGTAAACCCT-1	Fib
CTGAATGAGAGGAACA-1	CM
TCGAGCGTCCCAATAG-1	Pericyte
TTGTCTAGTAGCCATT-1	Myeloid
AAAGGGCCATCCTGGG-1	Myeloid
TCAGTCCTCACTCGTC-1	CM
GATGATCCATTTGGTG-1	CM
CGATGATCAGGCATCC-1	Myeloid
GGATGAGGTGGTAGAC-1	Lymphoid
TCCATCGCAATGCCAT-1	Pericyte
ACGGATTTCCGCCTAT-1	CM
TATCTGTAGTAGTTCC-1	Endo
TTAGCTTCAGCAAACG-1	Myeloid
AATGGCTCAAGCCCTG-1	CM
GAAACAAAGGGCTCTC-1	Myeloid
TCAAGGTCACTGTCGG-1	Endo
CCGAAGCTCACAGGGA-1	Endo
TGGCGCAAGCGTTAGG-1	Fib
TTACTCAGTCAGTGTT-1	CM
AACCTTTGTAAAGCTA-1	Pericyte
TCACAGACAGTGGTCC-1	Pericyte
CCTAAAGGTCAGGTGA-1	Pericyte
ACTGCGGCACCTTGTC-1	CM
ACAGCGCTCAGTGTAC-1	Lymphoid
AGGCCCAAGGTAGGCT-1	Endo
TTACGTTAGTTACCAC-1	Pericyte
GTGTCAACAGACCTGC-1	CM
TGCATGACAAACGTTC-1	Endo
CAGCCTTGTTTCCACC-1	Endo
TACCTATAGAACGACC-1	Fib
AATGGCTGTGCTTACA-1	Fib
CCAATGAGTTCTTTGT-1	Lymphoid
TTACTTGTCTGAGTCA-1	vSMCs
AAACTGCCAGAACAGC-1	CM
GTGATCAAGACACGGT-1	Endo
CGTTCCAGTTCTACGA-1	Endo
AGCCGCAAGTCAGCCC-1	Endo
TAACAGCAGTGTCGCC-1	Pericyte
AACGTACCACCTACCT-1	Endo
AGATTCGGTGCTTTGA-1	Lymphoid
GCGCCAACAATTAGGA-1	Endo
GAACGTTAGTACGACG-1	Endo
GCATGATAGTCAGGAC-1	Pericyte
CTTGAAGCAATTGTGC-1	CM
ATCCTGCTCGTCGCAG-1	Myeloid
CTGTTCGCATAGCCGC-1	Myeloid
TCACCACGTTAACTCG-1	CM
CGTTCCAAGGGCTTCC-1	Fib
CCGTACTGTCGCTAGC-1	CM
GGTGCTGCATAGCCAT-1	Myeloid
AGTCCGGAGGTCGTTT-1	CM
GGTGCTGAGGCGATTG-1	Pericyte
CTAGGATAGTTGGAAT-1	Pericyte
AGCTGGCCATCAGAAA-1	CM
TCAGGTACAGGCATCC-1	Fib
CTCTCAGTCTGGCTAA-1	CM
CGGACCAGTCAATACC-1	CM
TATGTTCAGACAGTGC-1	Lymphoid
CATTCCGGTACGTAAA-1	CM
GGTGTCGGTTTCGTTT-1	Endo
GAGACTTAGTTATGAG-1	CM
TTCATTGCATTTGGTG-1	CM
CCTATTAGTTCCCGGA-1	Myeloid
TCAGTTTCAAAGGTCG-1	CM
CAACCAAAGTCCCGCA-1	Endo
GCGAGTCGTCCGTGCA-1	CM
GTCCATCTCTCTGACC-1	CM
ATTCGTTCAGTGCGTC-1	CM
AGGCCTGTCACTAGCA-1	Endo
CGGACCACATGGCCTG-1	Endo
GTGGATTTCCTGTGGG-1	CM
GAGATTCAGACGCCCT-1	CM
ACATGCAAGCAGTAGC-1	Pericyte
CGGACCAGTGTTGGTT-1	CM
TAGGTCAAGGTCGTTT-1	CM
AGCTGGCCACTGTTAG-1	Fib
GTCGTAAAGTCTCCAA-1	Pericyte
TCAAAGCGTACGCAAG-1	Endo
TAGGTCAAGTGTGTAA-1	CM
TTACTCAGTCTAACCA-1	CM
TGCTTTAGTTAAGGGC-1	CM
CAAGGCCGTAGCGGTA-1	Fib
AAACTGCCAGTTCGGC-1	CM
GCACGCATCTAAGGTC-1	Fib
TTGACGAAGCGCGTTC-1	Fib
TGGTCCTAGGATTGAT-1	CM
CGGACCACAATTGTGC-1	CM
CTGTATTAGTCGAAAT-1	Endo
CCGTACTGTCTCTGGG-1	Fib
CTGTTCGTCTTTCGAT-1	Pericyte
CAGCTGGGTACCAAGG-1	CM
AGCCCGAAGCTGCTCG-1	Myeloid
TCGCAGGCATACCCGG-1	CM
ACTGCGGAGTAGGAAG-1	Endo
ACGGATTTCTATCCTA-1	CM
GAAAGTAGTGAGGTCA-1	CM
AACCTGAAGTTATGAG-1	CM
TGTGTCCAGACGACTG-1	Endo
CGGACCAGTCCGTAGC-1	CM
TCAAGACAGGTGTCGA-1	Endo
TAACGGTTCTCTGACC-1	CM
GGGTCTGTCGGTTCCT-1	Pericyte
CTTGCCATCAAACCAC-1	CM
GCCTAGGCATGGCCGT-1	Pericyte
CAACCAATCTCTGACC-1	CM
GTTACGAGTGAATCGG-1	Endo
AAACTGCCAAGTCTGT-1	CM
GCTGTTCCATTTGGTG-1	CM
GGCACGTAGCTGAGGT-1	CM
CAGCCTTAGTGTGTAA-1	CM
AGTCCGGCAAATTGAG-1	Lymphoid
TGTACGATCACCCGGA-1	Fib
AGTCCGGAGTGTGTAA-1	CM
GGAACTTAGGTCGTTT-1	CM
TAGCGGCCACCCTTAC-1	Endo
GGTGCTGCAAACCGAG-1	Endo
ACAGACTCATCAACTG-1	Endo
GGGTTATAGTGATATG-1	Pericyte
AACCTTTAGTTAGCAA-1	vSMCs
GCACCTTGTGGCATAG-1	Pericyte
GGCACGTAGCAGTAGC-1	CM
TGTAAGCCACGTTACA-1	Endo
TCCAGAACATTAAGGA-1	CM
AAACTGCCATCGGCCA-1	CM
TAAGCCAGTCCGTAGC-1	CM
CAACGGCGTGTCCTTC-1	Endo
TGCACCTAGTTCAAGA-1	CM
CACAGATAGTTCAAGA-1	CM
TAACGGTCACTGTTAG-1	Fib
