Barcode	cell_type
GCCATAAAGGATGCCA-1	Lymphoid
CAGCCTTGTAACTGAA-1	Myeloid
TGCTATTTCGGATAGG-1	Fib
GATGATCTCGCTACCT-1	Endo
GTGCACGCAGCGTGAA-1	Fib
CCGCATTTCACTAGGT-1	CM
TCTAGTTGTTCGGGAA-1	Myeloid
CTCCCAATCTATACCT-1	Fib
GCCATAACACAGTTAC-1	CM
GGGAACATCCATGACA-1	Myeloid
CAGGGCTAGATCGAGC-1	Endo
CGTGGCAAGTGCTGAG-1	CM
CTGGGACAGGATTAAC-1	CM
ACAGAAATCCATAACG-1	Fib
TCACCACCAAGTCTGT-1	Endo
TTCGATTGTTGTCGGC-1	vSMCs
CAGTATGCAATTCTCT-1	Fib
GCTCAGGGTAGATTAG-1	Neuronal
GAACCGCCAACCTCTC-1	CM
AGGCGTCTCAACTTGG-1	CM
ACTATTCGTGTTGTTG-1	Fib
CTGCGTTTCGCACCGA-1	Endo
CCCTAGTAGTCCCTCT-1	Endo
CCCTAACGTACGGAGT-1	Fib
TTTACGTCAAGCCTTA-1	CM
TGGAAGGTCACCCTTG-1	Myeloid
TTCGATTGTGCAACAG-1	CM
CTACAGACAACTGCGC-1	CM
TTACTCACATGGGTGA-1	Fib
TCCGACTAGTGATCTC-1	Myeloid
GCAACCGGTCTCTGGG-1	CM
TCAAGCACAACTACTG-1	CM
GCAAAGGAGCCGCAAA-1	Endo
GGGAACAGTAAACGAT-1	Fib
TAGTCCCCAACATAAG-1	Fib
CTTGCTGCAGGCACAA-1	Myeloid
TCCCACAGTACTATGC-1	CM
ACTGTCCGTAACAATG-1	Fib
AACAAAGCACTCCCAT-1	Endo
CGATGATCAAATTGAG-1	Myeloid
TAGGTCATCGCGTTCT-1	CM
CTCCCAACACCGTTGG-1	Pericyte
AGGCCCATCCAAGTCA-1	Fib
AGGCGTCGTGATGCTT-1	Endo
TAGACTGCAATGGCTT-1	CM
TCTCTGGTCGAGTGTT-1	Endo
GCCTACTAGAGCCTGA-1	CM
ACGTGGCCACATAAAG-1	Pericyte
CAGTGTATCTCTGCGT-1	CM
CCTCCCTCATTACTCT-1	Endo
TCGCCTAAGGTCCTCG-1	CM
GGTTGCGTCACTTACT-1	Fib
AGCGATTAGAAGCCTG-1	Fib
CCTAAAGCATAGCCGC-1	Endo
TCAAAGCCAGTGCGAA-1	Fib
TCAAGGTGTACGAGAC-1	CM
TCGCAGGAGACCAATA-1	Myeloid
ATGGATCGTGGACGAT-1	CM
GTGGATTCAATGACTC-1	Fib
CAGCTAACATTCACGA-1	Myeloid
GGGTGTCAGATACCAA-1	Fib
AACCGATAGGCTAAAT-1	Lymphoid
TTGCCCAAGTAACACA-1	Endo
GGCATTAGTCATTGCA-1	Endo
TTCGCGTAGAATACTG-1	vSMCs
TCAAAGCAGATGCGCA-1	Myeloid
CCCTGATGTTGAAGCG-1	Myeloid
TTGCAGATCGGATGTT-1	Lymphoid
CTCACCAGTGAAACAT-1	Lymphoid
TTACCGCTCCATGTTT-1	Fib
AGCGTGCCAAGTTGCT-1	Lymphoid
TCTAGTTAGTAACACA-1	Fib
TGCCTGTGTTGTATCG-1	Fib
GCACGCACAGCCGAAA-1	CM
TACATGGAGCCTCGCA-1	Lymphoid
ACAGGCCTCGAGAAGC-1	Myeloid
TACTGCCTCTTGTACT-1	Fib
CACATGATCGTTGTTT-1	Myeloid
TATCTGTCAAGTCTGT-1	Fib
ATTCGTTTCGCACCTT-1	Endo
CAAGAAACATTCTCGC-1	Fib
TCAAGGTTCCATGACA-1	Endo
AACGGGACATCGACGC-1	CM
CCGTGAGAGTCCGATT-1	Fib
GCGTAGCGTCCCGTGA-1	CM
AACATCGGTGATGCTT-1	Endo
TGATGCAAGACGCCCT-1	Myeloid
CTTGTCGTCGGATGTT-1	Fib
CTGCGTTCAATGGCTT-1	Myeloid
ACTGTCCCAGATGGCA-1	vSMCs
CACTAAGGTCCACCAG-1	Fib
ACTGTCCGTCCAAGAG-1	Fib
AGGCCTGCAAACCCTA-1	Fib
ACCGAATCACATCATG-1	Myeloid
GGATAGGCAATGCCAT-1	vSMCs
TGCTATTGTTCTACCC-1	Myeloid
CTGTATTAGAACGTTA-1	CM
CAGGGCTTCACTCGGG-1	Fib
TTGCGAACAGTTGGAG-1	Endo
CAACCAACAGACTAAA-1	Myeloid
TGCACCTCATCCTCGT-1	Myeloid
TTGTCTACACCTATTT-1	Fib
CTCCCAATCTCTGTTA-1	Pericyte
TACTCGCTCGATGCAT-1	Myeloid
GAGATTCGTGCATCAT-1	Endo
AAATGAGCACTGGGCT-1	Myeloid
TTGCTATGTAGACACG-1	Fib
TTACTTGAGTAGTCGG-1	Fib
GAGATTCGTTTCGTTT-1	Fib
GCACGGTTCCATGACA-1	Pericyte
GATGATCCATTGATGC-1	Myeloid
TCAGTTTAGCCTCGCA-1	Fib
TAGGAGGCAACGACAG-1	Endo
AGCTGATGTGAGTAAT-1	Fib
TCAGTTTTCGCTACCT-1	Endo
TTCATTGCAAGTCTGT-1	CM
CAAGGCCGTAACGTAA-1	Endo
GAGCATTAGTAACACA-1	Endo
TACAGCATCTCGGCGA-1	Fib
TCAATTCGTTTCGATG-1	Fib
GTAGACTTCGGCATAT-1	Endo
CATTCATTCCACCTAC-1	Endo
CACCTTGTCGGTTGTA-1	Fib
TTACGGAGTACGTAGG-1	Fib
TTGCAGAGTCAGGTGA-1	vSMCs
TCAGGGCTCCGTTTCG-1	Myeloid
TTTGCGCTCGGGTCCA-1	Lymphoid
TATGTGGTCTTCCAGC-1	Myeloid
GTGCTGGAGTGTTCCA-1	Fib
CAAGGCCTCTGGCACG-1	Fib
CCTCCCTTCGCGATGC-1	Endo
GAACCGCGTAGTGATA-1	vSMCs
CCGTAGGGTGCCCTAG-1	Endo
TCACCACTCGAAGCCC-1	Myeloid
CTAGGGCTCAAACCAC-1	Fib
TACCTATGTGTAGGAC-1	CM
ACTACGAGTAACATAG-1	Fib
CAACGTATCTAGTCGA-1	Fib
GGGCCATGTAAACGAT-1	Myeloid
CTGGCAGCACAATAAG-1	Myeloid
GAGCATTGTAGCGAGT-1	Myeloid
CCCTAGTGTACGCCCA-1	CM
AGGACGACAACTTGGT-1	Fib
TCAAGCATCTGGCTAA-1	Fib
ACAGACTTCCAGTACA-1	Endo
ACAGCGCAGGAACCGT-1	Myeloid
TTGTTGTAGTGATATG-1	Fib
GTTGGTACATCAGCTA-1	Fib
GTCACCTTCAGAATGA-1	Fib
AGCGTGCCATGGATGG-1	Fib
GCTCCTACAGAGATGC-1	Fib
AATGGAACAGAATGCG-1	Myeloid
CGCTGGAGTTGGACGA-1	CM
CTCCCAAAGGGAGTTC-1	Fib
GCGTTGGAGCTGGAGT-1	Myeloid
TGGACATCACATAAAG-1	Endo
AGTTACGGTCAATACC-1	CM
TCGAGCGCAACAACTC-1	Endo
GACCAATAGTGAGTGC-1	Myeloid
CTTGCTGCAAAGAAGG-1	CM
GATGGCCAGGAACCGT-1	Pericyte
TACTAGGTCTCTGAGA-1	Fib
GGCGAAAAGGATGTCG-1	Fib
AACGGGATCAGTCTTT-1	Myeloid
CCTTGGTGTAGCGGTA-1	Endo
TTTGGCCCACAGGTAG-1	Fib
AGCTATGTCACGATTG-1	CM
ATTCGTTTCCCGATTC-1	Fib
CCTTGCAAGTTACACC-1	Fib
CCATACCGTGGCATAG-1	Fib
GCGATTAAGAGAACCC-1	Fib
GCCATAAGTGACGCAA-1	Fib
GACCTTCCATGGGACA-1	Fib
TGCTTCGTCTTCTTCC-1	Pericyte
TAAACCGCATCGCTAA-1	Pericyte
GAAGTCTGTGCTTGAT-1	Pericyte
ACTATTCTCGTCTAGA-1	Pericyte
CCAATGATCCTGGGAC-1	Fib
CCCTGATCAGTTCGGC-1	Endo
TGGTCAACAAGGTTCT-1	Myeloid
ACTACCCAGAGAAGCA-1	Fib
TTGACGAGTCCTTCAC-1	Myeloid
ACTACCCTCGACTATG-1	CM
ATGTCGAGTATGAAGT-1	Pericyte
CACTGAAGTTCTGAAC-1	CM
GCTTTCGGTACGCAAG-1	vSMCs
CTAGGATCAACCTCCT-1	Myeloid
CCACAGGGTCACATTG-1	Fib
GCGGAAAGTCGTAGTT-1	Fib
GAACCTATCAATTGGC-1	Fib
CACCACTGTGCTTACA-1	Pericyte
AATGGAAAGTCTGTGT-1	Myeloid
CGTGGCACATCGTACA-1	Fib
GCTTGCTCATGGCCGT-1	Myeloid
AACAGTCCAGTCAGAG-1	Fib
AACATCGCATTTGGCA-1	Pericyte
TGTACAGAGATACCAA-1	Fib
AACGGGAGTTGTATCG-1	Myeloid
TTACGGATCTTACGGA-1	Pericyte
AGGCGAAAGTATGGGC-1	Endo
CCTGCTACATAGCCGC-1	Fib
GCATTGACACAGTAGG-1	Endo
GTCACAATCACTCGGG-1	vSMCs
ACAAGCTTCTCGGCGA-1	Lymphoid
TATGTGGCATCACAGT-1	Fib
ACTGCAAAGCGTAGCA-1	Myeloid
TCGAGCGAGAATACTG-1	Endo
TCACCTGAGCACGTAG-1	Pericyte
ATCCAGACACGCGTTG-1	Endo
CTAGGGCCAGCAACGA-1	Pericyte
CCCTAGTGTTTCACCC-1	Fib
TCCGACTCAACAAACA-1	Endo
AGCCTGGGTAAACGAT-1	Fib
CCAATGACAATTGGCT-1	Myeloid
CCAATGATCTCTTAAC-1	Myeloid
ACTGCGGCAAGATTAG-1	Pericyte
CTGTATTAGGGCTTCC-1	Fib
CTTGCCAAGACGTCAG-1	Endo
GGTACCGGTACCCACG-1	Endo
TTCGATTTCCTTTGAT-1	Fib
TTACCGCAGTCGTATC-1	Fib
TTAGGTGTCGCTTACC-1	Endo
CTGCGTTTCTATCCTA-1	Endo
ACCGCAGAGCTAACAA-1	Endo
TCAATTCCAATGCCAT-1	vSMCs
AAACTCGGTACGACCC-1	Myeloid
GTAGGAGGTTGGAGGT-1	vSMCs
CCGTAGGCACCAAGGA-1	Myeloid
GTGCCAGTCCTGAAAC-1	vSMCs
GAGACTTTCCGTTAGA-1	Myeloid
ATTCGTTGTGCGCATC-1	Endo
GGTGTCGTCTGGAAGG-1	Pericyte
CCTGGGATCTGCGTCT-1	Lymphoid
TTGTTCAAGTGGACGT-1	Pericyte
TGCGTAATCGGAAAGC-1	Pericyte
GGCACGTCAGCACATT-1	Endo
AATGCCATCGCGATGC-1	Endo
TGCTCACTCCCTAAAG-1	Myeloid
TGCTCACGTGCATTGT-1	Fib
CAGTGCGAGGCACTAG-1	Endo
AGCTATGGTTTCTACT-1	Endo
GTGGATTCAACGTACT-1	Pericyte
AAGATAGCAATGGTCT-1	Pericyte
CCCTGATCAGTTAAAG-1	Pericyte
TACAGCAAGTTCAAGA-1	Endo
TCTCTGGGTCTGGTCG-1	Myeloid
ACCTGCTTCGGTCTAA-1	Endo
AAGGAGCGTTCCTATT-1	Endo
AGTCCGGGTATTCACG-1	Myeloid
AAAGGGCAGAACGACC-1	Fib
GGATAGGCACAATAAG-1	Lymphoid
CCGCATTAGTCGATAA-1	Endo
GGCATTACAGTAGTCT-1	Fib
CTAGGATTCCATCTAT-1	Myeloid
ACGTGGCAGTTGGAAT-1	Endo
GCATTCCCATGGTAAA-1	Myeloid
AGTCCGGAGATAGGTT-1	Endo
GAACGTTCACGCTAAT-1	Pericyte
TCTAGTTAGCGTATCT-1	Pericyte
CCTAAAGGTAAACGGC-1	Myeloid
GTCTACCCAATACTGC-1	Myeloid
TGCCTCAAGTGGACGT-1	Endo
ACCGGGTAGCCTTTGA-1	Pericyte
GCTCCTAAGAGGCAGG-1	Pericyte
GTCACAAGTGGGTAGT-1	Fib
GCCTACTTCTCTGACC-1	Pericyte
TTGAGTGGTGCTTACA-1	Myeloid
GCGATCGCAACGGACA-1	Myeloid
GGAGAACCACAGAAGC-1	Endo
GTAGTACAGTAGACCG-1	Endo
CTAGCGGAGGTGAACC-1	Myeloid
CGCTGGAAGATTGACA-1	Endo
AGCGATTCAGTATACC-1	Endo
CTTGCCACAGCAACGA-1	Endo
AACCTTTAGACCCTAT-1	Pericyte
GTCACTCGTGTGTGCC-1	Myeloid
ACCGAATGTAACTCCA-1	Fib
CCGTAGGCAGGGAGTT-1	Endo
GTCCATCAGCACACCC-1	Endo
GCAACCGAGGCGCTTC-1	Pericyte
CTTCTAAGTTTCTACT-1	Lymphoid
TAGCATGGTTTCGTTT-1	Myeloid
GTGTCCTTCTCCAACC-1	Myeloid
ACAGCGCTCCTCCATG-1	Myeloid
CACCACTCATTTGGCA-1	Endo
CCATACCGTAAAGGCC-1	Endo
CAGCTAAAGCGTCTGC-1	Endo
TACGCAAAGCTAGTTC-1	Endo
CACTAAGTCTCCACTG-1	vSMCs
ATTACTCCAATTGTGC-1	Endo
AGTCCGGAGGAAGGTA-1	Lymphoid
CTAGGGCAGAGGTCCA-1	Pericyte
AATGCCAAGGGCTTCC-1	Endo
CTTTGCGTCGTGGCGT-1	Pericyte
TATCTGTTCGCCCTTA-1	Myeloid
ATCCAGATCTCTGAGA-1	vSMCs
CTGGGACTCGCACCGA-1	Endo
GTGTCAATCATTCGGA-1	Myeloid
CTTGCTGCACGATTAC-1	Pericyte
ATGTACGAGGTTAGTA-1	Lymphoid
GACCGACCAAGTCTGT-1	Fib
AACGAGGAGGCTCCTG-1	CM
ACCTGCTTCTGGCGCA-1	Endo
AATGCCATCGCATACA-1	Pericyte
TAGCGGCTCTCTTCCT-1	Endo
GCGAGTCGTACGAGAC-1	Endo
GTTATGGTCTTGTCGC-1	Pericyte
CTCGCTAAGGAAGGTA-1	Endo
TCACCTGCAGTCAGCC-1	Endo
AGTTTGGTCGCTACCT-1	Endo
TGTACGACAAGCGGTA-1	Endo
GCGATCGTCTGGCGCA-1	Fib
TATGTTCCATCCGTGG-1	Fib
CAATCCCTCTCTTCTC-1	Pericyte
GAATCTGCACATTGCA-1	Endo
CTGAATGTCCGCCTAT-1	Lymphoid
TAGCGGCTCACCGCGA-1	Myeloid
CCTCCCTTCGATCGCG-1	vSMCs
CAAGCTAGTAGCGGTA-1	Endo
TAACAGCGTAAGCCTT-1	Myeloid
GTGCACGGTCTGCACG-1	Endo
TGGAAGGGTATTCACG-1	Lymphoid
CAACCAATCGATGCAT-1	Myeloid
TCACAGATCTGTCGGG-1	CM
ACTAGGTCAGGATAGC-1	Endo
GCATGATAGTAATGTG-1	Pericyte
ATCCAGAAGTACGCGA-1	Endo
CAACGTATCTGGCCAG-1	CM
GGGTCTGTCGACTCGG-1	Endo
ATGTTTCTCGTGCTTC-1	Myeloid
TTACGGACACTGTCAA-1	Fib
CCCTAACGTTCTTAGG-1	Endo
GGGTTATGTACGTAGG-1	Myeloid
CGGTGCATCGACTCGG-1	Pericyte
CTTCCAGAGGGTCTGA-1	Endo
TAACGGTTCGATGCAT-1	Myeloid
CAACGGCGTCGAGAAC-1	Myeloid
CTAGGATGTCACCGCA-1	Myeloid
GTCCATCTCGATGCAT-1	Myeloid
AGCTGGCGTAATGTGA-1	Pericyte
GATGGCCAGGCTTCGC-1	Endo
TGATTTCAGAGACTCG-1	Fib
TAATCGGAGCGAGCTA-1	Fib
GTCACGGCAGGCAGAT-1	Myeloid
AGGCGTCGTTGCAGCC-1	Fib
CTGAATGTCCCATAGA-1	Myeloid
GGGCCATTCCGGCGAT-1	Endo
TACCCTGTCGGGCTCA-1	Endo
GTGTCCTAGCGGACAT-1	Myeloid
GTCCATCTCAGAGTGG-1	Fib
TTTGTGTCATCATAGC-1	Endo
CCCACATTCCAGAATC-1	Endo
GCATTCCAGGATGCCA-1	Myeloid
TGGCCTTAGAACGACC-1	Endo
CTTGCCAGTCCGTCGA-1	Lymphoid
TGGCGCAGTTAGGAGC-1	CM
CCCACATTCTTCTCTC-1	CM
TAGACTGAGCGGACAT-1	CM
TGTGGCGTCGTGAGTT-1	Lymphoid
TAGCCGGGTTTGCGAT-1	Lymphoid
TGTACAGCATAGCCGC-1	Endo
TAGGTCATCCTATCAT-1	Myeloid
GAAGTGGGTGTCGTGC-1	Lymphoid
TGCATTTGTATCACAC-1	Endo
ACCTGCTTCAGCCGAC-1	Myeloid
TTGACGAGTCAAGACG-1	Lymphoid
CGTTCCAGTATTGTCG-1	Endo
ACATGCATCGGTGATT-1	Lymphoid
TAACGGTTCAGAGTGG-1	Fib
GATTGACCAGTAGGCA-1	Endo
CAACCAATCAGAGTGG-1	Fib
TTTGGCCAGCGCCTAC-1	CM
CTAGGATAGACCCATT-1	CM
GGAGGATGTATTTGCG-1	CM
TTACGTTTCACTCGTC-1	CM
TTACCCGCATGCGACC-1	Fib
GAGATTCAGTATCTGC-1	Fib
TAGCCGGCACTGGGCT-1	Pericyte
GCTGCGAGTCTCGGGT-1	Lymphoid
CTCGCTAAGCTCGGCT-1	Lymphoid
AAACTCGGTCGATAGG-1	Myeloid
TTTGGTTAGATGCGAC-1	Endo
CCCACATCATTAGCAC-1	Lymphoid
CCCTGATCAACTTGGT-1	CM
GATGATCCAAACCTAC-1	Endo
CTGTTCGCAAGTCTGT-1	Fib
CAGCCTTGTCAACTGT-1	Myeloid
GAAGTGGCAAATTGAG-1	Endo
CCCTAACGTTCTCGAA-1	Myeloid
TGGCGCAGTCGCGCTA-1	CM
TTGCTATGTCAGTGTT-1	Fib
GATCATGGTGTAGGAC-1	CM
ACTACGACAAGTCTGT-1	Fib
AGCCCGACAGCCGAAA-1	Myeloid
GTAGGAGAGGTTGTGG-1	CM
GGAGGATTCCATATCT-1	Myeloid
CTAGGGCAGTATCTGC-1	Fib
TCGTTCGCATGACTGT-1	CM
TATCTGTCACAGTAGG-1	Fib
TGCTCGTGTTCTACCC-1	CM
TGCTATTCATTTGTTC-1	CM
TTGCAGACAGGTGTCC-1	Lymphoid
ATATTCCTCCAATCCC-1	Fib
TTGCTATGTCTAACCA-1	Fib
ACTAACGCATGGTAAA-1	Myeloid
GGGTTATTCGTGGGTC-1	Endo
TCACCACCACAGTAGG-1	CM
TGCTCACGTCCGTAGC-1	Fib
ACTATTCTCCCGTAGG-1	Pericyte
TAGTCCCTCGGGATCC-1	CM
CACCTTGTCTCCACTG-1	Endo
AACTTGGTCTCTTCTC-1	CM
GGTCATAAGGATTGAT-1	Endo
GAGGTCCGTGCTTACA-1	Endo
TGTTAGGTCCGGCGAT-1	Endo
AACCTTTAGAGGTGGG-1	Pericyte
TTCATTGCACAGTAGG-1	CM
ATCCTCGTCGACGGAA-1	Fib
ACGGATTTCGCGATGC-1	Endo
TTCATCAGTCCGTAGC-1	CM
TGCTCACGTCAATACC-1	Fib
GCATTGAAGTATCTGC-1	Fib
AACGGGACAGAGAGAA-1	CM
CCCTAGTGTGTCTCGG-1	CM
CGGACCACAGGTAGCA-1	CM
TTCAACTTCGGGAAAC-1	CM
GATTAGCAGTGCAACG-1	Pericyte
ACGGATTTCGCATACA-1	Pericyte
CCATACCGTGCTTCCT-1	Fib
AGTTTGGAGGGAAATG-1	CM
TGCTCACGTGTTGGTT-1	Fib
GTCCATCTCTCCACTG-1	Pericyte
CCGTGAGTCGATGCAT-1	Myeloid
AACCGATAGCGAGCTA-1	Fib
