Barcode	cell_type
CACCTTGTCTTAACGG-1	CM
GCGGGTTCACGAACGA-1	CM
GAACCTAGTGTTGGTT-1	Endo
TCGGGACTCACTGGTA-1	CM
GAATCTGTCAGGTTTG-1	Fib
CACTGAAAGATCGAGC-1	CM
TTTGGCCTCGTCCCAT-1	CM
TCACCACAGGCTTCGC-1	CM
TAATTCCAGTCATCTG-1	CM
GTGTGATGTCTAAAGA-1	CM
GCCCAGACAAGTCTCA-1	CM
TCGAGCGAGCAATAAC-1	CM
AACCTGACATGTATCG-1	CM
CCTGGGAAGTCTCTAG-1	CM
GGGTCTGAGTCGAAAT-1	CM
GGGTGTCAGACCAATA-1	CM
GAGATTCGTCTAACCA-1	CM
AACGAGGGTTATAGAG-1	CM
TGAGTCAGTCTCTGCT-1	CM
TCAAGGTAGCAGAATT-1	CM
GCACGGTTCGAGAAGC-1	CM
AACCTTTGTCAAACAA-1	CM
AATGTCGAGTACAGAT-1	CM
TTGCACCCATGCACTA-1	CM
CACCTTGAGGGACGTT-1	CM
GTCACGGTCACGTGTA-1	CM
CCGTGAGCACGATTAC-1	Fib
ATGTCTTAGTTGTCCA-1	CM
ACATGCAAGTGATTAG-1	CM
CCCTCTCTCGGTACTA-1	CM
GAAAGTATCTGATCTT-1	CM
TTACCCGTCACAACAC-1	CM
GCACGGTCAAGGTCGA-1	CM
GAAGAGCTCGTGGTAT-1	CM
TCACAGAAGACGCCCT-1	CM
CCCTGATTCTCATCCG-1	CM
CAACCAAGTACGGATG-1	CM
TAGCATGGTAAAGGCC-1	CM
TCACCACTCCAAGAGG-1	CM
TGCATTTTCGCTTACC-1	CM
TAGCATGAGCGGACAT-1	CM
GGAATCTGTTTGTCTT-1	CM
GTGTCAAAGTCGCCTG-1	Myeloid
GCACGCACAACTTGGT-1	CM
GAGCATTTCTTATCAC-1	CM
CGCACAGAGTTGACAA-1	CM
ACCCAAAAGACAGCTG-1	CM
TGTACGAGTCCAACCG-1	CM
CAACCAAGTTCAGAAA-1	CM
ATGTACGTCCCGAAGC-1	CM
AACGAGGAGATTACGA-1	CM
TGTACAGGTATGGTTC-1	CM
TCAAGGTAGCCCATGC-1	CM
TTCATTGGTGATCAGG-1	CM
GTAATCGGTTCCCGGA-1	CM
CAATCCCGTTACGCTA-1	CM
CTACAGACATGATCGT-1	CM
ACATGGTGTTACACTG-1	CM
AATGCCATCTTCAGAG-1	CM
GAAAGTAAGGTGTTGG-1	Fib
AGCCTTCAGGCTAAAT-1	CM
TGCGTAATCTCCAACC-1	CM
GCAGATTTCTGGCCAG-1	CM
GAGAACGCAAGATGCG-1	CM
AAACGAAAGTAATGTG-1	CM
CTGCTCATCCGGCTGA-1	CM
AGTGCGCAGAGAGTTT-1	CM
AGCCTGGAGTGTCCCG-1	CM
TGGACATGTTTCTTAC-1	CM
GTGTCAAAGAAATACC-1	CM
GGTAGGAGTATCCCTC-1	CM
AGATAGAGTGCTGGCT-1	CM
TCGGGACCAAGAGATT-1	CM
GTCACGGCAACTCGAT-1	CM
CAGGATTGTGGACTGA-1	CM
ATCCTGCGTCAATCCA-1	CM
TCAATTCGTTCCGGCA-1	CM
TGGAAGGGTGCTTACA-1	CM
AGCCTGGGTTTCCTAT-1	CM
CTGGCAGAGCTGAATA-1	CM
AAAGATGAGGAGAACA-1	CM
GTTATTCTCCGTTAGA-1	CM
ATGTACGGTGCGTTTA-1	CM
GCGATTACATTAACGC-1	CM
CTACTTACATCCTGGG-1	CM
TCAAAGCCATCGGCCA-1	CM
TCAAGACGTCGTAATC-1	CM
TACTGCCAGTCTCTAG-1	CM
TCTCAGCCAGGCATTT-1	CM
TACTAGGCATAGATAG-1	CM
TAACGGTGTTTGATCG-1	CM
GCAAAGGAGTAGACCG-1	CM
AGGCCCACACTCCACT-1	CM
GGAACCCGTTGTATCG-1	CM
TCGCCTATCGTGAACT-1	CM
TATGTTCGTACCCACG-1	CM
CTTGCCAGTAGCGTTT-1	CM
GATTAGCGTATGTCCA-1	CM
AAATGCCCAAACTACC-1	CM
CTCCCAAGTTGAATAG-1	CM
CGTACAACAAGGGAGG-1	CM
AAATGCCCACTCGCAG-1	CM
TGGTCCTGTATCGCGC-1	CM
TCCGACTAGGCGTCCT-1	CM
TTGCACCGTGCAAAGC-1	CM
CCACAGGCAATGGCAG-1	CM
GAGCATTGTGTTGGTT-1	CM
CCCTAACGTTGGCTAT-1	CM
TTAGGTGAGTCACGCC-1	CM
CGCACAGGTTTCAGCA-1	CM
CACCTGTCAAGCGACA-1	CM
TTGAGCAGTAAACCCT-1	CM
TGTGACAGTTCAGTAC-1	CM
TTGGTCCGTCACCGCA-1	CM
AACGTACTCTTCAGAG-1	CM
TGGCGCAGTAACCCAT-1	CM
CCACAGGCAGGCAAGT-1	CM
GCGGTGTAGCGCACAA-1	CM
CCTTAATGTTCAGAAA-1	CM
CGTAAACTCCTCATTA-1	CM
GTTACGAAGCTCGTTA-1	CM
CTCATGCTCTATCTTG-1	CM
ACGGATTCATATAGAG-1	CM
AAACTGCGTTCTGAAC-1	CM
TAGCTTTAGTTAGCGG-1	CM
TTGTTGTTCGATCGCG-1	Fib
GCTCGAGGTTTGATCG-1	CM
TGGGTGCAGGAAGGTA-1	CM
GCATGATGTCCCGAGT-1	CM
GGAGAACTCAAAGTAG-1	CM
TGCTATTAGGGTATCG-1	CM
GCGAGTCTCAAACCAC-1	CM
GCACGCAGTATCTGCA-1	CM
GGAATCTGTCCACCAG-1	CM
CTTTGCGAGGCACTAG-1	CM
GAACGTTGTGGCCTCA-1	CM
TGCTTTACACACTAGT-1	CM
TGGTCCTCACCTCGTT-1	CM
GGGCCATCACCCTTTG-1	CM
ACTCGGGTCGTGAGTT-1	CM
AAAGGGCAGAACGTTA-1	CM
ACTTTCATCGTATAGC-1	CM
TCGCCTAAGTCGTATC-1	CM
GTGCCAGAGAACGTCG-1	CM
CGATGATAGCATTCCA-1	CM
TGAGCCGAGTTCGTTG-1	CM
CATTCCGCAAACTACC-1	CM
TTTACGTTCTGATCTT-1	CM
GTGGCGTCACCTATTT-1	CM
AACGTACTCTAGCTGA-1	Fib
CATTGGACAGCAACAG-1	CM
CAAGCTAAGAAGACTT-1	CM
GCTTTCGTCACATTCT-1	CM
GTTATGGCAAGCGAAC-1	CM
ACTAACGCATCACAGT-1	CM
TGAGTCATCCTGGGAC-1	CM
ACAGAAAGTCAGTGCC-1	CM
GAGTGAGAGATGTTGA-1	CM
TTAGCTTCAGTCAGAG-1	CM
CTAACTTAGGCGTAGT-1	CM
TATTGCTGTATCTAGC-1	CM
CACCACTAGTGCTAGG-1	CM
CTAGGGCTCCTAAGTG-1	CM
GTTCAAGGTTCCCGGA-1	Fib
ATGTACGAGAGGTACC-1	CM
CTTAATCGTAAAGCTA-1	CM
AATGGCTGTTCCCAAA-1	CM
ATTCGTTTCAGTCTTT-1	Fib
TCAGTTTGTCTCTGCT-1	CM
CCTTGCATCATCGCAA-1	CM
AACCTTTCATGGTAAA-1	CM
TGCGTAAAGGTGTTGG-1	CM
GGGTTATGTGGATTCT-1	CM
ACTAGGTAGCGAGCTA-1	CM
GAAGAGCAGGTTCGAG-1	CM
GACCCAGAGCTCCATA-1	CM
GGATAGGTCTCATCCG-1	CM
GCATTCCAGTCCGTGC-1	CM
ACGGATTGTATTTGCG-1	CM
TACCTATCACGCGACT-1	Fib
CAACCAATCGAGTGTT-1	CM
CAGCTGGGTTTCAGCA-1	CM
AACGAGGGTACATGGG-1	CM
GGCGTTGGTTGGCGAA-1	CM
GGCGAAAGTGGATTTC-1	CM
CAGGGCTCAGTAGGCA-1	CM
ATGTCTTAGTTTACGC-1	CM
AGCCCGAAGCAGAGCT-1	CM
TCACAGATCTGGCTAA-1	CM
TCAGGTAGTGCTTTGA-1	CM
GGCGTTGTCAGAGTGG-1	CM
TGGAAGGAGGATGTAT-1	CM
GTGTCCTAGAGTGGAA-1	CM
ACCGAATGTTTCACCC-1	CM
ACTTCCGAGCATTGGG-1	CM
AAGGAGCGTTATGCAC-1	CM
AATACGCAGATGGGAA-1	CM
TCGCCTACACATTCTT-1	CM
TAGGAGGTCCTAAAGC-1	CM
TAACGGTAGTGTAATG-1	CM
TCAGGGCAGTTCGACT-1	CM
TTGCACCCACCGTCTT-1	CM
TATCTGTTCCATACCC-1	CM
CCCACATAGACTCTTG-1	CM
TTGCTATCAATGCATC-1	CM
AACCTTTCACCTATTT-1	CM
TAAGCCAAGGTAAGTT-1	CM
CCACGTTTCCGGCGAT-1	CM
TGCACCTGTACTTCGA-1	CM
GGAGAACAGTAACATG-1	CM
ACTTCCGTCTCTGCAC-1	CM
GGCGTTGCAAGTGGCA-1	CM
CCTTAATCAAGAGATT-1	CM
GGTGAAGTCATACTTC-1	CM
TACGGATTCTATACCT-1	CM
GCGAGAAAGAGGAATG-1	CM
CCACGTTAGCAACTGG-1	CM
GCGGGTTGTACGAGAC-1	Endo
TGATCAGAGAATATCG-1	CM
GTCGTAACACGTTGTA-1	CM
GGTGCTGAGATTCCGT-1	CM
GGAGGATCACTCAGCG-1	CM
TGAATCGCACGCTAAT-1	CM
GGATAGGCACACACCG-1	CM
TGGTCCTTCTATATCC-1	CM
TCGAGCGCATCTCACC-1	CM
GAACCGCAGTCCAGAG-1	CM
TTACGTTCACCCATCT-1	CM
TACGGATTCGACTCGG-1	CM
CGCAATATCCCTAAAG-1	Fib
ACAAAGACATTAGCCA-1	CM
ATCCTCGGTTTCCGGG-1	CM
AGCTATGTCGTCGCAG-1	CM
GCCTACTCATGCGTTA-1	CM
TGTAAGCCAGTAAGAT-1	CM
AACTGGTCAGATAAGT-1	CM
AACCGATAGCGTGTTT-1	CM
GCGGTGTCAAATGTCC-1	CM
CTTCCAGAGGTTGACG-1	CM
GTACTTTAGTACCTCA-1	CM
GCGATTAGTGGACAGT-1	CM
GGAACTTCATGATCGT-1	CM
ACAAACCTCTTCCACG-1	CM
CTCACCATCGCATAAC-1	CM
AGCGATTCATTCACCC-1	CM
AAACTGCTCCGCGATG-1	CM
TGGCGCAAGGGTCCCT-1	CM
TTACCCGGTCCGAGCT-1	Endo
GTAATCGAGAACTCCT-1	CM
TCAGCTCTCGGTCGAC-1	CM
TGCTCGTTCTGTGTGA-1	CM
GCGATTATCCAACCTC-1	CM
GGACACCAGGGTCCCT-1	CM
GATCATGCATGCACTA-1	CM
AACCTGAAGTTCAACC-1	CM
TTGCAGATCATGTTCT-1	CM
GAAACAATCGCTCGGA-1	CM
GCAGCCAGTTGGAGGT-1	CM
GTCTACCTCATACTTC-1	CM
AGTCAACGTGCAGACA-1	CM
AAATGAGGTGATGCTT-1	CM
GCATGATTCAGGTCTA-1	CM
TTTGGTTCAGAGTCGA-1	CM
TTGCACCGTATACGCT-1	CM
ACAGAAAGTAACCCAT-1	CM
CGCGCAATCGGATAGG-1	CM
GTTATTCAGGTAGGCT-1	CM
AATACGCAGACCCTAT-1	CM
TTACGGAAGCAGGACT-1	vSMCs
TCAGTCCCAATTGTGC-1	CM
CAAGCTATCTGGCACG-1	CM
TACTGCCAGGTTGACG-1	Endo
GCAGCTGCAACGAGGT-1	CM
TTGCTTACAGTATACC-1	CM
TACTAGGAGCTTTCCC-1	CM
GCGGGTTCATCACAAC-1	Fib
TGATTTCAGCCATTCA-1	CM
GCTTAAGTCGCGCTGA-1	CM
CCGTACTCATTCACCC-1	CM
AAAGGATTCCCGATTC-1	CM
GGCATTAAGAACTCCT-1	CM
CTCCCAACACTGCTTC-1	Fib
GATTGACTCCCGATTC-1	CM
TGTGTCCGTAGAATAC-1	CM
GTGCCAGAGATGTTCC-1	CM
GGATAGGAGGGCATTG-1	CM
AGCTGATTCTGATCCC-1	CM
GCCAGCACAGGTTATC-1	CM
GACCAATTCCAGTACA-1	CM
CTCAACCGTGCCCAGT-1	CM
CCAGAATAGATTCCGT-1	CM
ATGTCTTAGTTGACAA-1	CM
GCTGTTCGTATTCGCA-1	CM
TAACAGCCAGGGAGTT-1	CM
CCCTCTCTCAAAGTAG-1	CM
CACTAAGCATCCCTTG-1	CM
ATCCCTGGTGTCGTCG-1	Myeloid
AGATAGAAGCCAGAAC-1	CM
GTTGGTATCCTTGACC-1	CM
GCTGTTCGTCTAAGAA-1	CM
CCGTACTGTTCCTATT-1	CM
TCACAAGTCGGTCTAA-1	CM
ATAGTCGCACCAAGGA-1	CM
CCCAGAGGTATACGCT-1	Fib
ACTACGACACGCTAAT-1	CM
CTGAATGCAAGACTTC-1	CM
CAATCCCTCTTAAGCG-1	CM
TGTAAGCGTCGCTAGC-1	CM
CATGCCTCACCTGGTG-1	CM
AGTGCGCCAGCTATAC-1	CM
TCTCAGCTCGTTCAGA-1	CM
TGAGCCGGTAGTCTGT-1	CM
AACAGTCTCATCGCCT-1	CM
TAGTCCCCAAATTGAG-1	CM
TACGGATTCGATGTAC-1	CM
CCAGATAGTTGGAGGT-1	CM
CTCATGCCACGCGCAT-1	Endo
AACTGTGTCGACTCGG-1	CM
CCTCCCTTCTTAACGG-1	CM
ATGCATGAGATTGACA-1	CM
AGCCAGCGTTCCGCGA-1	CM
GAAGTCTAGCACACCC-1	CM
TTGCTTACACCAAGGA-1	CM
GTTCAAGAGGATTGAT-1	CM
TAAGCCACAATCAGGG-1	CM
GCGATCGAGCTACGTT-1	CM
TTTGGTTAGCAGGAGG-1	Fib
ATGTCGAAGAACGTCG-1	CM
TTAACGGCAATGGTAA-1	CM
CACGTTCTCACAAGCT-1	CM
TAGGTGTCAAAGGAAG-1	CM
AGCCAGCGTTACACTG-1	CM
CCACGTTGTCTCTAAG-1	CM
AGCTGTATCATCATGG-1	CM
GGGACCTAGTTCGCGC-1	CM
TTACTTGGTTCCAGTA-1	CM
GCTTGCTTCTTAATCC-1	CM
GTTGGTAGTCCGGTAC-1	CM
TGCTCGTTCCAGAATC-1	CM
GCTTTCGGTGATAGAT-1	CM
GACCAATTCCATATCT-1	CM
GCTCGAGAGGCTTCGC-1	Fib
GACTAACAGTGGTGTG-1	CM
CTGTATTCAGACTAAA-1	CM
GCCTACTAGCAGTAGC-1	CM
TTATGTCCACTCCACT-1	CM
AACAGTCAGTGAATAC-1	CM
ACCGGGTCAGTAGTCT-1	CM
GCATTGATCAACACGT-1	CM
CTGGGACCAGTAACTC-1	CM
GGTACCGTCCTATCAT-1	CM
CAGCTGGTCCAATAGC-1	CM
ACCCAAAGTTAAGTCC-1	CM
CAACGTAGTTTCGTTT-1	CM
TTTGTGTGTCTAACCA-1	CM
TATGTTCAGGATATCA-1	CM
ATGTTTCTCTATCTTG-1	CM
CCCTCTCAGCTGGAGT-1	CM
GTGTGATTCCTGACCT-1	CM
CTTGCCATCCTCCCAA-1	CM
AGATTCGTCTTACCTA-1	CM
GTGATCATCGCTCTAC-1	CM
GATGATCAGACCAATA-1	CM
CGGTGCAAGGCAGTAC-1	Fib
CAGTGCGGTTGAATAG-1	CM
AGCTGTACAACTCGTA-1	CM
GTCACAAGTCGCGCTA-1	CM
TTGTTGTAGGCAGTAC-1	CM
ACAGCGCTCCCTAAAG-1	CM
TGTTAGGAGCGTAGCA-1	CM
AAGATAGCACTCCACT-1	CM
CTAGGATAGGTAGGCT-1	CM
GGCATTAGTACAAGCG-1	CM
GTGCTGGGTTCCCAAA-1	CM
CCTATTACATGACTGT-1	CM
CTCTCAGGTATTGTGC-1	CM
GAACCTACAGAGAGAA-1	CM
ACGTTAGAGAACGCCA-1	CM
CAATCCCTCTGGACAT-1	CM
ATGTCTTCACGTGAAG-1	CM
GCGAGTCCAGCGTCGT-1	CM
TTGCGGGGTCCTCAGG-1	CM
GACCCAGCAACGGGTA-1	CM
GCTGTTCTCCGGACTG-1	CM
GGAATCTAGTGAGTTA-1	CM
TGCTCGTCAGAAGTGC-1	CM
TAATTCCAGTGAGCAC-1	CM
CAGTATGTCAGCCGAC-1	CM
TTACGGAAGGTAGGAA-1	CM
GCGGTGTAGCCATCAT-1	CM
GCTCGAGCATTACCTT-1	CM
GGAACTTTCGGTACTA-1	CM
TTGTTGTAGCTGGAGT-1	CM
CGCTGGAAGGTCTTTG-1	CM
ACCGCAGGTGAATCGG-1	CM
CGCAATAGTGGGTAGT-1	CM
GCACCTTAGTGTGTAA-1	CM
TTAGGTGTCTATACCT-1	CM
ACTACGAGTCATCAAC-1	CM
TGTACAGAGTACCTCA-1	CM
TCACTCGCAAGAGCGT-1	CM
TATCTGTCAAGCGTCC-1	CM
TCGCAGGAGTAATCAG-1	CM
TAAGCCAGTCTGATTG-1	Fib
GTTCAAGAGCGTTAGG-1	CM
ACGTTAGCACTTTGGA-1	CM
TGAATCGAGCGTATCT-1	CM
GAGATTCCAAGGACCA-1	CM
GAGGTCCGTATGCTAC-1	CM
TTCAACTGTGGTGGTA-1	CM
AGCGTATTCTGTGTCC-1	CM
AGCTATGCATAGACGG-1	CM
CTACAGATCTCCCTTT-1	CM
TCCAGAACATAGATAG-1	CM
AACTGGTGTCAAACAA-1	Fib
CTCTAGCCAAGCACTT-1	CM
TTCTGTAAGCAGTAGC-1	Fib
CATTGGAGTTCCCGGA-1	CM
CACGTTCTCGGAAAGC-1	CM
TGATGCAAGAACGCCA-1	CM
AAATGCCTCAATCGTG-1	CM
ACCAAACGTGGTTCTA-1	CM
TAATCGGGTCACCCGA-1	CM
CTCTACGCATCCTCGT-1	CM
TATGTGGTCGGATGTT-1	CM
GCTCGAGTCCGGCGAT-1	CM
TAATTCCGTAACATAG-1	CM
TAGGAGGCAGTATACC-1	Fib
GATTGACTCATGCTTT-1	CM
GACCCAGTCTTGGCCT-1	CM
GTCGTAAAGCGAGCTA-1	CM
GTCACGGGTCAGTGCC-1	CM
CAGTGTAGTCTCTAAG-1	CM
AACGGGACAATAGCGG-1	CM
CCCACATCAATCCATG-1	CM
CGTAAACAGACTCTTG-1	Myeloid
GCTTTCGCATAGAATG-1	CM
CGCTATCCAACGGGTA-1	Endo
TAACAGCGTAGGTCTT-1	CM
GACCCAGTCACATTCT-1	CM
CAGCTGGGTTGCAGCC-1	CM
GAGCATTGTTGAAGCG-1	CM
CTTCTAATCGTTCTAT-1	CM
GGTCATACAGGTTATC-1	CM
ACAGACTGTGGATTTC-1	CM
ATTTGTCCAGGCATCC-1	CM
AAAGGATAGAAGCCTG-1	Neuronal
GGAATCTAGTGGACGT-1	CM
GTGCTGGCATTTCTTG-1	CM
TGACAACAGAGAGTTT-1	CM
TAGGTCACACTAGCCG-1	Fib
CACTAAGTCCATCGAA-1	CM
TGTACGACAGAATGCG-1	CM
TGCATTTAGACCGCAA-1	CM
CTTGCCAGTTAACCGT-1	CM
GCGCCAAAGTAATCAG-1	CM
TGACTCCCATCATAGC-1	CM
GAGATTCAGATGCGAC-1	CM
TGAGTCAAGAGTGGAA-1	CM
ATATTCCGTAAGTGCG-1	CM
TGCATGAAGTCCCTCT-1	CM
GTCACGGAGGCGACTA-1	vSMCs
GTTACTTTCAGGAATA-1	Fib
CTGCTCAAGGCGTCCT-1	CM
GTGCCAGTCCAGTTAG-1	CM
GTCACGGTCCGGGCAT-1	CM
TTGTCTACACCACAGC-1	CM
GGAACCCCACTAGGAG-1	CM
AATGTCGCACTGTTAG-1	CM
ATGCATGAGTTGCCGC-1	CM
CAACGTACAGCAAACG-1	CM
GGGTGTCAGTTCAAGA-1	CM
ACCGGGTAGTCACACT-1	CM
TCCGACTCAATGCATC-1	CM
ACTTCCGGTAACCCAT-1	CM
GTGTGATCAATGACTC-1	CM
AGGCCTGTCGCATAAC-1	CM
AAAGGGCTCACCGCGA-1	CM
ATGTTTCGTCTGCGCA-1	CM
CTTGTCGTCGTGAACT-1	CM
GATGGCCAGGCTAAAT-1	CM
GCCAGACCAAACCTAC-1	CM
CTGGCAGCAACTGCGC-1	CM
CTCAGAAGTGGCGCTT-1	CM
CTCATGCCACAACGGA-1	CM
GTGGATTCAAGACTTC-1	CM
TGGCCTTAGGAAGGTA-1	Fib
ATCCTGCCATTTGTTC-1	CM
TCAAGCAAGTGAGTGC-1	CM
GTCTACCGTTGCAGCC-1	CM
TACTGCCTCTTTGCAT-1	CM
TGTGACATCTAGCTGA-1	CM
CCACAGGAGTGATAAC-1	CM
TAATCGGCAAATGTCC-1	CM
TTGAGTGGTGAGTAAT-1	CM
ACTGTCCTCAGAGTGG-1	CM
TGCTTTAGTTTGCATG-1	CM
ACAGCGCAGAGCCTGA-1	CM
GTGTGATTCTTGCGCT-1	CM
CCAGAATCACGGTTAT-1	CM
TCAGGTAGTATCATGC-1	Fib
TATGTGGTCTCTCAAT-1	CM
GAGGATGCACGCTGTG-1	CM
TATGTGGTCCGTGCGA-1	Fib
AGCCTCTTCGGTGATT-1	CM
ACAAACCGTACTAGAA-1	CM
AGCTGGCAGAGCTACG-1	CM
TGAGCCGGTTCCTATT-1	CM
CTTGAAGGTTCATTTC-1	CM
GGGACCTGTGCAAGCA-1	CM
GCAAAGGCATCATGTG-1	CM
GCTCCTACATTTGTTC-1	CM
GCAGATTGTCCGTCGA-1	CM
CGCTGGAGTGGTGGTA-1	vSMCs
GTGATCACAACTACTG-1	CM
AGATAGAAGTACAACA-1	CM
AGCCGCATCTACCCGT-1	CM
AAACGAAAGGAACCGT-1	CM
CATTCATCAGGATGTG-1	CM
AGCCTCTGTCTAAAGA-1	CM
TCAGGTAAGGTCTTGT-1	CM
TCACCACAGGTCTTGT-1	CM
TCTCAGCGTTAGGCTT-1	CM
GTGTGATTCACTCGGG-1	CM
CAGCTGGCATTAGCAC-1	Fib
CCGCATTCATCTCACC-1	CM
GTCGTAATCAGGAATA-1	CM
AGCTATGTCTTCAGAG-1	CM
GTGACATGTCGATAGG-1	CM
AAATGCCTCCTCTCTT-1	CM
TTGAGTGCACACACAT-1	CM
TTCGCGTCAGCGTCGT-1	CM
CTCCCAATCACTCCCA-1	Fib
GAAAGTAAGAACGCCA-1	CM
ATGTACGGTCCTTCAC-1	CM
TCAGGGCGTTCTGAAC-1	vSMCs
AAAGATGAGCAGAATT-1	CM
CCCTAACCATGGATGG-1	CM
AACTGTGCACATTGCA-1	CM
GATTGACGTATTCTTC-1	CM
TCAAGACTCCCGTAGG-1	CM
GGTACCGGTAGTGATA-1	Fib
GGGAACACACCGTCTT-1	CM
TGGCCTTTCTTCCACG-1	CM
AGCCGCAGTCTCGGGT-1	CM
TACTCGCCAATTCGTG-1	CM
TTCGCGTTCAGTCACA-1	CM
AAATGCCGTTACGCTA-1	CM
ATTACCTTCCTCCCAA-1	CM
CTGGCAGTCCGTACGG-1	CM
GCGATCGTCTGACATG-1	Fib
CTGTTCGGTAAACGAT-1	CM
ACGTGGCAGCAACTGG-1	Myeloid
CACTAAGAGGCAGTAC-1	vSMCs
GCCTACTTCGCGTGAC-1	CM
CATGTTTGTCGACTGC-1	CM
GGATGAGGTGATGCTT-1	CM
ACCGAATAGAGAGGTA-1	CM
ACAAAGAGTCAGAAGC-1	CM
TCCGACTAGTTATGAG-1	CM
TTCTAACTCGCTCTAC-1	CM
TGTGTCCTCGCTGATA-1	CM
CAACCAAGTGCTTGAT-1	CM
TACAGCACAACTTGGT-1	CM
GTGCTGGTCGTGGTAT-1	CM
CCGAAGCTCTACCCGT-1	CM
GCGGAAAGTCAAATCC-1	CM
CTGCGTTGTCTGGGCT-1	CM
TTGTCTAGTCCTTCAC-1	CM
TACCTCGCAGGTCCTG-1	CM
TCACCTGGTCAGCTTA-1	CM
TAGCACAAGGATGCCA-1	CM
CGCACAGTCACAAGCT-1	CM
TTGCGGGCAAGTAACA-1	CM
AGTCAACCAATGCCAT-1	CM
ATAGTCGCAAATAGTG-1	CM
ATTGTGGCACTGCTCT-1	CM
AGATTCGTCGGTCCGA-1	CM
TGTACAGTCGGAAAGC-1	CM
TCACTCGCAGGCAGAT-1	CM
GAGCATTCAATGGTCT-1	CM
TTCTAACAGCGTAGCA-1	CM
TGGGTGCGTGACGCAA-1	CM
TATCTGTTCTTCTTCC-1	CM
CTGTATTTCAGGTCTA-1	CM
TGTAAGCTCCCATAGA-1	CM
GTGGATTCAAGTCTGT-1	CM
CTCAACCTCCGTGCGA-1	CM
TGGCGCATCGTATAGC-1	CM
ACGTTAGTCATTCTCA-1	CM
GCAGCTGTCGGGAAAC-1	CM
GCGATCGCATAGAATG-1	Fib
CGCAGGTTCTCGCGGA-1	CM
AGTTACGGTGAGTCGA-1	CM
GTCACAATCTATACCT-1	CM
TCAGGGCTCTATATCC-1	CM
CGCAATATCGCTTCAC-1	CM
TGTGGCGAGGGTATCG-1	CM
TTAGCGATCTTCTCTC-1	CM
CGCAATATCGTGATAC-1	CM
GCACCTTAGGCAGATC-1	CM
TTACCCGTCTGGGCGT-1	CM
TGCTTCGAGCCTTTGA-1	CM
TGGTCCTAGATTCCGT-1	CM
TTACTTGGTTTGTACG-1	CM
TTAACGGCACAGAAGC-1	CM
GGGAACAAGATGTTCC-1	CM
AACTGTGGTGTCCCAG-1	CM
TCAAGGTCATAGAATG-1	CM
AACATCGGTTGGAGGT-1	CM
ATTACCTCACGCGTTG-1	Neuronal
CCGCATTTCTATCCTA-1	CM
CTGTATTAGTTAGCAA-1	CM
AGGCGTCCATGGGAAC-1	CM
TTATGTCGTTCCAATG-1	CM
CTGCTCAGTGGGTAGT-1	CM
AGCCTTCCATGGATGG-1	CM
GGACACCAGCGTTGCC-1	CM
GGGAACAAGACCATAA-1	CM
ATGTCGACAGCGTGAA-1	CM
GTCACAACAGGTAGCA-1	CM
TAGCATGCACCTACCT-1	CM
TTACCCGAGTCGACCC-1	CM
TTGGTCCGTGCTGGCT-1	CM
CGCTATCAGCGATACG-1	CM
GGCGAAATCTTCACTA-1	CM
ATCGAGTCATCATGTG-1	CM
TCAGCTCGTTCCAATG-1	CM
CCCTAGTTCCATATCT-1	CM
GTTATTCGTGTTGGTT-1	CM
GGAGTAGTCCATAGGT-1	CM
TAAGTGCTCTTTCGAT-1	CM
ACGTTAGAGGTGATGC-1	CM
ATCCTGCCATTTGGTG-1	vSMCs
ACGTGGCCATCCCTCA-1	Fib
CATTGGATCTCGGCGA-1	CM
TTTGGTTTCACCACAA-1	CM
AAAGGGCGTGTTTCTT-1	Myeloid
ACTCGGGTCCCACGGA-1	CM
TCGATTTGTGCTGAAG-1	CM
GCGGAAAAGTAGCAAT-1	CM
GAACCTAGTGCTGTGC-1	CM
CTTGTCGAGAGCGGTT-1	CM
AGCTGGCCATCCATAG-1	CM
GCGGAAATCACGATTG-1	CM
CTCACCACATAGCAGG-1	CM
ATAGGCTAGGAACCGT-1	CM
CCAGAATAGGACCGAT-1	CM
TATCTGTAGGTTACAA-1	CM
CGCAGGTAGCAGTAGC-1	CM
GGATGAGTCTTACCTA-1	CM
GGGACCTGTGCTTACA-1	CM
TACCTCGTCATTCTTG-1	Endo
GACTAACTCCAGGTAT-1	CM
CAGCCTTAGGAACCGT-1	CM
TATCGAGAGCTTTCCC-1	CM
AACGTACCATTGCGAT-1	CM
CCTTGGTTCCCGGGTA-1	Fib
TAAGTGCGTCCAAGAG-1	CM
CTCGCTAAGCAGTAGC-1	CM
TAAGTGCGTCAACAGG-1	Fib
ACTCGGGAGTCACACT-1	CM
CGATGATCACATGATC-1	CM
GGTGTCGAGATGGGAA-1	CM
TGAGCCGCAAGGTCGA-1	CM
GTGTGATAGTCGAAAT-1	CM
TGTTAGGAGCTAGCAG-1	CM
TTGGTCCTCAGCACGC-1	Myeloid
GCGGGTTCATCCGTAA-1	CM
CTTGTCGCAAGCCAGA-1	CM
CTTGCTGTCCATCTAT-1	CM
CCTATTACATATACGC-1	Fib
AAGATAGAGCTCCGGT-1	Myeloid
ACCCAAAGTACTATGC-1	CM
TAACAGCCAAGATTAG-1	CM
TCAGGTACAATTGCCA-1	CM
TTGACGAGTTCCGCGA-1	CM
AGCCAGCCACGTGAAG-1	CM
CAGCTGGGTAAGCCTT-1	CM
TGAATCGAGAATCAAC-1	Fib
GTGATCATCGAACCGC-1	CM
ATTTGTCCATTACACG-1	CM
TCGAGCGTCTAGTCGA-1	Fib
TACCCTGCAGTTACAC-1	CM
ATAGGCTAGGGCTTCC-1	Fib
GGGTTATTCTTTATCG-1	CM
AAATGCCTCTCGCGGA-1	Endo
CAAGCTACAAAGAGAG-1	CM
GTTACTTAGCATTCCA-1	CM
ATTGTGGGTTTGCCCT-1	CM
TACGGATTCACACGTA-1	CM
CGGACCATCGCAGATT-1	CM
GCAGATTTCCACGGCA-1	CM
GCACCTTCAGAGAGAA-1	Fib
TACCTATGTCATTGGT-1	CM
CACAGATGTCTAAGAA-1	CM
CAGTGTACAATTCGTG-1	CM
AGATAGATCAATTCCT-1	CM
CGTACAATCTATCTCA-1	CM
CCATACCTCAGTCTTT-1	CM
ACCGGGTTCTTCAGAG-1	CM
CTCTCAGGTAAACGGC-1	CM
TGTGGCGCATGGTTTG-1	CM
ATGTTTCGTCAACTGT-1	CM
TAAGCCACACTTTGGA-1	CM
TCAATTCAGTACTCTG-1	CM
TAGCTTTCACGATATC-1	CM
TTTGTGTTCCATCGAA-1	CM
CGCAATAAGACTCTTG-1	CM
ACAAACCAGCTCCATA-1	Fib
GGAGGATTCCTAAGTG-1	CM
GCGTAGCCAGAGAGAA-1	CM
CCTTAATGTGGACCAA-1	CM
GACCTTCGTACAACGG-1	CM
TTGCTATCACTGATAC-1	CM
TCGGGACAGTACGACG-1	CM
AGATAGAGTCATCAAC-1	CM
CTACAGACACTCGCAG-1	CM
ACCTGCTAGTGAACCG-1	CM
GGACACCGTGGCGCTT-1	CM
AGCCTGGTCCTGAAAC-1	CM
TTGTTGTTCTGATCCC-1	CM
TCACCTGCAGTATACC-1	Fib
ACTACGATCCTGGGAC-1	CM
ATCGAGTCATCCCAAA-1	CM
CTCTCGACACGCGCAT-1	CM
GCGAGAAAGTCCGATT-1	Fib
GTGGATTCATGCCTTC-1	CM
CTTGCCAGTAGGTCTT-1	Pericyte
CGCACAGAGAGAACCC-1	Myeloid
CCGCATTTCGGCATAT-1	Fib
TTCTAACCAAGGACCA-1	CM
CTGGCAGGTTCCGGCA-1	CM
TGCTTTATCGGTTGTA-1	Endo
TACGGATCAAACTACC-1	CM
TTCAACTCATGGGAAC-1	Endo
TCAAGGTGTCACCGCA-1	Fib
CGGACTGAGGTTTCTG-1	Fib
CAGTATGGTGCTTGAT-1	CM
CTGTATTGTGCTAGTT-1	CM
AGCGTGCGTGAGGGTT-1	Fib
GCAGCCAGTTGTATCG-1	CM
CAACGTAAGATATGAC-1	CM
ACATGCAGTACTTCGA-1	CM
ACAGCGCGTGAATGGC-1	CM
GCAGATTGTAACACTC-1	CM
CTGTATTAGGTAGGAA-1	Fib
ACGTTAGGTGCACTTA-1	CM
GCTTTCGAGCACCATT-1	CM
GATTGACAGTGAAACT-1	CM
CTTGCTGTCGGTCCGA-1	CM
GAAGTCTTCTGGACAT-1	CM
GCGCCAAAGTTCGACT-1	CM
AGGCCCAGTAACTGAA-1	Myeloid
TTGTTGTTCACAGGGA-1	CM
AGCTATGTCCGATTGA-1	CM
AGCCAGCGTTTGCGAT-1	Fib
CACAACAGTCTCAAAC-1	CM
AGGCCTGGTGGATTTC-1	Endo
CAACGGCGTTAACCGT-1	CM
TGCTATTAGGTGAACC-1	CM
GGTGAAGTCTCTATCA-1	Myeloid
TACGGATCAACGACAG-1	Fib
ACGTGGCTCCATAACG-1	CM
AGACAAAAGACTAGCG-1	CM
GCTTGCTGTCTGGATT-1	CM
TCTATTGGTCATAAGA-1	CM
ATAGTCGGTTCGGGAA-1	Myeloid
GAGCGCTGTGCAACAG-1	CM
GAACTTGAGGCACCTC-1	CM
TTTACGTAGTCCGATT-1	CM
CATGTTTCAGCCACGT-1	CM
TTAACGGGTATGAAGT-1	CM
TCCGACTGTTATCGAC-1	CM
GGAATCTTCGGTTCCT-1	Myeloid
TTGCGGGCACGCGTTG-1	CM
GCGAGTCGTGTCCCAG-1	CM
CACAGATCAGCTGATT-1	CM
AAAGATGAGTTGCTTG-1	CM
CTTGAAGGTTTCTTAC-1	CM
CAACCAAGTTCCGCGA-1	CM
CTCGCTAGTTTGCATG-1	CM
CGGTGCAGTAATGTAG-1	CM
TTTGGTTGTTTGATCG-1	CM
CCTGCTAGTTACACTG-1	CM
CTACTTAAGGAGACTC-1	Fib
AAACGAAAGATACCAA-1	CM
TTGTCTATCGGGAAAC-1	CM
CGCAATACAGTTGCAT-1	Myeloid
GTCGTAAGTATTGTCG-1	CM
TACGGATCACATCATG-1	Fib
TTCAACTGTAACTCCA-1	CM
GGGACCTGTTCTTTGT-1	CM
TACCCTGGTACCCACG-1	CM
TCAGGGCGTAAACGAT-1	CM
GTCACCTCAATTCGTG-1	CM
GTGGATTAGGATCCTT-1	CM
GCATTGAAGTTAGAGT-1	CM
GAACGTTTCAGTCAAC-1	CM
CTAGGATAGCCTGTAT-1	CM
GCAAAGGTCGGAGTTT-1	Fib
ACATGGTTCCGCGATG-1	CM
ACCATCCTCTTCATAC-1	Myeloid
TGCATTTGTAACCATC-1	CM
GCATGATGTTACTTTC-1	Fib
CCCTAACAGGCCAATG-1	CM
ATTTGTCAGACTCTTG-1	Fib
TCACCTGAGAGGCAGG-1	Endo
GTGTCCTGTGAATCGG-1	Fib
TGATCAGAGTTCGACT-1	CM
AACTGGTTCCGCGATG-1	CM
TCAGTCCCAAGGACCA-1	CM
TGCTATTCAGGGTACA-1	CM
CAGTGCGAGCCGCTGT-1	CM
GACCTTCCATCTCTCG-1	CM
CTCTCGAGTACCTATG-1	CM
CTGGCAGCAGCGCGTT-1	CM
GCATTGAAGTGGTGTG-1	Fib
GTCCATCTCAGTGTAC-1	Endo
GCTGTTCGTATCTCAG-1	Myeloid
CTCAGCTCACCTACCT-1	CM
GCAACCGCAAGCCAGA-1	CM
TTGCCCAGTACTATGC-1	CM
TCACTCGGTCATCAAC-1	Fib
CGCTATCCACGGTGTC-1	CM
GACCAATCACAGAAGC-1	CM
GTGTGATTCATGTTCT-1	CM
CTCATGCCATATACGC-1	CM
CCCAGAGCACATGATC-1	CM
ACAAACCGTAACGGAC-1	Pericyte
GCCAGACCAGCTGATT-1	CM
CAACGGCTCATGAACC-1	CM
GTGTCAACACTCAAGT-1	CM
CCATACCTCGAGTGTT-1	Endo
CAGTATGCAGCGTACC-1	CM
GAGACTTAGTCTTAGC-1	CM
TCGTTCGTCTAGCTGA-1	CM
TAATTCCGTTCTACGA-1	Endo
GTGGCGTCAACGGGTA-1	Fib
GCGCCAATCTTGTGCC-1	Fib
CAAGAAAGTGCTGGCT-1	CM
GAACGTTTCACGGGTC-1	CM
TAACAGCGTGGACTGA-1	CM
TCAGTTTTCGCGTTCT-1	CM
TTCTAACTCGAGGTCC-1	CM
GCCAGCAAGTCGACCC-1	CM
GAACTTGTCGTGAGTT-1	Fib
AAGGAGCGTAGCAGCA-1	CM
GGGTTATCAATAGCGG-1	Fib
CAAAGCTCAGTAGTCT-1	CM
CTTGCTGAGGCGCTTC-1	CM
TCAGTTTAGCGTATCT-1	CM
GCTCCTAGTAAACCCT-1	CM
ACTACGAAGGTTCGAG-1	Fib
ACCGAATAGAACTCCT-1	Fib
GCCATAAAGAGAACCC-1	CM
GGACACCAGGAATGGA-1	CM
CCCTGATAGAACTAAC-1	CM
ATTCGTTCAAGCGAAC-1	CM
CTCAGAATCGTATAGC-1	CM
GACCCAGGTCCGGTAC-1	CM
GTCACTCCACCATTCC-1	CM
TCTAGTTTCGGTCAGC-1	CM
CATGCCTCAGTAAGCG-1	Fib
TTCTAACGTGTACGCC-1	Fib
AAAGGGCGTATCTAGC-1	Myeloid
GTTATTCCAGGTCCTG-1	Myeloid
TCTAGTTCATATAGAG-1	CM
ATTACCTGTAATGTGA-1	CM
CTGCTCAAGGTGAACC-1	CM
GCGTTGGGTTCTGATG-1	CM
TACGCAATCCCAGCAG-1	CM
ACTTCCGGTCATTGGT-1	CM
CACCACTTCCGTTAGA-1	CM
TACAGCACACAAGGGT-1	Lymphoid
CACCTTGTCTGGGCGT-1	CM
AATGGAAGTTTCCGGG-1	Fib
AAACGAAGTGGACCAA-1	CM
TGTACAGAGGTTTCTG-1	Myeloid
GAGAACGTCTACCCGT-1	CM
GACCGACTCCAGGCCA-1	Fib
AGATTCGAGACCCATT-1	Myeloid
TGATTTCGTTTCAGCA-1	CM
GCATGATAGCCATCAT-1	CM
CGGTGCATCAGGTCTA-1	CM
TCTCAGCCATTGCACA-1	CM
TTCATTGCAATGGTAA-1	CM
TAGGTGTAGGCTTAAA-1	Fib
CATTGGATCTCTGCGT-1	CM
GCTTTCGTCAAGAGAT-1	Fib
GAGGATGAGCTTACCA-1	CM
GCCTACTTCGTGGAAG-1	CM
TGCCTGTGTCATGAGG-1	CM
AGTCCGGGTGAGGTCA-1	CM
GCAGATTGTCATGAGG-1	Fib
GGAACCCTCGAGGCTC-1	CM
ACCGGGTTCCCAATAG-1	CM
ATTTGTCTCCACGAGC-1	Endo
GCGAGTCTCTTACTCA-1	CM
AGGCGTCGTCCGAGCT-1	CM
ACTAGGTAGTGATCTC-1	CM
GCAGCCATCGCGCCAA-1	CM
TAAGCCAAGAGCACTG-1	Myeloid
ACAAACCCAGGAGCAT-1	CM
AACTTGGTCGCATACA-1	CM
TCAAGACTCCGCCTAT-1	CM
GATGGCCAGATCGATA-1	Myeloid
CAGTGCGAGATGCGAC-1	CM
TGGACATTCACGTGTA-1	CM
CTCAGCTCAGCAAACG-1	Endo
CAGTGTATCGAGAACG-1	CM
CTAACTTTCGTCTAGA-1	CM
AAGGTTCAGACCAATA-1	Fib
TTTGTGTGTGCACCCA-1	Myeloid
TTTGCGCCAGTTCGGC-1	CM
GCGCCAAGTGATAAGT-1	CM
AGGCCCACACCCATCT-1	Fib
TTGACGATCTATGAGC-1	CM
GGCGAAAGTGGTTCTA-1	CM
GGAATCTGTGCTGTGC-1	Myeloid
ACATGGTCATGGGACA-1	Fib
CAGGATTAGGCACTAG-1	Endo
ATGCATGTCTAGTCGA-1	CM
GCCTAGGCATTGATGC-1	CM
CAGTGTACAAGTAATG-1	CM
CCGTGAGTCACTTACT-1	CM
TGCTTTATCCAAGTCA-1	Fib
GGGTCTGTCGCGATGC-1	Fib
AACCGATAGTGTCCCG-1	CM
ACAGAAAAGAGTTCGG-1	Fib
TTTGGTTGTGATGCGA-1	CM
ACTTTCATCCCACTAC-1	CM
TGTAGCACAGACCTGC-1	CM
AGTCAACGTTCTACCC-1	CM
GTTGGGCTCTCTGCGT-1	Fib
ATATTCCAGCACCATT-1	CM
GCGATTAGTAGGTGAC-1	CM
TACATTCCAAACGTTC-1	Fib
GCCCGAACAAAGCATA-1	Endo
ACGTGGCTCATCGCAA-1	CM
AGTGTACCACCATTCC-1	Myeloid
CCGTAGGCACGCGTTG-1	Pericyte
ACAGCGCCATTGTGAC-1	Endo
CCCTCTCAGAGGCAGG-1	Fib
GTAGTACAGTACGCGA-1	CM
GCCATAACATTGCGAT-1	Fib
TCGCAGGGTGATGCTT-1	CM
CACAACAGTTTGTACG-1	Pericyte
TTGACGATCGCTACCT-1	CM
TACTGCCTCGGAAAGC-1	CM
TTCAACTAGATCTCAC-1	CM
CCATACCAGGAGTCTG-1	CM
CCTGCTAAGACTCGGA-1	CM
CCACGTTTCACGATTG-1	CM
TTTGCGCCAATGATGA-1	CM
TGCTATTTCAGGCGCT-1	Endo
CTGCTCAGTAACCGAG-1	CM
CTGCTCAAGGTTGTGG-1	CM
GTCACGGCATATACGC-1	CM
CCACGTTGTTTCAGCA-1	Fib
GCTCCTAGTGAATCAA-1	CM
ACCAAACAGCTGCCAC-1	CM
GTCACAAAGTCGTGAG-1	CM
TTCTGTAGTGCTGAAG-1	Endo
TAGCCGGAGGAAGAAC-1	Myeloid
TACTGCCAGACCATAA-1	CM
GATCATGCATTGAACC-1	Fib
TCGATTTGTAGGTCTT-1	CM
TCCAGAATCCGGGCAT-1	Endo
CGGACTGCAGTGGTCC-1	Fib
CCTAAAGTCTGTTGCC-1	CM
ATGTCTTAGCTACGTT-1	CM
GCGGGTTCACGCCGAT-1	CM
GGGCCATAGTTAGAGT-1	CM
CAGGATTGTAGAAAGG-1	Fib
GCGATCGTCGTTTGAG-1	Fib
GCTTGCTAGGCCTAAG-1	Endo
TGCTATTAGAGGTCCA-1	CM
GGTCATACACTTGCGG-1	Fib
AAAGGGCCACTGAAGG-1	Fib
ATCCAGATCAGTGTGT-1	Myeloid
TTACTCAAGGCAGTAC-1	CM
CCCACATCATAGATAG-1	Myeloid
ATCCTGCCATCGCTAA-1	CM
TTACCCGGTCTGAGCC-1	Myeloid
CATTCCGCATGTGAGG-1	Fib
TGCATGAAGTCCAGAG-1	Fib
CGTGGCAAGGATGTAT-1	CM
CTGAATGAGGGCTTCC-1	CM
TGTTAGGAGACACTTC-1	CM
CGCTATCAGCCCATGC-1	CM
AAGGTTCTCGGTCCGA-1	Endo
TGTACAGAGGTTAGTA-1	CM
ACTAGGTGTCTCAAAC-1	Fib
GCTTAAGGTCGAGAAC-1	Myeloid
CTCTAGCAGTAGACCG-1	Endo
AAACGAAAGGATGCCA-1	Endo
ACATGGTAGCTGATTC-1	CM
GGTGAAGGTAACGGCA-1	Myeloid
GAATCTGCACCTGTGG-1	CM
GAAAGTAGTTAGGAAT-1	Pericyte
TCCAGAAAGAACCATA-1	CM
TTGGTCCTCGTGCTGG-1	CM
AGCTGATCACTGTTAG-1	CM
AGCCTTCAGACCATAA-1	CM
GTGCCAGTCTATAGGC-1	Fib
GTGTGATAGGATTGAT-1	Myeloid
GCACCTTGTCTGTCCT-1	CM
TGCTCGTAGGAGGCGA-1	CM
CAACGGCTCCGGCGAT-1	CM
GAGACTTAGAGCACTG-1	CM
AACGTACCACCTGTGG-1	Fib
GCAGCTGGTTCCCTTG-1	Myeloid
GCGGAAACAATCCATG-1	CM
GGCACGTGTTATGCAC-1	Fib
TGATTTCGTGTGAGGT-1	CM
CACAGATGTTAAGTCC-1	CM
AGCCCGAAGTGTCGGA-1	CM
GTACTTTTCTGGCACG-1	CM
CAGCTGGAGACCCATT-1	CM
CTTGTCGAGTATACCC-1	CM
CTGGCAGGTAATGTGA-1	CM
TAAACCGCAATGGCTT-1	CM
CCGTACTCAACTAGAA-1	Myeloid
TAACAGCCACCGTTGG-1	Endo
GCTCAGGTCCTAGAGT-1	Endo
GACCGACTCTCGACCT-1	CM
CCTAAAGAGACACTTC-1	Endo
TAGACTGGTGAGGGTT-1	Myeloid
TCCGACTAGGCAAGGG-1	CM
CAAAGCTGTCACCCGA-1	CM
CAGTGCGAGGTCTTTG-1	CM
TCGATTTAGTTCAACC-1	Myeloid
CCCTCTCAGGCTCAGA-1	CM
CGGTGCAAGAGACTCG-1	Fib
GTCTACCAGCGAGCTA-1	CM
GGGTTATTCGAAGCCC-1	CM
GACCTTCCACAAACAA-1	Endo
AGCCGCACATTGAACC-1	CM
TGATCAGAGTAACACA-1	CM
TCTAGTTCATCAGAAA-1	Myeloid
TAAGTGCAGGAATGGA-1	Fib
CCGTACTGTTCATTTC-1	Lymphoid
TCAGGTATCAATCGTG-1	CM
GAGTGAGCAGATGGCA-1	CM
GCGGAAATCACGTGTA-1	CM
GCTCGAGTCGCTAGTA-1	CM
ATGTACGGTCCGTCGA-1	Pericyte
CTGAATGAGGTACTCT-1	Fib
GAGGTCCCATCCCAAA-1	Fib
TGAGTCAGTCTGCGCA-1	Fib
TCAAGACCATTTGGCA-1	Myeloid
TTGCTATAGACGCCCT-1	CM
CTAGCGGCATCCGTGG-1	Fib
CACGTTCCATAGACGG-1	CM
TCAATTCAGAACCATA-1	CM
ATCCAGATCCTTACGC-1	CM
TGGCAATGTATTCTCT-1	CM
CTTAATCGTGGACGAT-1	CM
GGATAGGCACTCAGCG-1	Fib
ACTACCCCAGATAAGT-1	CM
CTAACTTCAGAACTTC-1	Pericyte
TTGTCTATCTACCCGT-1	Myeloid
TCACTCGTCGCCACTT-1	Fib
TAACAGCAGTTGCTTG-1	Fib
ACGTTAGGTGTTGTTG-1	Fib
CACGTTCGTATGTCCA-1	Myeloid
GGGTTATAGGAATGGA-1	Fib
GCAGCTGTCGATATGC-1	CM
TGGCAATAGCCAGAAC-1	CM
TTTGCGCGTATCAGCT-1	Fib
AAACTCGAGGAGTAGA-1	Myeloid
CACCTGTAGCCAGAAC-1	Myeloid
CAAGGCCTCAGGCCGT-1	Myeloid
CAGCTGGGTGCATTGT-1	CM
TTGCTTACATGTGAGG-1	Pericyte
TGTGGCGTCCCAGCGA-1	Endo
TGACAACGTCGCTACG-1	Fib
CATTCATGTACATGGG-1	CM
CAACCAAGTCCCTAAA-1	Endo
GGATGAGAGCCATCAT-1	Myeloid
AGCCTCTTCCAACAAC-1	Endo
GCGATCGAGGCCTCGT-1	Endo
CACCTTGGTAGTACAA-1	CM
CTCAACCAGCAGGACT-1	Pericyte
GCTTGCTCACCTACCT-1	Pericyte
TCTATTGTCAGCACGC-1	Endo
GGCACGTGTACGTATC-1	CM
TCACCTGAGTAGGTCG-1	Myeloid
CCGTACTTCAAATGGA-1	Endo
CCCGTTAGTATTCACG-1	Fib
CAATCCCCACATTCTT-1	vSMCs
ACAAAGAAGTACGACG-1	Pericyte
GCGGAAACATAGAATG-1	CM
CCTTGCAGTAAACCCT-1	CM
AACAAAGCATGGCCCA-1	Endo
GTGTGATAGTGTCGCC-1	CM
TCACCTGCACTAGCCG-1	CM
CCTAAAGGTCAGCTTA-1	Pericyte
GCCTAGGGTGCTGAAG-1	CM
GGAGTAGAGATGTTGA-1	CM
GCAGCTGCATCTCACC-1	CM
CCCTAGTCACTTACAG-1	Myeloid
GTGCCAGCAAACCGAG-1	CM
TAGCTTTCAGGTAGCA-1	CM
CTTAATCGTTCCGGCA-1	CM
CTCTAGCGTATTCACG-1	Fib
ACATGGTGTGATAACA-1	Pericyte
AATGCCAGTAGCGTTT-1	Endo
GCATTCCTCGTGAGTT-1	CM
GCTGTTCTCACATTCT-1	Pericyte
CAACCAACAATAGCGG-1	Fib
GGTAGGACACATCATG-1	CM
TTCTGTATCCATCGAA-1	CM
TTTGAGGAGTAGAAGG-1	Pericyte
TTCGTTAGTTACCCAA-1	CM
CAATCCCTCTTGGCCT-1	CM
CTGTATTCAGCAGGTA-1	Fib
CTGTATTAGACGCCCT-1	Endo
CGGACCATCCGATTGA-1	CM
GGTGAAGTCTACTTTG-1	CM
GTCGTAATCATCGCTC-1	CM
AACCAACAGAACTAAC-1	Myeloid
TCACAGACAACAACTC-1	CM
TAGCACAAGCTGAATA-1	Fib
ATTACCTGTACATGGG-1	CM
CATGTTTTCTTTGCAT-1	CM
CATGTTTGTCAGAGTG-1	Myeloid
AAACGAACAGTGCTCG-1	CM
CAATCCCGTTACGGAG-1	CM
TACGCCTTCACTAGGT-1	Myeloid
GCTTAAGTCGACTCGG-1	CM
TACTAGGAGGATGCCA-1	CM
TTGACGAAGTCAACTC-1	CM
CACCACTTCAATTGGC-1	CM
GCGAGTCAGAGGCAGG-1	CM
CCTAAAGCAGGGAGTT-1	CM
ACGTTAGCAGATACAA-1	Endo
TCGATTTAGCGAGCTA-1	Fib
GTGTCAAGTTTAGGAA-1	Fib
GTAGGAGTCCCGATTC-1	Myeloid
CCACGTTAGGTACATA-1	Neuronal
ACTAACGCAGGGCTTC-1	Endo
TGACTCCCACCTACCT-1	CM
TTACCGCGTAGAAGCC-1	Fib
CTTCCAGGTGCAAAGC-1	Fib
AACTGGTCATTATGGC-1	CM
CCTTGGTCAACGTAGG-1	Endo
GAGGTCCAGTGTCGGA-1	Endo
ATGTCTTTCTTCACTA-1	Fib
CTAGGATTCCCGATTC-1	CM
ACAAAGAAGTGCTGAG-1	Fib
TCGCCTATCTTACTCA-1	Myeloid
GCGCCAAGTGCCCTAG-1	CM
GCTTTCGTCGCGCCAA-1	Endo
ATCCAGAAGAACCATA-1	Pericyte
TATCTGTAGTGTTCCA-1	Fib
TCAGTTTGTAAACGAT-1	CM
TCAGCTCTCGTTCAGA-1	Endo
CCCTAGTCATTGAACC-1	Myeloid
GTGTCAAAGAATCAAC-1	Fib
TCACAAGAGACAGTGC-1	Pericyte
GGTCATACAATTGGCT-1	CM
CTGAATGTCGTCAACA-1	Myeloid
CTACTTACAAGCTTTG-1	CM
AACGTACGTCCAAGAG-1	Myeloid
TTGAGTGGTTACGGAG-1	Endo
AATGGCTAGGTACACG-1	CM
CAATCCCGTCCAACCG-1	Myeloid
TTCTAACAGACACAAT-1	CM
CCACAGGCATCGTACA-1	CM
AGCCTCTTCGGTTCCT-1	Myeloid
AGCCAGCCACAGTTCA-1	Myeloid
AGATTCGTCGATAGGG-1	CM
GCGGTGTTCGGGTCCA-1	Endo
TCAGGGCAGAGAAGCA-1	CM
AAGGTTCCAAGGACCA-1	Pericyte
CTCACCAAGAACGTCG-1	Endo
TGATTTCAGAGCTGTG-1	Fib
CTCTCAGAGATACCAA-1	vSMCs
CCCTAGTCAACTCCCT-1	Myeloid
GCGGTGTCAGATACAA-1	Myeloid
TAAGCCATCCGTTTCG-1	CM
ATCCTCGAGAATCAAC-1	Myeloid
GGGCCATCATTTCACT-1	Myeloid
CACCTGTAGGGATCCA-1	CM
GACCGACCAAGCACTT-1	CM
GGGACCTCATCACAAC-1	Fib
TTATGTCTCAGTGTGT-1	Endo
GTGCACGCATCGTACA-1	CM
AGCCGCATCGGATCGC-1	Myeloid
TGGGTTAGTAGCGAGT-1	CM
TGCTCACTCTTATCAC-1	Myeloid
GACCTTCGTACGGAGT-1	Fib
TCACAAGTCCATTGAG-1	Fib
CCACAGGGTGTGCTTA-1	CM
GTTCAAGGTAGTCCAT-1	Fib
CACAACAAGTGCCCTG-1	Fib
AGTTTGGCAGGACCTC-1	Endo
TACCCTGAGTAGGAAG-1	Fib
GGGTGTCCAAACCCTA-1	CM
CCAGAATTCCGTTAGA-1	Fib
TTGCTTAAGAGCGGTT-1	Fib
GGATAGGGTGGATTCT-1	CM
AGTGCGCTCCTGGAAT-1	CM
GCATTCCCAAGATTAG-1	CM
GCTCCTATCCAGTACA-1	CM
ACAGGCCGTCTAACCA-1	CM
CAGTATGTCAAGGCCC-1	Myeloid
ATGTTTCGTTTCGACA-1	Pericyte
TATTGCTCACCTACCT-1	Fib
CCCTCTCCACTGTCAA-1	Neuronal
CCGAAGCTCACTAGCA-1	Myeloid
AGCCCGAGTTTCGACA-1	CM
GATGGCCAGTTCGTTG-1	CM
GTGGCGTTCGAACCGC-1	CM
GCTCAGGCATGCCTTC-1	CM
CTTTGCGAGTGATTAG-1	Myeloid
TGCACCTCATTGCCTC-1	CM
ATTACCTTCCAGTTAG-1	Pericyte
TTTGGTTGTGGCATAG-1	Myeloid
CACAACACAAAGGCCA-1	Fib
TCTCTGGGTCGAGGAT-1	Fib
TCACCACGTAACGGCA-1	Endo
GCGAGTCGTCCAAGTT-1	Pericyte
TCTATTGGTCCGTAGC-1	Fib
TCACCTGGTTTGACCA-1	Fib
AGCTATGGTTGGCTAT-1	CM
TGGGTGCCAAGATTAG-1	CM
TGACTCCTCCTGACCT-1	CM
TGCATTTTCCTGTGGG-1	Endo
ACCGGGTGTCGAGAAC-1	Lymphoid
ATGCATGCAACGCACC-1	Myeloid
TGGGTGCTCGCACCTT-1	Fib
AGCCTGGTCAAACCCA-1	Pericyte
AACAAAGTCCGCGATG-1	CM
ACTATTCTCTATACCT-1	Endo
ATCGAGTCATGATTGC-1	Endo
TTCATCAGTCGTCGCA-1	Myeloid
GTTGGTAGTAAACGGC-1	Pericyte
CCACGTTGTCACAGTT-1	Endo
CAACCAACAAAGCATA-1	Endo
TGTGACAGTAACGGCA-1	CM
CCCTGATTCTTTCGAT-1	Neuronal
TTGAGCACAGACCTGC-1	Myeloid
TGAATCGCACAGTTCA-1	CM
GTCCATCAGGTTAACA-1	CM
GGAGGATCAATTGTGC-1	Myeloid
GGAATCTCATGTGAGG-1	Endo
TTACTTGCACAGGAAC-1	Endo
TACATGGAGAGCCACA-1	Endo
GCGATCGTCTCTGCAC-1	Fib
TAACGGTAGGCAGATC-1	CM
TTACCCGTCCTAGAGT-1	Endo
TTCTAACTCGTGATAC-1	Fib
CAGCTGGCAGTTGCAT-1	CM
ACGTTAGGTCAGTGTT-1	CM
GTTGGGCGTCTGTTGA-1	CM
CCATACCAGGCTTTAC-1	Pericyte
CTGCGTTAGGGTTCCC-1	Myeloid
TTCGTTATCCATATCT-1	Fib
GGGACCTAGCACGTAG-1	Fib
GTCACTCTCTAGCTGA-1	CM
ATTACCTTCTGCGTCT-1	Fib
ACTCGGGCATCGTACA-1	CM
CGAGTTACAGCACATT-1	Myeloid
GAAATGACAGTAGTTC-1	CM
TGACTCCTCTGAAAGA-1	Endo
GACTAACGTTGTGACT-1	Fib
TGGAAGGAGACCCTAT-1	Pericyte
TCCATCGCAGGGCTTC-1	CM
CTCAGAAGTTACGGAG-1	Endo
GCGATCGAGACTAGCG-1	Endo
GCGCCAAAGGTACTCT-1	Fib
TTGTTCACAAATGTCC-1	Fib
TAGTCCCAGAGGAACA-1	Endo
GCATTGATCTTCCACG-1	vSMCs
CTTGAAGGTTCTGATG-1	CM
GTCACCTAGCAGAAAG-1	Pericyte
TTGCCCACAGGCAAGT-1	Myeloid
ATTTGTCTCGTATAGC-1	Endo
CCCACATAGGCCTCGT-1	Endo
TCAGTCCGTATGTCCA-1	Endo
CTTGCCACAAGCCTTA-1	Fib
CCTGCTAGTTTGTGAC-1	Endo
TACAGCACACATTCTT-1	Endo
GTCACAACAATTCGTG-1	CM
TAGTCCCAGTGATTAG-1	Endo
AGTGTACTCCTCCAGT-1	Pericyte
GTCCATCGTATTTGCG-1	Pericyte
TTGGTCCAGGCAGTGT-1	Myeloid
TTCGCGTAGGTGATGC-1	Myeloid
ACAATCGGTCTCAAAC-1	Pericyte
CATTCCGCACGCCGAT-1	CM
CCGTGAGAGGTTGTGG-1	Myeloid
GCGAGAAAGCTGAGGT-1	Myeloid
AGTTTGGAGGGAAGCG-1	Neuronal
TCGATTTTCTCTGTTA-1	Myeloid
GCGGTGTCACATTGCA-1	Pericyte
ACCCAAACAGCTGATT-1	Endo
TTATGTCAGTCGCCTG-1	Endo
TTGCTATTCGCAAACT-1	Myeloid
ATCCTGCGTGGACCAA-1	Pericyte
TGGTCAATCTTAAGCG-1	Pericyte
GTTGGGCCAATCACTG-1	Pericyte
TCAGGGCCAAACCGAG-1	Endo
CCTATTACATGCGCTG-1	CM
CTCTAGCCAACTCGTA-1	Fib
TGCTATTGTGCCCAGT-1	CM
ATCGAGTTCCTTTGAT-1	Endo
GCGATCGCACGTTAGT-1	Pericyte
GCCTACTGTCACTCTC-1	Pericyte
TGGCCTTCACTCCCAT-1	Endo
TTGGTCCTCGATCGCG-1	Fib
CCCACATTCCAGGGAA-1	Myeloid
GCATGATCAGTGCGAA-1	Endo
CTACAGAAGAGGAACA-1	Pericyte
AATGGCTCATATTGGC-1	CM
AACTGTGCATTTGGTG-1	Pericyte
TGTAGCAGTCTTAGCA-1	Neuronal
CACGTTCTCAAGAGAT-1	Myeloid
CCTGCTATCCTCCCAA-1	CM
TGATGCATCCACGGCA-1	Pericyte
TCACAGAAGCACACCC-1	Pericyte
TAGGTGTGTCACTCTC-1	CM
GCAGCTGTCGTCGCAG-1	CM
GTCACTCGTTGCAGAG-1	Endo
AACAAAGCAGGTAGCA-1	Pericyte
AATGTCGGTCAGTGCC-1	Pericyte
TTCTGTAAGGTTAACA-1	CM
GATGGCCGTAACGTAA-1	Fib
GATCGTAGTCCACCAG-1	Fib
GTAGACTGTACCCACG-1	vSMCs
ACTAACGCATATTGGC-1	Endo
GGAGAACAGTTAGCGG-1	Pericyte
TTAGGTGGTCATAGAA-1	CM
ACAGCGCGTAGAAGCC-1	Myeloid
TAACGGTCACAGAAGC-1	Endo
GCACGGTTCTGGCGCA-1	Fib
AAACTCGCAGTCCTGG-1	CM
ACCATCCTCCAGTACA-1	Endo
TGGAAGGCAATCACTG-1	Endo
TGAGCCGCAGTGCGTC-1	CM
CGTGGCAAGCCTGTAT-1	Neuronal
GGTGAAGAGAGGCAGG-1	CM
CATTGGACATTCTCGC-1	vSMCs
CTTAATCTCGACCCGA-1	Endo
ATCGAGTGTCAGAAAT-1	CM
GGACACCGTCTCTGCT-1	CM
CCTAAAGGTGCTTGAT-1	Endo
AGTGTACGTATCTAGC-1	Pericyte
GGATGAGGTAATGTGA-1	Fib
TTCTGTAGTAGCTGTT-1	Endo
TGATCAGTCGATCGCG-1	Pericyte
GTAGTACTCTTCCGTG-1	Endo
ACAAACCTCTGGCGCA-1	Myeloid
CTTAATCTCGAGGCTC-1	Lymphoid
GTGTGATCATGTGAGG-1	Fib
CTGCGTTTCGATGTGT-1	CM
AACAAAGCACTGCTTC-1	Fib
CTTAATCGTGTCTCGG-1	CM
CGGACCAAGGTTCGAG-1	Endo
TGCCTGTCATAAAGTG-1	Myeloid
GCTCAGGTCGAGGTAG-1	Endo
TAATTCCAGCATGTGG-1	Endo
GGTGTCGCATCCTCGT-1	Endo
TGAATCGGTAACGGAC-1	Fib
ATCCTGCGTCTGTGTA-1	Fib
GGGACCTTCCAAACCA-1	Myeloid
ATAGTCGAGGCGATTG-1	Myeloid
GTGACATTCCGCGATG-1	Myeloid
GCGTTGGAGTCTCTAG-1	Fib
TGCTCGTGTCGAGAAC-1	Endo
CATAACGGTTTGATCG-1	Pericyte
TGGCAATTCCATCTAT-1	Endo
AGATAGAAGTGATCTC-1	Endo
TTGCCCATCCAGGTCG-1	Pericyte
GAGTGAGTCCGTCAAA-1	Myeloid
CCGCATTAGACTAATG-1	Endo
TACGCCTCAGTAGTTC-1	Fib
GACCCAGGTCTGGGAA-1	Endo
TCTATTGTCAGTAGTC-1	CM
AACGAGGTCGGGACAA-1	CM
TTGCCCATCCGATGCG-1	Pericyte
ACCAAACAGCAGAATT-1	Endo
CTCTCGATCACGGGTC-1	CM
ACAAGCTGTAACCCAT-1	Endo
GATGATCGTAGATGAT-1	Myeloid
TTGCTTAGTGCGTCCA-1	Endo
TATGTTCGTGCCCTAG-1	Myeloid
GAAGTCTTCATTGCCC-1	Endo
TTAGCGAAGTCACACT-1	Myeloid
TTCGTTATCTGACATG-1	Endo
CTTCTAACAGCAACGA-1	Myeloid
CTCCCAATCCAGGTCG-1	Myeloid
ACCATCCGTTGTGACT-1	Myeloid
TTTGCGCCAGCTGATT-1	vSMCs
CCCTGATAGTTGCCGC-1	Fib
AACCTTTAGTGATTAG-1	Myeloid
GTTGGGCTCAGAGTGG-1	Endo
TAGGTCAAGCATGATA-1	CM
GAAAGTAGTTTCCACC-1	Fib
ATTACCTGTAGGTAAT-1	Pericyte
GCATGATGTTGGAGGT-1	CM
GAACTTGCAGTAAGAT-1	Myeloid
CCCTAGTTCGTTGTTT-1	Pericyte
CTAACTTGTTAAGGGC-1	CM
GGACACCCAGAATGCG-1	Neuronal
GGGCCATAGTCGAAAT-1	Pericyte
GAGGCTCAGGAGACTC-1	CM
GTCGTAAGTACGGTTT-1	CM
TCAAGCACAGCACATT-1	Pericyte
TGATTTCCAAGCAATA-1	Pericyte
AAATGCCAGAGTGGAA-1	CM
ACATGGTGTGTACGCC-1	Endo
GCGATCGGTAAGCCTT-1	CM
GAGACTTCACGCCGAT-1	Endo
GGAATCTCATATTGGC-1	Endo
AAGGTTCAGGCCAGTA-1	CM
GATCATGGTAATGCCT-1	Myeloid
TCTCAGCGTCTCTGGG-1	Pericyte
GACCAATCAAGGAAGA-1	Fib
TTGCAGACAATGCATC-1	CM
ACCGAATAGATGGGTC-1	CM
TGCGTAACACGATATC-1	vSMCs
CACAACATCATTCATC-1	Fib
CGTGGCATCGCTATTT-1	Endo
CGCAATACAGTAGTTC-1	Pericyte
AGCCTTCCAAGTCTGT-1	CM
GAGTGAGAGATACCAA-1	Myeloid
TTGCGAAAGGGAGTTC-1	CM
GAGAACGGTTACCACA-1	Endo
CCCTAGTAGCCGCTGT-1	Myeloid
GGGTTATCACAAGGGT-1	CM
AACAGTCGTGAGTCGA-1	Myeloid
CAGTATGCAATTGCCA-1	CM
GTTCAAGGTGTTGGTT-1	CM
CACAACATCTGGCCAG-1	vSMCs
TTATGTCTCCGAATTG-1	Endo
TAGCATGCAGTATCTG-1	Pericyte
AGTTTGGTCGCGTTCT-1	CM
CTCAACCAGGGAAGCG-1	Endo
TTACTTGTCGCTATAG-1	Fib
TGTGTCCTCAGGTCTA-1	Myeloid
CTTGAAGCATCCTCGT-1	Endo
ACTAGGTGTGTCCTTC-1	CM
TCCAGAAAGTAGTGTA-1	CM
TACCCTGCAAGGGAGG-1	Fib
CAGCTGGAGGCCAATG-1	Fib
GCCAGCAGTTGTGACT-1	CM
TAGCATGTCTTGTCGC-1	CM
AGCCTCTCACCCATCT-1	Pericyte
CTGTATTAGCGGACTA-1	Pericyte
GTGCACGCATCGGCTG-1	Myeloid
GGATAGGGTCTGCGCA-1	Pericyte
TTCTAACAGCTGCCAC-1	CM
TACGCCTGTAGTTTGC-1	Neuronal
CCCGTTATCTCGGCGA-1	Fib
TCAGTCCGTTTCCGGG-1	CM
ACTCGGGCACATAAAG-1	Pericyte
ACCCAAAAGGTACTCT-1	Myeloid
AGGCCCAGTGGTAGAC-1	Endo
CACCTTGAGTGCTGAG-1	Fib
CAGGATTTCTTCGTTA-1	Pericyte
GAAACAAAGTTCAAGA-1	Fib
AACTGTGTCTCGACCT-1	Myeloid
TGGCAATAGGTGTTGG-1	Lymphoid
TATCGAGTCGATAGCT-1	Endo
GATCATGCACGCTAAT-1	Endo
TACGCAATCCCATAGA-1	Endo
TACCTATGTTACACTG-1	Fib
TATGTTCGTTCCCTTG-1	CM
GCGGAAAAGCAGAAAG-1	Pericyte
TTACGGAAGTGAGCAC-1	Lymphoid
AGTCAACGTTCTTTCA-1	Endo
GACCCAGTCGATAGCT-1	CM
CTCATGCGTTAACCAC-1	Endo
GGACACCGTAGCATGG-1	Myeloid
TTGTTGTAGGTTACAA-1	Endo
GGGCCATCATCATAGC-1	Endo
CGGTGCAGTCACCGCA-1	Pericyte
TGTGACACAATCCATG-1	Endo
ACATGGTTCCCGTATC-1	CM
CGCAGGTCACTTACAG-1	Myeloid
CTTGTCGTCCGTCAAA-1	CM
ACTGCAACATCGGCTG-1	Myeloid
TTACCGCTCACTAGGT-1	Fib
TCCCACACACAGCTTA-1	Myeloid
ACTTTCATCAGCGGTC-1	CM
CCTGCTACATGGCCTG-1	Myeloid
CCCACATTCCGTCAAA-1	Endo
GCACGCATCTCGACCT-1	Endo
GACCGACCAAGACACG-1	Pericyte
GGCACGTAGTTGAATG-1	Endo
TACATGGGTACGACCC-1	Pericyte
CAAAGCTTCTCGACCT-1	CM
GCGAGAACATGTCCCT-1	Pericyte
GCTCAGGCATATACGC-1	CM
TGAGTCATCAATCGTG-1	Endo
GTTGGTACATGGTATC-1	Endo
TTTGCGCGTCCGTCGA-1	Myeloid
TAAGCCATCTATCTAC-1	Endo
TGTGTCCGTGCATTCA-1	Neuronal
TTGGTCCGTAGTACAA-1	CM
GGCGAAATCAAGGCCC-1	Pericyte
TGCTATTCAATTGCCA-1	Endo
GGGTTATAGTCAGCCC-1	Lymphoid
CCTAAAGGTGCACTTA-1	Endo
GAGATTCCAAGTCTCA-1	Pericyte
ACCTGCTCAACCTCCT-1	CM
GGATAGGTCTTAACGG-1	Fib
CGTGGCAGTATCTGCA-1	vSMCs
GGCACGTAGGCCAATG-1	Myeloid
GTGCTGGCATAGGCGA-1	Myeloid
GTGGATTCACGAACGA-1	Myeloid
GAACTTGCATAGCAGG-1	CM
TTACTTGGTCAATACC-1	Endo
ACAGGCCCACATTCTT-1	Fib
GCAAAGGCAATAGTGA-1	Fib
TAGACTGTCTCTTCTC-1	Endo
AACAGTCAGTTCAACC-1	Myeloid
ACCGGGTAGTACAGTA-1	CM
TTGCGAACATCTGCAA-1	Fib
CACTGAAAGCAACGGT-1	Myeloid
TCGTTCGCAAACCTAC-1	Pericyte
CACCACTCAGACCTGC-1	CM
GAGACTTAGGTGTCGA-1	Neuronal
GCGCATGGTGCGTGTC-1	Fib
TACAGCATCTGTCGTC-1	CM
TTGCGGGTCTTGCGCT-1	Fib
GCATTCCTCGTTCAGA-1	CM
TTCTAACGTCTGGTTA-1	CM
GGCACGTTCGATGAAA-1	CM
CCTTAATCAATCATCG-1	Endo
AGCTGTAGTGAATACA-1	Fib
CTAACTTGTCTAACCA-1	Endo
TTGAGCACAAACAGTA-1	Endo
TGGGTTAGTCGACTGC-1	Myeloid
AAACTCGTCAGGCCGT-1	CM
GAAGTGGCAAGAGATT-1	Myeloid
CAGTGCGGTACGTAGG-1	Endo
CACAGATAGTCTTAGC-1	Endo
CACAGATCAACGACAG-1	Endo
GCGAGTCCAAGCGTCC-1	Endo
GAAATGAAGAGAGGTA-1	CM
TATCGAGTCTGTAGAC-1	Myeloid
ACTACGATCCGTGCAG-1	CM
CTCTACGCAATGCATC-1	Fib
AACGGGAGTCAGACGA-1	Pericyte
GCTTTCGCACTGAAGG-1	Myeloid
TAATCGGGTCGCTAGC-1	CM
TTCGATTCAAGCGTCC-1	CM
GCGAGAAGTATTCACG-1	Fib
TGACTCCGTTCCGCGA-1	CM
GCTCAGGGTCCTTATT-1	CM
TGGTCAAAGGCAATTA-1	CM
CTTGTCGGTGGAAGCT-1	Neuronal
ATCCCTGGTCAGGTGA-1	Fib
CTTGAAGTCCAGTACA-1	Myeloid
GTCCATCGTCCACCAG-1	Myeloid
TTAACGGGTAAAGGCC-1	Myeloid
AGCTGGCCAATTCGTG-1	CM
ACAGACTGTGTGAGGT-1	Endo
AAATGCCGTTACGGAG-1	CM
TAGCTTTAGAAGCCTG-1	CM
GAGGTCCTCCCAATGA-1	Endo
GTCGTAAGTCGATTAC-1	Endo
TCAAGACGTATGCTAC-1	Fib
GCGAGTCCATGACTGT-1	Myeloid
CAACGGCGTTACTTTC-1	Pericyte
CTTGCCACATAGCAGG-1	Endo
ACAAACCGTAGGGTTG-1	CM
GAACTTGAGTTACCAC-1	Fib
GACCGACGTGCCCGAT-1	CM
ACCGCAGTCTCTCAAT-1	CM
TAGCATGTCGCATAAC-1	Endo
GAGCATTAGTCCGTGC-1	Myeloid
TTACGGAAGGACTTTC-1	Pericyte
TCCCACATCGTGAACT-1	Fib
ATGCATGAGCAACTGG-1	Fib
CATGTTTAGTCCCGCA-1	Endo
TGATCAGAGGAGTACC-1	Lymphoid
TCAGCTCCAAGTCTGT-1	CM
TGCCTCACACAAGGGT-1	Myeloid
CATAACGAGAATCAGT-1	CM
GCGATTATCAGAATGA-1	Endo
AAATGAGAGTTAGCGG-1	Neuronal
GGTTGCGAGAAGCCTG-1	Endo
CAGCTAAGTTGGGAAC-1	Endo
GTGGCGTAGCTGAATA-1	Endo
ATCCCTGTCCGTGCGA-1	CM
CCACGTTCAGGGCTTC-1	Fib
GCACCTTCATAGACGG-1	Endo
CAGTGCGTCCCGATTC-1	vSMCs
CGTTCCACAGATTAAG-1	Endo
ACGTTAGCAACAACTC-1	Fib
ATAGTCGTCGCACCGA-1	Lymphoid
TTGCCCACAATTCGTG-1	Endo
GGTGAAGTCAGTCACA-1	CM
AACCAACAGAGGAATG-1	CM
TTTACGTGTTGCAGCC-1	Endo
AATACGCAGTACGACG-1	Myeloid
TAAGTGCTCGTTGTTT-1	CM
TTGCTATCACTGGGCT-1	CM
ACGGATTAGTCAACTC-1	Endo
TAATTCCGTCCGGTAC-1	CM
TTTGGTTCACTTACAG-1	CM
AGGCCCACAAAGGTCG-1	CM
CCTTGGTGTTGGCGAA-1	Fib
GTCACCTAGAAGCCTG-1	Fib
TACATGGCACAAGGGT-1	Endo
TCAGTTTAGATATGAC-1	Fib
CCCTAACCATCGGCTG-1	CM
GCATTGAGTTCCAATG-1	CM
GCAAAGGCAAGTTGCT-1	Fib
AACAAAGAGGCACCTC-1	Fib
CCTGGGAGTTATAGAG-1	Endo
GTCACTCGTGGACCAA-1	CM
TTACCCGTCGCGCTGA-1	Endo
GTAGGAGCACCTTGTC-1	CM
GGATGAGCAGACCTGC-1	CM
TGAGCCGGTCAGTGTT-1	CM
TACTCGCCATGGTATC-1	vSMCs
GCAGATTAGTCGTATC-1	Endo
TACATTCGTCCCGAGT-1	Myeloid
GTCACAATCAGGCCGT-1	Endo
CTTGAAGGTTGGGAAC-1	CM
TCACCACAGCGTATCT-1	Endo
TGGGTTACAGCACATT-1	Lymphoid
CACCTGTGTGACAAGC-1	CM
TAGCCCTCACACGGTC-1	CM
AACCGATGTGTGTGTT-1	Endo
TTTGGCCGTAAACGGC-1	CM
AGTGTACAGGTAGGCT-1	Fib
GAGCATTGTCAATCCA-1	Endo
TACGGATTCGAACCGC-1	Endo
GCAAAGGAGCTGCCAC-1	Endo
TCGGGACAGTCGACCC-1	Endo
CCTCCCTCATCTCTCG-1	CM
GGCGTTGAGTACGCGA-1	CM
TAGCATGTCGAGGCTC-1	Endo
GAGACTTAGATCGATA-1	Fib
AGCCTTCCAGGTGTGA-1	Myeloid
AACCGATCATGTATCG-1	CM
TCACCTGCAATCACTG-1	Endo
TATTGCTAGGCCTAAG-1	Endo
CGCGCAATCTATATCC-1	CM
ACTGCGGAGGCTCCTG-1	Endo
TTGCAGAGTATACGCT-1	vSMCs
CCAGAATCATTAGCAC-1	CM
GCGTAGCTCGGTGATT-1	Endo
TGGGTTACAAAGGAAG-1	Endo
GGAGGATAGGACCGAT-1	Myeloid
TTTGCGCTCGATCTTT-1	Fib
GGTACCGCAGCCACGT-1	Fib
TAAGTGCAGCCCATGC-1	CM
ATTACTCCATTTGGCA-1	Endo
TCCGACTCACTGGGCT-1	CM
AGGCCTGGTACCGGCT-1	Pericyte
TCCATCGTCAAGAGAT-1	Fib
GAACGTTCACTCAGCG-1	CM
CGAGTTACATCGACGC-1	CM
CTTGCTGTCGTGGAAG-1	Endo
GCTTGCTAGTTGCGCC-1	Endo
ACCGCAGTCCGCGATG-1	Myeloid
CTAGGGCCATGTATCG-1	CM
TCAGTTTGTGAATGTA-1	Pericyte
GTTATTCCACAGTAGG-1	CM
GTGACATAGACACAAT-1	Myeloid
CTGTTCGCACAGCTTA-1	Endo
AACTGGTCAAACCTAC-1	CM
GGTGTCGAGTCTGCTA-1	Fib
CATGCCTTCGATGTAC-1	Endo
AGGCCTGCAAACCCTA-1	Fib
GAAGTCTTCTGTAGAC-1	CM
TCAAGGTGTCAAATCC-1	Endo
CCGCATTAGCCATTCA-1	Fib
ACAGGCCCAATCACTG-1	Fib
CAATCCCAGAAGCCTG-1	Fib
ACGTTAGGTCTAACCA-1	CM
ACAGAAATCTTGTCAT-1	Lymphoid
GTAGACTGTTCGGGAA-1	CM
GTTGGGCTCCCAGCGA-1	Endo
TCAGTTTCAAGCGGTA-1	Fib
TGACAACGTACTATGC-1	Fib
GTGTCCTCACAGTTAC-1	CM
TTGTCTACACATCATG-1	CM
TCAAGCAGTGAGAGTC-1	CM
GTTACTTAGCAAGGTC-1	CM
CCCTCTCCAGAGATGC-1	Endo
GTTATTCAGTTGCGCC-1	Myeloid
GCGCCAAAGGCAGATC-1	Myeloid
ACGTTAGGTTTAAGCC-1	Endo
TGCATTTTCCGGCGAT-1	Myeloid
TAACTTCCACATAAAG-1	CM
ACGGATTTCTTCAGAG-1	CM
GGTAGGAGTAGACACG-1	Fib
GTGGATTAGCGGACAT-1	Endo
ACTACGAGTGGCGCTT-1	CM
TGTTAGGAGGAGTCTG-1	CM
GATCATGGTCATTGGT-1	CM
GCGTTGGGTTGGGAAC-1	CM
TACGCAAAGGATTGCG-1	Fib
AGGCCCAGTAGTCCAT-1	CM
CTTGTCGGTCCGTGCA-1	Myeloid
TTCATTGCAAACCCTA-1	CM
ACCCAAATCTTGTCAT-1	CM
GCGTTGGCAAGCAACG-1	CM
CACAACACAGGTCCTG-1	Fib
GCTGCGAGTGTACGCC-1	Myeloid
AACAGTCGTGTGCGTC-1	CM
TTGTCTATCTGGCACG-1	CM
AGATAGAAGTCACGCC-1	CM
GCTCCTAAGTGCCCTG-1	CM
CTCGCTAGTAGTTTGC-1	Myeloid
GGTGTCGGTGTCGTGC-1	Fib
GATGGCCTCGTGGGTC-1	CM
TTTGCGCAGAGACTCG-1	Myeloid
CTGGCAGTCAAACCAC-1	Endo
AACGGGACAATGGTAA-1	CM
GCTCCTACAGCCACGT-1	Fib
CCGTGAGTCATACTTC-1	CM
TTCTAACAGTAGACCG-1	Endo
AAAGGGCGTAAACGGC-1	CM
GAGCATTGTTATGCAC-1	CM
ACAAACCCAACGTAGG-1	Fib
GAACGTTTCATCGCCT-1	CM
CACAGATAGTGCTAGG-1	CM
CGCAGGTCAAACTACC-1	CM
CCTTGGTCAATGACTC-1	CM
ATCCCTGGTTCTTATC-1	Endo
TGGCCTTGTAAGGTCG-1	Fib
TAAGCCATCGCGTTCT-1	CM
CTCGCTATCTCGCGGA-1	Endo
CTAACTTCAAGGAGTC-1	CM
ACCGCAGTCGATAGTC-1	CM
ACCTGCTAGGGTCTGA-1	CM
ACTGCAAAGTCAGGAC-1	Fib
AATACGCAGAGGTGGG-1	CM
TAGCCGGTCGAGTTAC-1	Endo
GCCTACTAGGCAGATC-1	vSMCs
CCTTAATGTAGATGAT-1	CM
AGTCCGGGTTTAGAAG-1	CM
AACCTGAAGATCGATA-1	Fib
TGTAAGCCATAGAATG-1	CM
CAATCCCGTCAATACC-1	CM
TCACTCGGTAACGGCA-1	CM
AACGGGACACAGAAGC-1	CM
GGGTGTCAGGCCTCTG-1	CM
GCTGCGACATTCTTTG-1	Myeloid
CATGCCTTCCGGGCAT-1	Lymphoid
AATACGCAGGGCTTCC-1	CM
TTGACGATCGTGGGTC-1	CM
GGTAGGATCGGATAAA-1	Endo
TAACGGTCAATTCGTG-1	CM
GAAATGAGTAAACGGC-1	Fib
CAACGGCTCGTGGAAG-1	Myeloid
CAGTGCGGTTAACCGT-1	Endo
GCTGTTCGTAGAATAC-1	Pericyte
GCCAGCATCCATTGAG-1	Pericyte
TTAGCTTCAGGTAGCA-1	CM
CGTTCCAAGTCACGCC-1	Endo
GATCATGGTGAGGTCA-1	Myeloid
AACGGGACAGAACAGC-1	Endo
CTTGCCAGTTAAGGGC-1	CM
CACTAAGAGATATGTG-1	Endo
GTGACATCAAGCGGTA-1	Fib
AGTCCGGGTTGGAGGT-1	CM
TAACTTCCACGATATC-1	Myeloid
GCGATTACAAAGGCCA-1	Endo
TAGTCCCCAGTAACTC-1	Neuronal
TCGCCTACAAACCGAG-1	Fib
ATATTCCGTTAGCTCA-1	Endo
TAACGGTAGTACAGTA-1	Myeloid
TAAACCGCAGTAGTTC-1	Fib
AAACGAACACAAACGG-1	Endo
GAGACTTAGCGAGCTA-1	CM
GTGGCGTGTCCCGTGA-1	CM
TGAGCCGGTAGACACG-1	CM
AGGCGAACAGCGCGTT-1	Endo
CCGTAGGGTTCTGAGT-1	CM
TAATCGGGTATTTGCG-1	CM
AAATGCCGTCAATACC-1	CM
TACCTCGCAAGGGAGG-1	CM
GGCGAAAAGTGTCGGA-1	Fib
AGTCCGGGTCGAGGAT-1	CM
ACTACGACAAGCGTCC-1	CM
TCAGGGCGTAGCGTTT-1	Fib
GAAGAGCGTTACTACG-1	Fib
TACATGGGTCGATAGG-1	Pericyte
CTGTTCGCAAGCGTCC-1	CM
AGTGCCGTCTTCTTCC-1	Fib
CAACGGCGTTAAGGGC-1	CM
GCTCCTATCGATGTAC-1	CM
GCAGCCATCGCACCGA-1	Endo
TTTGGTTTCGGTCTCT-1	Endo
GGATAGGGTGGCATAG-1	CM
TGCTATTCAGCGTAGA-1	Myeloid
GCTGCGAGTTTCTACT-1	CM
AGGCCTGCATCGGCCA-1	Fib
CCCTAACTCGCATAAC-1	CM
ATTACTCAGACCAATA-1	Myeloid
AACGGGAGTGAGGTCA-1	Pericyte
ACTCGGGTCTAGCTGA-1	CM
CGGACCACAAGCGAAC-1	CM
CCAGATAGTTCCTGTC-1	CM
GCTCCTATCTATACCT-1	CM
TGCTATTAGGCTAAAT-1	CM
ATCCAGAAGTTCCCGG-1	Myeloid
GACCGACGTTTCCGGG-1	Fib
CTAACTTAGTGGACGT-1	CM
AGTCCGGCAGCAGGTA-1	Fib
ACAGAAAGTTACTACG-1	Fib
TTACTTGCACGGTGTC-1	CM
GACTAACCAAGCAACG-1	Myeloid
GGCACGTGTACGACCC-1	CM
CCGTAGGCAAGCGGTA-1	Fib
TCAATTCGTACGCCCA-1	CM
TTTACGTTCTCTTCCT-1	Myeloid
GCTCCTATCGACTCGG-1	CM
CTGGCAGTCCACACCT-1	Endo
GTCTACCGTCTCTAAG-1	Pericyte
AGGCCTGCAGTTCGGC-1	Fib
TAACTTCGTTGGCTTA-1	Myeloid
CTCGCTATCTCATATC-1	CM
CACGTTCCAACACGGA-1	Myeloid
AGATAGATCGCCAGAC-1	CM
CTGCTCACATTCCCGT-1	CM
GTGGATTTCGACGGAA-1	CM
AACCTGAAGCGAGCTA-1	Myeloid
ACGGATTTCCGGCGAT-1	Lymphoid
TCCGACTAGGCAGTGT-1	Fib
GCCAGACCAGGTAGGT-1	Myeloid
GGCGTTGAGGGCTCTC-1	Myeloid
GGCATTACATTACACG-1	CM
AAATGCCGTCCGTAGC-1	CM
AATGGCTCACCTACCT-1	Fib
AGCGATTGTCTGTTGA-1	CM
CCTTAATAGAGTTCGG-1	Myeloid
TGGTCAAAGTTAGCGG-1	Myeloid
TGATCAGTCCTGGGAC-1	CM
GAGGCTCCACTCCTCA-1	Neuronal
TGTAGCACACTCGGAC-1	CM
AACAGTCAGTGCAACG-1	Myeloid
CGGTGCACATAGACGG-1	Fib
AACGGGACAAGTCTCA-1	CM
TCAATTCGTGTCTCGG-1	CM
ATCCAGACATAGCCGC-1	CM
CAGTATGTCCCACTTG-1	Fib
ATCCCTGGTGTCCAGC-1	Endo
AGGCCTGCAGAACAGC-1	Fib
TTGTCTAAGGATTAAC-1	Myeloid
CCGCATTGTTACGCTA-1	Myeloid
AATGGAACATAGGCGA-1	CM
GAGATTCAGCATTCCA-1	CM
CTAACTTTCCCGTAGG-1	CM
ATCCCTGTCTATCTTG-1	CM
GCGGGTTTCGGTCTAA-1	Endo
GCATGATAGAGGCAGG-1	CM
GGTAGGAGTGGCCTTG-1	Myeloid
GCGTTGGTCTGCCGAG-1	Pericyte
TCCGACTCACCTGGTG-1	CM
TAATCGGAGGCACTAG-1	Endo
AGGCCTGCAAGCGGTA-1	Fib
GCCAGACGTATCACAC-1	Fib
GATCATGTCGACGGAA-1	CM
GAATCTGAGATAGGTT-1	Myeloid
TACGGATCAGCCACGT-1	Fib
GAAGTCTAGACACTTC-1	Endo
CTCATGCCAGGACTGA-1	Fib
TGATGCAGTTATCGAC-1	Myeloid
GTCCATCGTATGCTAC-1	Fib
CCGTGAGTCCTGGAAT-1	CM
TTAGCTTCAGCGCGTT-1	Fib
TGCATTTCATTTGGTG-1	Myeloid
TGTAAGCCACTGAAGG-1	Myeloid
TGCATTTCATCGCTAA-1	CM
CTCATGCCATACCCGG-1	CM
TTACTTGAGAGGTGGG-1	Endo
TTCATCATCACTCGGG-1	CM
AACTGGTCAACTTGGT-1	CM
GCGAGAAAGGATGTAT-1	Myeloid
GGCACGTGTCGATAGG-1	CM
CTTGCTGCAGCAGGTA-1	Myeloid
GATTGACGTACTAGAA-1	Endo
AAATGCCGTGTTGGTT-1	CM
GGTGAAGTCGAGGTCC-1	Myeloid
GATCATGGTTACACTG-1	Fib
TATGTTCAGCTCGGCT-1	CM
AGATTCGCAGCGCGTT-1	Pericyte
AGTCCGGCAAAGCATA-1	Endo
TAACGGTTCGAGTGTT-1	CM
TTCATCACATGGGACA-1	Lymphoid
GTGCTGGAGGCCTCTG-1	Lymphoid
TTGACGAAGGGTAGTC-1	Fib
GTAATCGAGTCTAGAA-1	Lymphoid
TTGCTATTCTGGCGCA-1	Endo
GCTCCTATCACACGTA-1	CM
AGTCCGGCATGATCGT-1	CM
AGGCCCAGTCTGAGCC-1	Endo
CAATCCCCACTCCCAT-1	Myeloid
GTCCATCTCGAGTGTT-1	CM
TGTTAGGTCGTGGAAG-1	CM
TAAGCCATCCTGGAAT-1	CM
GAACGTTAGGTGATGC-1	Fib
GTGGATTCACAGTAGG-1	CM
AAATGCCCATCGTGAT-1	Myeloid
ATGTCGAAGGTAGGAA-1	CM
CTGAATGCAAGAGATT-1	Myeloid
CTCTCGACACAGCCAC-1	CM
AAAGGGCCAAGAGCGT-1	Pericyte
TGTTAGGTCGCGTGAC-1	CM
CACGTTCGTGGCATAG-1	Neuronal
AGTGTACAGACGAAAG-1	CM
TATCTGTAGCGCAATG-1	CM
TGGGTTATCACCGCGA-1	Myeloid
GCATTGAAGGCACTAG-1	Endo
AAATGCCCATACCCGG-1	CM
ACTAACGCAAGATTAG-1	CM
TGGAAGGAGAGGTGGG-1	Pericyte
ACGGATTTCTAGCTGA-1	CM
TAGCTTTGTTATCGAC-1	Myeloid
CACAACACAACTGCGC-1	Myeloid
AAATGCCGTCTGGGAA-1	CM
