Barcode	cell_type
CAAGAAAGTCCAGACC-1	Fib
GCTCAGGTCGACCCGA-1	Pericyte
GGCATTAAGAGCCACA-1	Endo
CCGTAGGTCTCATATC-1	Fib
GCTTAAGTCGCGGCAT-1	Fib
GCGTAGCCATATACGC-1	Fib
GAGTGAGGTGTGAGGT-1	Fib
TAGCGGCTCAGAGTGG-1	CM
GTGGCGTTCTTCGTTA-1	Fib
TTACCCGTCTCCTTGG-1	Fib
CTGGGACTCCACCTAC-1	Fib
GAATCTGTCAGGATCT-1	Fib
TGGGTGCAGCGCACAA-1	Myeloid
GCTTTCGGTCTCAAAC-1	Endo
TGGCGCACATTGCGAT-1	Fib
TACTGCCCACAGCCAC-1	Fib
GGAACCCCAAACTACC-1	CM
GCTCGAGTCCAGGTCG-1	Fib
ACTTCCGAGAGCTACG-1	Fib
GGTAGGATCCAGTTAG-1	Fib
GAGCATTGTACGGTTT-1	Fib
GGTGCTGGTATTGTCG-1	Fib
GGTAGGAGTCGACTGC-1	Fib
AAAGGATGTTTCCGGG-1	CM
ACAAGCTGTGTTGGTT-1	Myeloid
AGCTGGCCATTACACG-1	Fib
CCGTGAGGTGGATTCT-1	Fib
GCCTACTTCTCGCGTT-1	Fib
TGTACGACAAGAAACT-1	Fib
AAAGGATTCAAGAGAT-1	Fib
TTCGTTATCATGTTCT-1	Fib
GCGATCGCAAGTGGCA-1	Fib
AATGGCTAGCGTCTGC-1	Fib
ACTACCCGTATTCTCT-1	Fib
AAAGATGAGACAGCTG-1	Fib
CAACCAATCCTCCAGT-1	Fib
CACATGATCTCGCGGA-1	Myeloid
GGCGTTGCAGAGAGAA-1	Fib
GAGATTCTCTCTGTTA-1	Fib
TCCAGAAGTAGGTCTT-1	Fib
AGGCGTCTCCGCGATG-1	Endo
CAATCCCGTGTGCTTA-1	Myeloid
ACAGAAATCCACTAGA-1	CM
TTGCCCACAAAGGTCG-1	Fib
GTCACGGGTCTCGGGT-1	CM
TTCAACTCACTGCTCT-1	Fib
AGTCAACGTTTGTACG-1	Fib
TTCGCGTCAATACTGC-1	Pericyte
TCAATTCAGCAGAGCT-1	Myeloid
GAGGATGGTTTCTTAC-1	Fib
GCGGTGTGTTGTGACT-1	Endo
ACAGACTCAATGGCAG-1	Myeloid
GGTCATACATGATCGT-1	Fib
CCATACCAGCGAGCTA-1	Fib
TGCTCGTTCGTGTGCG-1	CM
GTCCATCAGTCACGCC-1	Fib
TTCGTTAGTAGAATAC-1	Fib
GCCATAAGTGCGCTCA-1	Fib
GTGGATTAGAGGTCCA-1	Myeloid
AGTCAACGTTTCTTAC-1	Fib
CCGTACTTCCCACTTG-1	Fib
CACTAAGAGCAGGAGG-1	Fib
GGGTGTCTCTCATATC-1	Fib
ACCTGCTGTAGCATGG-1	CM
CGTAAACTCAGAACGG-1	Fib
TTCTAACCAAGCGACA-1	Myeloid
AGTCCGGTCGTCTTAT-1	Fib
CGCTGGAGTAGTCTGT-1	Fib
CCCTAGTCACTAGGAG-1	Fib
GCTGAGCGTCTGCACG-1	Fib
TATTGCTGTACGTAGG-1	Fib
GGCACGTTCGGAAAGC-1	Fib
ATTCGTTCACGGCCAT-1	Fib
TCTATTGTCTTCAGAG-1	Fib
CGAGTTAGTGCAAGAC-1	Endo
TGCTATTAGATCACCT-1	Fib
AGCTGTAAGTCCAGAG-1	Fib
CACGTTCAGATGTTCC-1	Fib
ACAAGCTCAGGCATCC-1	Fib
TTGTTGTAGATCCGAG-1	Fib
TAACGGTTCTTAACGG-1	Fib
AATGCCAAGGAGTACC-1	Fib
GAAACAAAGGTTCGTT-1	Fib
GAAGAGCAGCTATCCA-1	Fib
GATGGCCAGACTTCCA-1	Fib
TGGGTTACAGTTGGAG-1	Fib
GCTGCGATCTGGAAGG-1	Fib
CTTGCTGGTATTCTCT-1	Myeloid
TGGTCCTAGTTGACAA-1	CM
TGATTTCCACTGTCAA-1	Myeloid
TGATGCATCGAGCGCT-1	Fib
TTTGTGTAGGGTATCG-1	vSMCs
TTCAACTTCGCTCGGA-1	Fib
TTGCAGAAGCTCCATA-1	Pericyte
CCTTAATCATTGTTCT-1	Fib
TAGACTGGTAGTTTGC-1	Endo
GGCGAAAGTAGGTGAC-1	Fib
TCACCTGTCTGTGTGA-1	Fib
AGGCCTGCACGCTGTG-1	Pericyte
TCAAGGTAGCTGAATA-1	Pericyte
TAACAGCAGAACCCGA-1	Fib
CACATGAGTTACACTG-1	Fib
ATTTGTCAGGATCCTT-1	Fib
CTCTCAGAGGCGATTG-1	Fib
TAGTCCCAGAACCATA-1	Fib
TTTGGCCCATGTGGGA-1	Fib
TGTGACATCTCTCAAT-1	Fib
TACCTCGTCTCTATCA-1	Fib
AACTTGGAGCCCATGC-1	Pericyte
GAGACTTCAGAGATGC-1	Fib
CAGTGTAAGTCATACC-1	Fib
TGGCAATGTGCGTTTA-1	Fib
ATGCATGAGGTCTTGT-1	Fib
TGGGTTAGTTACTACG-1	Endo
GTCACCTAGCGCACAA-1	CM
GCCATAAGTTCCGCGA-1	Pericyte
AGCGATTTCCGGAAAG-1	Fib
GTTACTTAGACCCTAT-1	Fib
TTGCCCAAGAAGAGTG-1	Myeloid
TGATGCACAAGCGGTA-1	Myeloid
ACTTCCGCAATGGTAA-1	Myeloid
AACCGATTCGGGCTCA-1	Endo
TTAGCGACACAGAAGC-1	Fib
TTTACGTGTGTCTACA-1	Fib
AGCCAGCTCCACGGCA-1	Fib
GCGAGTCGTCAGAGTG-1	Myeloid
AGCCTGGAGTTGTCCA-1	Fib
CATAACGGTCCGTAGC-1	Fib
AATGTCGCAGACCTGC-1	CM
CTCTCGACACATAAAG-1	Endo
GTGCACGGTATTCTTC-1	Fib
GGAACCCTCACTGGTA-1	Fib
GTCACAAGTTTCTCTA-1	Fib
GAAGTCTCACGCGACT-1	Fib
CAGGATTGTGATTCCA-1	CM
GCGTTGGTCGCTAGTA-1	Fib
AGCCCGACAGCAACGA-1	Fib
GGTGCTGAGATATGTG-1	Fib
GTGTGATGTGTAGGAC-1	Endo
GTTCAAGAGCTACGTT-1	Fib
TGGCAATCACTCAAGT-1	Fib
CACCACTAGTGAATAC-1	Fib
CTGCGTTCAGTAAGCG-1	Fib
CTCTACGAGGAGACTC-1	CM
TAATCGGTCCAATCCC-1	Fib
AGCCTTCCACGTGAAG-1	CM
GCCAGACAGGTTCTCA-1	CM
GGCACGTCAATGGCAG-1	Fib
TGTGGCGCACTGATAC-1	Endo
CCACAGGGTTTGCATG-1	Fib
GGGTGTCAGGCAATTA-1	Fib
TTCGCGTCACTGTAAC-1	Pericyte
ATTTGTCCAGACCTGC-1	Fib
AAATGCCGTTGCTTGA-1	Endo
CCTATTATCTTCACTA-1	Fib
GTGTCCTAGGTCTTGT-1	Endo
TCACCACCAAGTTGCT-1	Endo
CAGTATGGTGTGTGCC-1	Pericyte
GCCTACTCATCACAGT-1	Endo
GTGTCCTCAGCGCGTT-1	Fib
TTTGAGGTCGTTGTAG-1	Fib
TATCTGTCATTGTGAC-1	Fib
TTACCGCTCAAGGCAG-1	CM
CGCAGGTTCGCTATAG-1	Myeloid
TAGCCGGAGTGTAATG-1	Pericyte
GGACACCGTGCTGTGC-1	Pericyte
TACAGCAGTTCCGCGA-1	Endo
TTTACGTAGCTGCTCG-1	Fib
CGTACAAAGTCATCTG-1	Fib
CAAGAAAGTGTCGTGC-1	Fib
TTACGGACACCATTCC-1	Fib
TAGGTGTAGGATATCA-1	Endo
CAGCTGGCAACAACTC-1	Fib
GAAGAGCCATAGCCAT-1	Endo
GAGCGCTAGTGTGTAA-1	Myeloid
AGCGTGCGTAGAGAGA-1	Fib
CGTAAACAGTGGGACT-1	Fib
TACCTATCATAGCAGG-1	Fib
ATCCCTGAGTATACCC-1	Fib
ACTTCCGGTGAAACAT-1	Fib
TTGAGTGTCCAAACCA-1	Fib
GCACGCAAGGGCATTG-1	Myeloid
CTACAGATCCCGAAGC-1	Endo
TAATCGGTCCCGATTC-1	Fib
TGTTAGGCAGTCCTGG-1	Myeloid
GTTGGGCTCAGCACTA-1	Endo
TTACTTGCATAAAGTG-1	Fib
GAACTTGGTAAAGGCC-1	Endo
TCCATCGAGGGTCTGA-1	Myeloid
AACGAGGAGAGCTACG-1	Myeloid
GTTATGGTCGGTTCCT-1	Fib
ACTGTCCGTAGCGGTA-1	Myeloid
TGAATCGGTGTTTCTT-1	Fib
AAGATAGAGCTCGTTA-1	Endo
AGCGTATGTACCCACG-1	Fib
TTTGGCCCATGCCCTT-1	Myeloid
GCTGCGATCGCAGATT-1	Fib
GGTCATACATTGTGAC-1	Fib
CCAGAATGTTCCTATT-1	Myeloid
AACAGTCTCGTCTTAT-1	Endo
AAACTCGAGACGCCAA-1	Fib
CCCTAACCATTCCCGT-1	Pericyte
TTTGGCCAGTTACCAC-1	Fib
GTGGATTGTCTGTTGA-1	Endo
TCACCACTCACCCTTG-1	Myeloid
GACCCAGAGAAACGCC-1	Fib
CTGGCAGTCTTCATAC-1	Lymphoid
GAACCTAGTTAACTCG-1	Lymphoid
TCCATCGCATGCGACC-1	CM
TAGCCGGAGACCCTAT-1	Lymphoid
TGGAAGGCAAGGAACC-1	Myeloid
GCGAGAAGTTGGTAAA-1	vSMCs
TTGCCCAAGGATGCCA-1	Endo
ACTAACGAGATGTTGA-1	Endo
GCGCATGGTCTGTGTA-1	Myeloid
TGGCCTTCAACAAACA-1	Endo
CAAAGCTTCGCAAGCC-1	Myeloid
ATGGATCTCCCGATTC-1	Myeloid
ATAGTCGCAAAGAAGG-1	Myeloid
TAACTTCCATGTGAGG-1	Myeloid
GCGCCAAAGATATGTG-1	Myeloid
CTTCTAATCCAGGCCA-1	Fib
AGTTACGTCCTTACGC-1	Fib
ACTGCAACATCCGTAA-1	Pericyte
CTTCTAAGTGTTTCTT-1	Myeloid
GTGTCCTCAATCAGGG-1	vSMCs
AGCCTGGTCCCTACGT-1	Myeloid
TGAGCCGCAGGCTACC-1	Fib
TGAGCCGAGAAGGGCG-1	Lymphoid
TCTCTGGTCCGATTGA-1	Myeloid
AGGCCTGTCGTTTGAG-1	Fib
CTCTAGCCAGGGAGTT-1	Myeloid
TACAGCAGTTCTGAAC-1	Pericyte
CGATGATAGAGACTCG-1	Endo
GAACGTTGTTTCACCC-1	Myeloid
TACTCGCTCTTAGTGG-1	Fib
GCGATCGAGCTGCTCG-1	Endo
TACGCCTCAGGGTAAC-1	Myeloid
CTTGCCAGTTCTACGA-1	Endo
TAGCTTTCAATTGGCT-1	Fib
TACTAGGGTTGGTAAA-1	Pericyte
TCAGGGCTCTCTATTG-1	Fib
ACAGGCCTCGACTGGC-1	Endo
GCTTAAGAGAACGCCA-1	Myeloid
AATGTCGCACTCGGAC-1	CM
GCTCACTAGGTAGGCT-1	Lymphoid
TTAGGTGTCGAGTGTT-1	Fib
TTGACGAAGGCGTAGT-1	CM
CTCATGCTCTCGCGGA-1	Fib
TGCCTCATCGATAGGG-1	Endo
TAGGAGGGTCGCTAGC-1	Endo
GCGATCGGTTTAAGCC-1	Myeloid
AGCCTTCAGGTCGGTA-1	Myeloid
ACAGAAAGTAAGTCTC-1	Myeloid
ATTGTCTCATTACCTT-1	Myeloid
GCCCGAACACCTATTT-1	Myeloid
ACTATTCAGTACGCGA-1	Myeloid
GTCACCTCACAATAAG-1	Myeloid
TGACTCCGTCTGAGCC-1	Fib
AGCCTGGAGGGCGAAG-1	Lymphoid
GCCCGAAAGCTGCTCG-1	Fib
CTAACTTCAAGAAACT-1	Lymphoid
CACTGAAAGAAGACTT-1	Endo
GTACTTTAGTCATACC-1	Endo
GTGTGATTCTGGAAGG-1	Lymphoid
GAAGTGGCACAAACAA-1	Myeloid
GTTCAAGCATTCGTCC-1	Fib
CCATACCTCATGTTCT-1	Fib
TCAAAGCGTGACCAGA-1	Endo
AACAAAGGTATCGCGC-1	Myeloid
GCCCAGACAACTACTG-1	Fib
GATGGCCTCGATCGCG-1	Endo
GCTCACTTCGGGAAAC-1	Myeloid
TTGCTTATCACTTACT-1	Myeloid
GCAACCGCAACATAAG-1	Myeloid
GTCACAATCTGTAGAC-1	Myeloid
CGGTGCAAGACCCATT-1	Endo
CACATGATCTCTATCA-1	Pericyte
CTTCTAAAGATGCGAC-1	Myeloid
CACAACACAAGCGTCC-1	Endo
TAGCCGGTCGCAAACT-1	Endo
TGCTTCGAGTAATCAG-1	Pericyte
CTTAATCAGAAAGGGT-1	Myeloid
ATAGTCGCATGGCCCA-1	Fib
ACTCGGGTCTTTATCG-1	Myeloid
CCACGTTAGTCTGGGA-1	Fib
ACTGTCCTCTGGCCAG-1	Endo
CTCGCTAAGATCGAGC-1	Endo
ATTACCTTCTCGTGAA-1	Myeloid
TGATCAGTCAGGAAGC-1	Myeloid
AAAGGATCATCGGCTG-1	Endo
TCGTTCGCAGGCATTT-1	Myeloid
TAAGCCACACAGCTTA-1	Fib
ATCCCTGCATCCCGGA-1	Myeloid
AACAGTCCATACTGCA-1	Endo
GACCGACGTAATGTGA-1	Fib
AAAGATGTCTGACATG-1	Lymphoid
GTAATCGGTGCTTCCT-1	Fib
GTTACTTGTAACAATG-1	Endo
GAATCTGAGCCGCAAA-1	Myeloid
TATGTGGAGCACGTAG-1	Fib
GATGGCCTCAGTCTTT-1	Fib
TTTGTGTCAGATGGCA-1	Myeloid
TGAGTCACAGTAGTTC-1	Myeloid
TTTGGTTGTCCCGTGA-1	Myeloid
TCACCTGTCCACGAGC-1	Myeloid
TTGCAGACAAGATGCG-1	CM
AGCCAGCTCTGAGTCA-1	Myeloid
ACTCGGGAGAGGAAGT-1	Endo
TGCGTAAGTTCAGAAA-1	Myeloid
GCAACCGTCTATTTCG-1	Lymphoid
CTCACCATCAGTGGTT-1	Myeloid
GAGGATGGTAATGCAA-1	Fib
TGTAAGCCAGGCATCC-1	CM
AAATGAGCAATGTGCT-1	CM
GACCTTCTCCCACTTG-1	Endo
GGGAACAGTCTGGGAA-1	Myeloid
ACAGAAAGTACATGGG-1	Endo
TGAGCCGGTTCCCAAA-1	Endo
CTTCCAGGTCAGCTTA-1	Endo
GTGATCATCCAGGTAT-1	Pericyte
CTCTCAGTCCTTTGAT-1	Myeloid
TAGCATGAGATGGGAA-1	Myeloid
AACCGATCAACGTACT-1	Endo
TTTGAGGGTTTCCACC-1	Myeloid
TCCCACACAAAGCTGG-1	Fib
GCTTTCGTCTGTTGCC-1	Endo
ATTGTCTAGAAGCCGT-1	Myeloid
TGCTTCGAGTCTAGAA-1	Fib
TTCTAACAGTAGACCG-1	Myeloid
TGGCAATAGGTGAACC-1	Fib
CTCAGAACACTTATGG-1	Pericyte
TTCGATTCAATGGTAA-1	Fib
AACCAACCAGTTCGGC-1	Endo
TCAGGTAAGAGGCAGG-1	Endo
GCCAGCAGTATCGCGC-1	Fib
TTGTTGTGTTGGGAAC-1	CM
AGCCCGAGTGTGAGGT-1	Lymphoid
TCAAAGCCATGGATGG-1	Myeloid
TTAGGTGTCATCATGG-1	Myeloid
TTGTTCATCTGGGCGT-1	Myeloid
AGGACGATCCTCCAGT-1	Myeloid
CGCTGGAAGTAACACA-1	Myeloid
TCAGCTCGTCTGTCCT-1	Myeloid
TGTACGACACGCGATC-1	Myeloid
CACATGAAGAGGTGGG-1	CM
CAGGGCTTCTTATCAC-1	Myeloid
CCCTGATCAAGCGTCC-1	Endo
CCTATTACACATAAAG-1	Myeloid
TTAACGGGTAGGTAAT-1	Myeloid
TCAGCTCTCCATCGAA-1	Lymphoid
GCGATTACATAGACGG-1	Fib
GGTCATATCTTAAGCG-1	Endo
GTAATCGCAGTAAGCG-1	Myeloid
ACGGATTGTCCATTGA-1	Myeloid
CCAATGAGTGGACTGA-1	Myeloid
TCGTTCGTCGGCTATA-1	Lymphoid
TTCTAACCAGTAACGG-1	Lymphoid
GAGTGAGCACCTGGTG-1	Endo
TGGGTTACATCGTGAT-1	Myeloid
TTGTTCAAGTGCACAG-1	CM
GGTTGCGCACCACCAG-1	Endo
AGGCCTGGTAAGCCGA-1	Endo
TTTGTGTAGAGTAAGG-1	Myeloid
GCTTGCTAGGGTTCCC-1	Myeloid
ACTAGGTCACGCGACT-1	Endo
CCACAGGAGCCTGTAT-1	Myeloid
TCACAGATCAGGATCT-1	Myeloid
AACATCGCAATACTGC-1	Myeloid
CTCTACGGTGGCATAG-1	Fib
TGACAACAGAGATTAC-1	Lymphoid
GAAAGTAAGAATACTG-1	Myeloid
GCGCATGAGAATCAAC-1	Lymphoid
GTGACATTCCGAGAGA-1	Lymphoid
GCTTAAGGTGGTACTT-1	Myeloid
GGATGAGCATTTAGGC-1	Pericyte
TTGTCTATCACTCGGG-1	Myeloid
ACTTTCATCGGGATCC-1	Lymphoid
AGCCTGGTCGATGTGT-1	Endo
TTCATTGTCTGAAAGA-1	Fib
GCCAGACGTTCAGTAC-1	Myeloid
GACCGACGTTACTACG-1	Endo
AAAGGGCTCAGGCGCT-1	Endo
GCTGTTCCAGCGTACC-1	Lymphoid
CTGTTCGGTTACGGAG-1	Endo
TGCTCGTGTTTGCCCT-1	CM
TGATTTCCACAGCTTA-1	Myeloid
CACTGAATCCAGGGAA-1	Fib
GCGTTGGGTCCGGTAC-1	Endo
CATAACGGTAATGTAG-1	Lymphoid
AGCCTTCTCGCATACA-1	Myeloid
TCGCAGGAGTTCTCCC-1	Endo
GCCAGCAGTCCGAGCT-1	Myeloid
TGTAAGCCATTTGTTC-1	Lymphoid
TAACGGTTCTACCCGT-1	Myeloid
AAACTGCGTGTGCTTA-1	Endo
AGCGTGCAGTGATTAG-1	Myeloid
ATTCGTTGTAAACGAT-1	CM
AATGTCGCAGTGGTCC-1	CM
ATTACTCGTTCCATCC-1	Lymphoid
AGCCCGACAGGATGTG-1	Myeloid
TTCATTGGTGTCGTCG-1	Lymphoid
AATACGCTCTGATCCC-1	Lymphoid
AAACTCGCAATGACTC-1	Pericyte
ATGTTTCAGTCGTACT-1	Lymphoid
CTGTATTAGTGGACGT-1	Pericyte
GCGTAGCGTTAACTCG-1	Fib
GTGCACGGTACGGATG-1	Fib
TTGAGTGGTTCTTATC-1	Endo
AACCTGATCGTGGTAT-1	Fib
ATGCATGCATCCTGGG-1	Myeloid
GTACTTTTCGGTTGTA-1	Lymphoid
AGCTATGTCGGATAGG-1	Myeloid
AACGAGGGTCCATTGA-1	Endo
AGCCGCACACAGCTTA-1	Endo
TGTACGACACATCATG-1	CM
TTGGTCCGTAGTACAA-1	Lymphoid
AGCTGTAAGCTGATTC-1	Myeloid
GGATGAGAGAGGCCTA-1	Lymphoid
GCACGCAGTCTGAGCC-1	Fib
CACATGAAGGGCTTCC-1	CM
TAACGGTCATAGATAG-1	Endo
ATTGTCTAGTCTAGAA-1	Myeloid
CCGAAGCCATAGAATG-1	CM
ATGGATCAGCACCATT-1	Myeloid
CTGGGACCAAGGAACC-1	Fib
AAACGAACACCACCAG-1	Lymphoid
TCAGTCCTCATGAACC-1	Lymphoid
CGGACTGCACTGTAAC-1	Lymphoid
GCACGCAGTGGACAGT-1	Myeloid
GGCACGTTCCCACGGA-1	Fib
GCGATCGGTGATGTGG-1	Endo
AGCCTCTCAAGTGGCA-1	Lymphoid
GGGTTATTCGAACACT-1	Lymphoid
TTTGTGTAGTAACATG-1	Lymphoid
GCTTAAGGTACTATGC-1	Lymphoid
GCCTAGGTCCGAGAGA-1	Lymphoid
AGCTATGAGCATGATA-1	Endo
GCTCGAGGTAATGCAA-1	Myeloid
TAAACCGGTCACAGTT-1	Lymphoid
CTCAGCTTCGAGAAGC-1	Lymphoid
AAGATAGTCCTGGAAT-1	Fib
CCTTGCAAGCATGATA-1	Myeloid
GTAGTACGTGATGCTT-1	Myeloid
ACTCGGGCACGGTTAT-1	Endo
TTGCACCCACACACCG-1	CM
CGATGATGTTTGCCCT-1	Myeloid
GCCATAACAGGCAGAT-1	Myeloid
TTACGTTAGTTAGCGG-1	Pericyte
AGTCCGGCATAAAGTG-1	Fib
AATGTCGCACTGGGCT-1	CM
GGCGAAATCCAGAATC-1	CM
GGATGAGCAAGTCTGT-1	Fib
CCTTGGTTCCTGGAAT-1	Lymphoid
GTAATCGGTCCAGACC-1	Myeloid
GCGGGTTAGGAGAACA-1	Lymphoid
CGCGCAATCCAGGCCA-1	Fib
CCTGGGAGTCAGGCTC-1	Myeloid
CTTGTCGGTTGGCTAT-1	Myeloid
CTCGCTACACATCATG-1	Endo
ATTACTCTCACTCGTC-1	Fib
AGCTGTAAGGATGTAT-1	Myeloid
CCTGCTATCTCGGCGA-1	Endo
TACATTCAGTATAGTG-1	Lymphoid
ATATTCCCACCCATCT-1	Lymphoid
ATCCTGCTCGCCAGAC-1	Lymphoid
TTGTCTAAGCCATGGA-1	Myeloid
ATTACTCGTCCTATTT-1	Myeloid
CGTGGCATCCAGTACA-1	Pericyte
CACTGAAAGTTAGCAA-1	Lymphoid
TGGCCTTTCTCAGATG-1	Myeloid
TGGGTGCCAGTAACCT-1	Lymphoid
GCCTACTAGGTCTTGT-1	Lymphoid
TACCTCGCATATACGC-1	Pericyte
CACTAAGAGGTTGTGG-1	Myeloid
CTGTATTAGCCATTCA-1	Lymphoid
TATTGCTAGCTCGTTA-1	Myeloid
GCGATCGGTCTGGGAA-1	Myeloid
TGTAAGCCACATAAAG-1	Fib
CATTCCGCAGTAAGCG-1	Lymphoid
CGCTGGAGTCAGTGTT-1	Fib
GAGAACGCAATGTAAG-1	Lymphoid
ATGTCTTAGTTAGCGG-1	Myeloid
TATCGAGTCGCCCTTA-1	CM
GCGATTAAGCGGACAT-1	CM
CTTCTAATCCATAGGT-1	Lymphoid
ACATGGTGTCGTCGCA-1	Lymphoid
TCAAAGCGTCAACTGT-1	Lymphoid
TTAGGTGTCGACTTAG-1	Myeloid
CTCTAGCCAGGACTGA-1	Lymphoid
AACCAACCACGTACAT-1	Fib
CTGCTCATCTGTCGTC-1	Lymphoid
TGCGTAATCACATCCC-1	Lymphoid
TGCTCGTGTCCACCAG-1	Lymphoid
CGTGGCACATCCCGGA-1	Fib
ACTGCGGCAAACCCTA-1	Lymphoid
AAAGGATAGTATGCTC-1	Endo
GGAGTAGTCGAGGTCC-1	CM
GTCCATCTCTTAGTGG-1	Fib
TTACCCGCACTAGCCG-1	Myeloid
CTGGGACCATTAGCAC-1	Lymphoid
CTAGCGGGTCAGAAAT-1	Lymphoid
CAACCAATCTTAGTGG-1	Fib
CATTCCGGTCAAATCC-1	Lymphoid
GTAATCGTCCTGGAAT-1	Lymphoid
GAAAGTAGTTTCCGGG-1	Endo
AGCCAGCAGTGAAACT-1	Myeloid
AAGATAGTCCTCCAGT-1	Lymphoid
TCACAGACACGTTGTA-1	Lymphoid
TCTCTGGTCCATATCT-1	Fib
CACAGATGTATCATGC-1	CM
ATCCTGCCAAACGACG-1	Myeloid
CTCAGAACAAGGGAGG-1	Lymphoid
TCTCTGGAGTTCAGGG-1	Lymphoid
GCGTAGCGTGTAGGAC-1	Myeloid
GCTCGAGTCCCAGTAA-1	Lymphoid
CGAGTTAGTCGCTAGC-1	CM
TATCTGTAGAATGCTA-1	Endo
GTGCTGGTCAAGTTGC-1	Endo
CCCACATGTTTGCATG-1	Myeloid
TCAGTTTGTTCCTGTC-1	Fib
ATTTGTCCACTCGGAC-1	Endo
TTGCGGGAGGTTACAA-1	Lymphoid
TAACGGTTCTTAGTGG-1	Fib
TAGGTCATCTCTATCA-1	Myeloid
GCGTAGCGTCATAAGA-1	Lymphoid
GCTGCGATCCCACTTG-1	Endo
GATTAGCAGACCATAA-1	Endo
TACGCAATCCACCTAC-1	CM
AGCGATTAGCCCATTA-1	Lymphoid
AACATCGCAAAGGTCG-1	Pericyte
TCGCCTAAGAGCTACG-1	Lymphoid
CACCTTGGTTCCCTTG-1	Lymphoid
GCCCGAACATGCACTA-1	Fib
GATGATCTCGAGTTAC-1	Fib
TACGGATTCGTCCCTA-1	CM
GTCACAATCCAACGCG-1	Lymphoid
AAGATAGAGTCATCTG-1	CM
CGCTGGAGTAGACACG-1	Fib
AGATAGACATAGCCAT-1	CM
ACCAAACGTGTTAGAA-1	Myeloid
CATGCCTTCCACGGCA-1	CM
GTTACTTAGCATTGGG-1	Lymphoid
GGTCATAGTAACAATG-1	CM
TCCCACAAGAGCCTGA-1	CM
GACCCAGTCCCATAGA-1	Lymphoid
CCCTGATGTGAGGTCA-1	Endo
GGGTCTGCACGGTTAT-1	Fib
GTTACTTAGAGGTGGG-1	Fib
ACTAACGAGTCTGGGA-1	Pericyte
TGGCCTTCAAATGTCC-1	CM
GCGAGAACATCCCTTG-1	Lymphoid
GTGGCGTAGAGCTGTG-1	CM
AGCTATGAGTGTCGCC-1	Lymphoid
TTGAGTGGTGTCCAGC-1	Endo
GAGACTTCAATGACTC-1	CM
TGCTATTAGTCTGCTA-1	Lymphoid
ACCCAAATCTTCCGTG-1	CM
GAACCTAGTTGGGAAC-1	Lymphoid
TAGCCCTCAAGCAGGT-1	CM
TTGCAGAAGTCGCCTG-1	Lymphoid
ACAGGCCGTAGTCTGT-1	Myeloid
AATGTCGCACATATCG-1	CM
CAGCTAAGTCGAGGTA-1	Fib
GCAGCTGAGATTAGAC-1	Lymphoid
TTTGCGCGTAATGCAA-1	CM
GCAGCCATCGGTCAGC-1	Endo
GATGATCCAAGGAACC-1	Myeloid
GGTGAAGTCGCCGAAC-1	Myeloid
ACCGAATGTTAGTAGA-1	CM
CTTCTAACAAGGAAGA-1	Endo
GCATGATGTCAATCCA-1	Lymphoid
TAAACCGCAGGGTAAC-1	Myeloid
CACCACTGTAACCATC-1	Lymphoid
CGCAATAAGATGAGGA-1	Myeloid
GCATTGAGTTTGGATC-1	Myeloid
ACTGCGGAGATGGGTC-1	Pericyte
ACAAGCTTCCCTACCA-1	Endo
GCCCGAAAGGTTCGAG-1	Endo
ACTATTCAGAGAATTC-1	Endo
GTGTCAAGTAGTGATA-1	Lymphoid
CGCAATAGTCCGAGCT-1	Myeloid
GTCACTCGTACGACCC-1	Myeloid
TCTAGTTTCGCAGATT-1	Lymphoid
GCTTTCGTCGTGGCGT-1	Endo
TTGTTGTGTTAACTCG-1	CM
ACATGGTCATGCGACC-1	Lymphoid
GCTTAAGTCCACGAGC-1	Lymphoid
CTTCCAGTCTCGGCGA-1	Endo
TTCGATTTCAATTCCT-1	Lymphoid
GTCACCTCAAGACTAA-1	Lymphoid
GTTACTTAGGGCTTCC-1	Fib
TCGCAGGCATCATGTG-1	CM
GCCAGCACATTCTTTG-1	Lymphoid
ACTGCGGAGGGCGAAG-1	CM
ACCGCAGCATCCCAAA-1	Fib
AGCTGATAGACCCTAT-1	CM
TAGCCGGGTCACTCTC-1	CM
ACTATTCCAAGTAATG-1	CM
CCGAAGCCACAGTAGG-1	CM
AAGGAGCTCCTCTCTT-1	Lymphoid
GTCACAAGTCCGTAGC-1	Endo
ATTTGTCCAGTGGTCC-1	Endo
GTGCCAGCATCACAGT-1	Endo
GCTGCGACATGTAGAA-1	CM
CTACAGACAGCGTAGA-1	CM
GCTGCGACACTCGGAC-1	CM
GAGATTCAGACCCTAT-1	Fib
ACAAGCTTCTGGCGCA-1	Myeloid
TTAACGGCAATGCATC-1	Myeloid
TAACGGTGTGCAACAG-1	Myeloid
GCTCACTCACGTACAT-1	Endo
TGGCCTTAGGATTTGA-1	CM
TTACTCACATCATGTG-1	Myeloid
GAGTGAGCAGCCACGT-1	Lymphoid
CCTTAATGTCAAACAA-1	Fib
GGAGTAGGTGTCCTTC-1	CM
AGCGATTTCCATATCT-1	Myeloid
CGCGCAAAGAAAGCAG-1	Fib
TGGTCAACATTGATGC-1	CM
AGGCCTGCAACAAACA-1	CM
TACATGGTCGTGGAAG-1	CM
CGAGTTAGTGTGTGTT-1	CM
GCTGAGCAGGCGACTA-1	Myeloid
TTAGGTGTCAACTTGG-1	Fib
CCCTCTCAGTCTAGAA-1	CM
ACAGACTCATGCGCTG-1	Myeloid
TGGCCTTGTCTGATTG-1	Myeloid
GCTGTTCGTCTGGGCT-1	Lymphoid
TGACTCCGTATCACAC-1	Fib
GCTGCGAGTATCGCGC-1	Lymphoid
TTCATTGCAAGGAACC-1	Myeloid
TGGCCTTCACCTACCT-1	CM
AATGCCACAATTAGGA-1	Endo
TGCCTGTGTTGCTTGA-1	Endo
GCAACCGCAGATTGTC-1	Endo
GTAATCGTCGTGGGTC-1	Lymphoid
CTCGCTATCCTATCAT-1	Myeloid
GACTAGTCAGGCAGAT-1	Myeloid
CCCTAACTCAGTGGTT-1	Myeloid
AACTGGTGTGGGTAGT-1	CM
GATGATCCATGGGTGA-1	Myeloid
CGCTATCGTTTGCATG-1	CM
GCGTAGCGTTGGGAAC-1	CM
CTTGAAGCAGAGATGC-1	Fib
AAAGGATTCCTGTGGG-1	CM
GAGGCTCAGGGCTCTC-1	Endo
TTGAGCATCGGGAAAC-1	CM
ATGTCGAGTAGCGTTT-1	CM
GGAACCCAGGAGGCGA-1	CM
TGTTAGGTCTCGCGTT-1	Fib
CACATGATCGAGGTCC-1	Pericyte
GCTGTTCCAAGGAACC-1	Myeloid
ACAGGCCCAAGGAACC-1	CM
CATTCCGCAACTCGAT-1	CM
TTATGTCCAATCCATG-1	Lymphoid
TAAGCCATCCAGTACA-1	CM
ACTCGGGTCTCTCAAT-1	CM
ATTTGTCCACTGGGCT-1	CM
TACTCGCAGTCGACCC-1	Myeloid
TGCTCACTCTTCAGAG-1	CM
GAATCTGCAGAGATGC-1	Fib
ACTACGACAGTAACCT-1	Lymphoid
CGTTCCAGTATTTGCG-1	Lymphoid
CAGTATGAGCTCGGCT-1	CM
GCGCCAATCCTTTGAT-1	CM
CCACAGGAGACCCTAT-1	CM
TTGAGCATCACTCGGG-1	CM
AGCTGGCCAAGACACG-1	CM
AGTCCGGAGCGTTAGG-1	CM
GGAGTAGTCACGTGTA-1	CM
CAACGTAGTAATGCCT-1	CM
CTGTTCGCATTGTGAC-1	Fib
TAACGGTTCCTCCAGT-1	Fib
CACAGATAGCGAGAAA-1	Myeloid
CTTGCTGCAGTCAGCC-1	Myeloid
TAAACCGCAGGACCTC-1	CM
GTAATCGGTGATTCCA-1	Endo
CGAGTTAGTGAGTTGG-1	CM
TGCATTTCAAACGACG-1	Myeloid
CTTAATCGTTCTACCC-1	CM
CTGTTCGCATATACGC-1	Pericyte
GACCTTCGTAATGCCT-1	CM
GCATTGATCACCCTTG-1	Endo
AGTCCGGAGTGGGACT-1	CM
CCTGCTATCTATCTAC-1	CM
AGTCCGGCACCTATTT-1	Myeloid
TAGGTCATCGAAGCCC-1	Fib
ACGGATTTCTCTCAAT-1	CM
GGAGTAGTCGCGTTCT-1	CM
GGGTTATCATCGACGC-1	Lymphoid
CTCGCTATCGGGAAAC-1	CM
AGCTGATAGAGGTGGG-1	CM
AACGAGGTCGCTTGAA-1	CM
GAGTGAGCACTGGGCT-1	CM
CAGGGCTAGCTAGCAG-1	CM
AATGTCGCACCTGGTG-1	CM
AACCGATTCAGAACGG-1	Fib
GTCCATCTCCTCCAGT-1	Fib
AGTCCGGCATTGAACC-1	CM
GAGCGCTCAACGTCCG-1	CM
GAGTGAGCATGGCCCA-1	CM
ACTGCAAGTTCTTAGG-1	Endo
GCACGGTCATAGTCCA-1	CM
GATCGTACAAGGCGTA-1	CM
GAGCGCTAGGAGACTC-1	CM
GTGTGATAGTCGCCTG-1	CM
GCCTACTGTGTCTACA-1	Lymphoid
ATCGAGTAGGAGGCGA-1	CM
ACAGGCCTCTAGTCGA-1	Myeloid
AACCGATCAGGTGTCC-1	CM
CATAACGAGTATGCTC-1	Endo
GTCACCTAGTATGCTC-1	Endo
