Barcode	cell_type
AACTTGGGTTCTTTCA-1	Fib
GTAGGAGGTTTGTGAC-1	CM
GTGTGATGTCTTAGCA-1	CM
GTGACATGTCAAACAA-1	CM
AAAGGGCCACCCATCT-1	CM
TCGTTCGAGCTCGTTA-1	CM
GATCGTACAGGAGCAT-1	Endo
GTGCCAGGTTTGTGAC-1	CM
AAATGAGTCCGCTCTA-1	CM
GGCACGTTCGCTGATA-1	CM
AGTCCGGGTGTGTGTT-1	CM
TCTAGTTTCCCAATGA-1	CM
TCAGGGCTCGGTACTA-1	CM
ACAAGCTTCGTGGTAT-1	Fib
GTTGGTACACTGCTCT-1	Fib
CCTTAATTCTCGGCGA-1	Fib
TTGCGGGGTTAGGAAT-1	Endo
TTGCTTAGTTCAGTTG-1	Endo
TTAGGTGAGTGATCTC-1	CM
TAGCATGCAATGACTC-1	Myeloid
GCCAGCAGTTAGGAGC-1	Fib
TGGTCAAGTATACGCT-1	CM
CCAATGACAGTAAGCG-1	Endo
GCATTGATCGCGCTGA-1	CM
GAACTTGGTTGGCTTA-1	CM
CGCGCAAAGACCATAA-1	CM
AGCCTCTCACTAGGAG-1	Fib
ACTTCCGGTGGTGGTA-1	Fib
TGGAAGGCAAAGGAAG-1	Fib
TGAATCGTCGCAGATT-1	Fib
AACCTTTGTGACAAGC-1	CM
TCGGGACAGACACAAT-1	Fib
CCCTGATAGAGTTCGG-1	CM
TAGGTCAGTGCACCCA-1	Pericyte
CCTAAAGAGCAGAAAG-1	Endo
TAGGTGTTCTTGGCCT-1	Fib
TGCTTCGTCCGTCAAA-1	Fib
ACAGACTGTTCTGATG-1	CM
CTAGCGGGTCCTTCAC-1	CM
GCTCACTTCAAATGGA-1	CM
GATTAGCAGCTACGCC-1	Myeloid
CGCAGGTTCCAAACCA-1	Fib
AGGACGAGTCTGGGCT-1	Endo
CTAGGATTCGATCGCG-1	Myeloid
AGCGTGCAGTGATCTC-1	CM
CTCTACGAGGCGATTG-1	Myeloid
CCCTAACGTTACGAAA-1	Myeloid
CGCGCAACATTACTCT-1	Fib
GATTGACTCCTGGGAC-1	Fib
GTCACCTAGAGCAGCT-1	Fib
TAACAGCTCGCCCTTA-1	Myeloid
TTGGTCCTCCCGGGTA-1	CM
AGCTGTAAGCTCCATA-1	CM
GCGCCAAAGGCATGCA-1	Fib
GCATTGAGTGCATTGT-1	CM
ATTCGTTAGTCGATAA-1	Endo
AGCTGTAAGAACGACC-1	Fib
TCAGGGCTCAAGGCCC-1	Myeloid
GCGAGTCCACATAAAG-1	Myeloid
TATCGAGAGATCGAGC-1	Fib
AACTTGGTCCCACTTG-1	Endo
TCGCAGGCATGGCCCA-1	Fib
GCGGAAAGTGCCCGAT-1	Endo
ACCTGCTCACCACAGC-1	Endo
CTTGAAGTCGGTCGAC-1	CM
TAGCCGGCATTGCCTC-1	CM
ACTTCCGCAGCAACAG-1	Fib
TCTCTGGCATTTCACT-1	Myeloid
TATGTTCCAGCAACCC-1	Myeloid
CACATGAAGACTAGGC-1	Fib
TTGGTCCGTAATGTGA-1	Pericyte
ATTCGTTGTATTGTCG-1	Myeloid
TATGTTCAGGGCTTCC-1	Myeloid
CACCACTAGAACGCCA-1	Myeloid
CGATGATGTGGAAAGA-1	CM
TATGTTCAGAGGAACA-1	Myeloid
TAATTCCTCCCAGTAA-1	Myeloid
ACTTTCAGTGGCCTCA-1	Lymphoid
CCGAAGCGTGGATTTC-1	CM
GACCTTCGTCAACTGT-1	Fib
TCTAGTTGTGGTAGAC-1	Myeloid
CTCTAGCCACTAAACC-1	Myeloid
TATCGAGAGGGCTTCC-1	Fib
GCGGAAAGTCCAGACC-1	Neuronal
AAATGAGAGCGTGTTT-1	Myeloid
ACTAGGTCAGGCACAA-1	Fib
GCGTAGCCAGATTTGC-1	Myeloid
TACCTATAGCACGTAG-1	Fib
TACGGATCAGTCCTGG-1	Myeloid
CCAATGAGTGATGCTT-1	Myeloid
TTGCTTAAGGAAGAAC-1	Fib
GAGGATGGTATCTCAG-1	Myeloid
AACCGATGTTCCGGCA-1	Endo
GACCTTCAGCAATAAC-1	Endo
ACCAAACTCTATCTAC-1	Endo
CGCGCAAGTTGAAGCG-1	Myeloid
GCGAGTCCACTCCCAT-1	Endo
TGGTCAATCCTCTCTT-1	Myeloid
CATTGGATCGGGAATG-1	Myeloid
TCAAGCAGTTTAGGAA-1	Myeloid
CGCTAGGCAATGCATC-1	Fib
TGCACCTAGTAGGAAG-1	Myeloid
CTCAACCAGCCTTTGA-1	Fib
GCCTACTGTGGAGTGT-1	Endo
CAGGATTTCTCTTCCT-1	Myeloid
GAAACAAGTAGCATGG-1	Endo
ACAGACTTCTTCAGAG-1	Myeloid
TTCGATTTCCGTTAGA-1	Myeloid
CTCTAGCTCTTCAGAG-1	Endo
GGCATTATCCGATGCG-1	Myeloid
TTGCGGGCATTCTTTG-1	Myeloid
CTCAGCTCATGGTTTG-1	Endo
TGCTATTCAGGCTACC-1	Lymphoid
GAGAACGTCCACACCT-1	Endo
AACTGGTGTAGACGCA-1	Myeloid
GAGCGCTCATGGATGG-1	Endo
GCTCACTCACCGAAAG-1	Myeloid
GTGTCCTTCCATTGAG-1	Myeloid
TTTGCGCAGGTCTTGT-1	Myeloid
TGGCAATCACTGTCAA-1	Endo
AACTGGTAGAGCACTG-1	Myeloid
GCTTGCTCAAACCGAG-1	Myeloid
CAGGATTCAGTAAGCG-1	Myeloid
CGCAGGTCAGCAACCC-1	Endo
GGAACTTTCTGGACAT-1	Endo
GGTACCGCAAGTAATG-1	Lymphoid
CAAGAAAAGAAAGGGT-1	Lymphoid
AACGTACCACATCATG-1	Myeloid
TGCTCGTGTTACCCAA-1	Endo
ATTTGTCAGGACCGAT-1	Myeloid
TTGACGAGTTTCTACT-1	Fib
TTGCACCAGCTGAATA-1	Lymphoid
GCATTGATCCTGACCT-1	Pericyte
CCGTACTAGGAGAACA-1	Myeloid
TAACTTCTCGTTGTTT-1	Lymphoid
ACAGACTGTTGGGAAC-1	CM
GCACCTTTCCCATAGA-1	Endo
CAACGGCCAGGCTACC-1	Endo
AGGACGACACTAGGAG-1	CM
CCAGAATAGTATCTGC-1	Myeloid
TCAGTTTGTCTGGGCT-1	Myeloid
TACCTATCAGTAACGG-1	Endo
TCGTTCGCAATTCTCT-1	Myeloid
GTTGGGCCAATGCCAT-1	Myeloid
TTCTAACAGAGCTACG-1	Myeloid
TCGCAGGTCGAGGCTC-1	Myeloid
GAAATGACAATGCCAT-1	CM
TGATCAGTCCATACGA-1	Lymphoid
CGCACAGGTTTCTCTA-1	Myeloid
TCACCACAGTCTGGGA-1	Lymphoid
TTCATTGGTGTCCAGC-1	CM
TGACTCCGTTGTCGGC-1	Myeloid
ACCTGCTGTCCAACCG-1	Pericyte
GTGCACGGTGCATCAT-1	Lymphoid
CTCGCTAGTGCTGGCT-1	Fib
GAGGCTCAGCTATCGT-1	Lymphoid
CAAGAAAGTTACTTTC-1	Endo
GAGATTCGTCCTATTT-1	Endo
CTTTGCGGTTTGACCA-1	Fib
AGCCAGCGTTGGTAAA-1	Fib
CGCAATAGTTTAGAAG-1	Pericyte
AATGTCGCAAAGGCCA-1	Pericyte
GAAGAGCGTTCTTATC-1	Myeloid
AACCAACAGAGTTCGG-1	Lymphoid
GATGATCCAAAGGAAG-1	Fib
TTGTTCACACCTTGTC-1	Fib
TGTACGAGTTGTCGGC-1	Endo
GCTCACTGTCGGCTGT-1	Myeloid
TGTACAGTCTTCCGTG-1	Lymphoid
GAATCTGCAATGCACT-1	Myeloid
TTGCGGGCACTGAAGG-1	Myeloid
CGCTAGGCACTGGGCT-1	Fib
TCTAGTTGTCTGAGCC-1	Myeloid
GCGTAGCGTATACGCT-1	Lymphoid
GCATTGAGTCCGTAGC-1	CM
CACCTTGAGTCTCTAG-1	Endo
ACAGACTGTTAACTCG-1	CM
ACTATTCAGACAACGC-1	Myeloid
AATGCCATCGGAGTTT-1	Myeloid
CACATGACACCACAGC-1	Endo
GAACTTGGTCGAGGTA-1	Endo
CAATCCCGTTCTTATC-1	Lymphoid
