Barcode	cell_type
TGCTCACCAAGACTAA-1	Fib
GTGGATTGTGTGAGGT-1	Fib
CACCTGTGTTCTACCC-1	Fib
TTACCGCTCCAGAGAG-1	Fib
TTCATCATCTCGTGAA-1	Myeloid
TTCTGTAAGACTAATG-1	Fib
ACTGCGGTCTGTGTGA-1	Fib
ACAAGCTGTCTAACCA-1	Fib
ACCGGGTCAGGGTACA-1	Endo
TTAGGTGAGTCTTAGC-1	CM
TGCTATTTCGGTCGAC-1	Fib
TCTAGTTCATTAAGGA-1	Pericyte
ACTGCGGTCCTGTAGA-1	Fib
TCACTCGCAAGCCTTA-1	Fib
AACCTTTAGACCCATT-1	Fib
AACTGTGTCACGTGTA-1	Fib
CTCTACGAGCCAGAAC-1	Fib
TGCGTAAGTAACGGCA-1	Fib
ACAAGCTGTGTTGGTT-1	Fib
GAACTTGTCGAGTGTT-1	Myeloid
CACTGAATCTCTGTTA-1	Fib
GTCACCTAGTACGCGA-1	CM
CAGCCTTAGAGATTAC-1	Endo
TCTAGTTCAGGCACAA-1	Fib
CCCTAACTCAACTTGG-1	Fib
ATGTTTCAGAACGACC-1	Fib
AGCCTGGCAAACCCTA-1	Myeloid
GAACCGCAGGCGCTTC-1	Fib
TCTAGTTGTTCACGTA-1	Fib
GAGGTCCGTATTGTCG-1	Fib
GTGTCAATCCTGTAGA-1	Myeloid
TGTACAGCAGGTAGGT-1	Fib
CTGCTCAGTCTGTCCT-1	Fib
TGAATCGGTTCTACCC-1	Endo
TCAAGCACATTACCTT-1	Fib
GTAGACTGTAGTACAA-1	Fib
TGGGTTAAGTGGTGTG-1	Fib
TGCTTTATCCCTATTA-1	Fib
TGAATCGTCCTTTGAT-1	Fib
GTAATCGAGCCTTTGA-1	Fib
GCTGTTCTCTCAGATG-1	Myeloid
CGCACAGAGTTTGGAA-1	Fib
AAGATAGTCTGACTTT-1	Fib
TGCTTCGGTGCCCTAG-1	Myeloid
TCGCCTAAGACAACGC-1	Pericyte
CCGTACTTCCAATAGC-1	Fib
GGAATCTAGGACTTTC-1	Fib
CTCAGAACAAGCAGGT-1	Fib
GGAACTTCATATAGAG-1	Myeloid
AGCGATTCATGTGGGA-1	Fib
GAGTGAGAGTCTGGGA-1	Fib
TAACTTCGTCCTCAGG-1	Myeloid
AATACGCCATAGCAGG-1	Fib
GTAGGAGCATTCGTCC-1	Fib
TTATGTCTCGGGAATG-1	Fib
GCGGAAACAGAACTTC-1	Fib
GTGTGATCAGCCGAAA-1	Myeloid
GGATAGGCACTAGCCG-1	Fib
ATGTACGCATGGCCCA-1	Fib
TACTCGCTCGATGTAC-1	Fib
AACGTACCAACATAAG-1	Myeloid
TAGACTGGTGGGTAGT-1	Myeloid
TAGCATGAGGAAGAAC-1	Fib
CCTTAATCAACAACTC-1	Fib
AACGAGGCACTGTCGG-1	Fib
GCACCTTTCTTCAGAG-1	Fib
GGTAGGAAGCGCACAA-1	Fib
AGCGATTAGGCCAGTA-1	Endo
CAAGCTACAGGGCTTC-1	Endo
TAGCTTTCATATTGGC-1	CM
AGCTGTAAGGGATCCA-1	Fib
ACTACGAAGGGCTCTC-1	Myeloid
GTGATCACACTCGCAG-1	Fib
TTTGAGGTCAGTCTTT-1	Myeloid
CTGCGTTTCGATGCAT-1	Myeloid
ATCGAGTTCAAGAGGC-1	Myeloid
GATTAGCGTTGCCTGG-1	Fib
TCCATCGTCTTCCAGC-1	Fib
GTGGATTGTCTGGGCT-1	CM
GTGATCATCTACTGCC-1	Fib
TGTAGCAAGTGAGTTA-1	Endo
AGCGTATCAAATGCTC-1	Fib
GGATGAGGTAGTGATA-1	Endo
GTGCTGGAGAATCAGT-1	Fib
TTACTCACAACTGCGC-1	Myeloid
CTGCGTTCACATAAAG-1	Endo
GCGATCGCATCGTACA-1	Myeloid
GTGACATGTATCTCAG-1	Fib
GAACTTGGTACCCATA-1	Fib
TTTGCGCGTTCCAATG-1	Myeloid
GAAACAACATGGTAAA-1	Fib
GAACCTAGTATTCGAC-1	Fib
ACTGTCCGTAATGTAG-1	Fib
TACGCAACATACTGCA-1	Myeloid
GGCACGTTCCCGTAGG-1	Fib
CATAACGTCTGATCTT-1	Fib
GTGCACGAGGAATGGA-1	Myeloid
GTTATGGTCTCATCCG-1	Myeloid
GCGGGTTAGCCAGAAC-1	CM
AACTGGTGTTTAGGAA-1	Fib
CAACGTAGTTTCCGGG-1	Myeloid
GTGCACGCATAAAGTG-1	Fib
CCCAGAGCATAGCAGG-1	Endo
ATCCAGAGTTATCGAC-1	Myeloid
CAGGGCTGTAGTGATA-1	Fib
ACAGGCCAGAACGTCG-1	Fib
GTTGGTAAGTGTCCCG-1	Fib
TGCTCACGTCTGTCCT-1	Myeloid
GAGCATTGTGGACAGT-1	Myeloid
GGGCCATAGAACCCGA-1	Fib
AACCTGACACCGAATT-1	Endo
CTACTTATCTGAAAGA-1	Endo
ATTACCTGTGATGTGG-1	Fib
AAGATAGGTGCTGTCG-1	Fib
TGGTCCTCAATTGGCT-1	Myeloid
GGAGAACAGGCTTAAA-1	Myeloid
TGATGCAAGCCAGAAC-1	Fib
CTCCCAACATAGATAG-1	Myeloid
GTTACGAAGATGTTCC-1	Fib
GGATGAGGTATTCGAC-1	Fib
AGTGCGCTCGTTCTAT-1	Myeloid
GTCTACCCACTTACAG-1	Endo
GCGCCAACACTCGGAC-1	Fib
CCTAAAGTCCGAGAGA-1	Fib
CAAGCTACAATCATCG-1	vSMCs
TGTACAGAGTGATCTC-1	Fib
CAGTGCGTCCCACTAC-1	Myeloid
TCAGGTAAGTGTGTAA-1	Fib
TCGGGACCACTGGGCT-1	Fib
AAAGATGCATCCCAAA-1	Fib
ACAGGCCGTATCCCTC-1	Myeloid
CGCACAGCATCTCTCG-1	Myeloid
AACGAGGTCTATCTCA-1	Endo
CAAGAAAAGGTACATA-1	Myeloid
CTAACTTCAGTTGCAT-1	Endo
CGCGCAATCTCCACTG-1	Fib
AAGGAGCCAGCAACCC-1	Myeloid
CTTTGCGTCATCGCTC-1	Fib
GTTATGGGTGATGTGG-1	Fib
ACTCGGGTCGCTTACC-1	vSMCs
TGCCTGTTCGTTCCGT-1	Pericyte
CGCTAGGTCCCGAAGC-1	Fib
TCTATTGAGATCCGAG-1	Fib
CTAGGATTCCGGCTGA-1	Myeloid
GTGCTGGCACCATTCC-1	CM
GAAGAGCTCGGAGTTT-1	Fib
GGGACCTTCGCGATGC-1	Myeloid
TCACAGAGTTCCCTTG-1	Endo
CCACGTTTCCCATAGA-1	Fib
CCCGTTAAGATACCAA-1	Pericyte
GGGTGTCTCCACTAGA-1	Fib
TGACTCCGTGCCCAGT-1	Myeloid
GAACGTTAGCAGGAGG-1	Fib
AGCCTGGTCAACTTGG-1	Fib
ATCCCTGTCGGCTATA-1	Fib
GATCATGTCCAGAGAG-1	Myeloid
CACCACTGTAGTCCAT-1	Myeloid
GCCTACTTCTCTTAAC-1	Myeloid
CTACTTATCGGGAAAC-1	Myeloid
GTGGATTTCTCTTAAC-1	Fib
GATGGCCGTTAGGAGC-1	Myeloid
ACGTTAGGTCTAACCA-1	Myeloid
GAGGTCCTCAAGGCAG-1	Endo
CAAGAAAAGAGATTAC-1	Myeloid
GGATGAGTCCCAATGA-1	Fib
AACCGATAGACTAGGC-1	Fib
CTCAGAACATTGCCTC-1	Fib
TCACAAGCACAAACGG-1	Pericyte
GAAAGTAAGAGTCCGA-1	Pericyte
GAGGTCCTCGTGAACT-1	Fib
GCAACCGGTAGTACAA-1	Myeloid
CATGCCTTCCATCGAA-1	Myeloid
GGCGAAAGTTACACTG-1	Fib
CATTGGAAGCATACCT-1	Fib
AACATCGTCAGGTTTG-1	Myeloid
CAGTGCGGTATTCTTC-1	Fib
CCCGTTACAGTTCGGC-1	Fib
ATCCTCGCATATTGGC-1	Myeloid
CCCTCTCTCCGTCAAA-1	Myeloid
CACATGATCTGGCCAG-1	Myeloid
CAATCCCCACAGGAAC-1	Myeloid
CGATGATGTACCAAGG-1	Myeloid
GGGCCATAGCACCATT-1	Myeloid
GCTCAGGTCCGTGCGA-1	Fib
TGAATCGAGGCACTAG-1	Endo
TAGCCCTAGTCCGATT-1	Myeloid
AAGGTTCAGATGGGAA-1	Myeloid
GTGTCCTCAACTCGTA-1	Pericyte
GCCTACTGTCCCGTGA-1	Fib
GCTTAAGAGTGCAACG-1	Myeloid
TACGCAAAGACGCCCT-1	Fib
TGCACCTAGCGTATCT-1	Myeloid
CGGACCAAGATCTAAG-1	Fib
CAAGAAAAGACTTGAA-1	Myeloid
GAACTTGCACACACAT-1	Myeloid
CACCTTGTCGTCCCTA-1	Fib
AGACAAAGTGTTGTTG-1	Myeloid
TTCTGTAGTGAATGTA-1	Myeloid
TGCTTCGTCTGTGTCC-1	Myeloid
TCACTCGTCCTTACGC-1	Myeloid
GGATGAGTCCTCCATG-1	Myeloid
CAGCTAACACTTACAG-1	CM
GTTACGAAGACACAAT-1	Myeloid
AAGGTTCCATTTGTTC-1	Fib
TGGTCAACACCGAATT-1	Fib
TCTATTGTCCGATGCG-1	Myeloid
AAGATAGCAAGACACG-1	Myeloid
ACTGCAATCGGGCTCA-1	Endo
TCCATCGAGTCATCTG-1	Myeloid
GAAAGTATCATGCTTT-1	Endo
ACGGATTGTAGAATAC-1	Myeloid
TATGTGGGTTCCAGTA-1	Endo
TCACAAGCACGAACGA-1	Myeloid
GACCGACAGGCTCCTG-1	Myeloid
TAGGTGTAGTGAGCTG-1	Endo
CTTGCTGAGTGCTAGG-1	Myeloid
ACTCGGGCAAGGTTCT-1	Fib
TAGGAGGCACACATTG-1	Myeloid
AATGGCTTCGAGAAGC-1	Fib
TAGCGGCGTTCAGAAA-1	Myeloid
TTCGATTGTTTGACCA-1	Endo
AGTCAACGTCCCGAGT-1	Myeloid
GGGTGTCAGAATCAAC-1	Myeloid
TTGTTCAAGGAAGACA-1	Myeloid
CCATACCCAAGCCAGA-1	Myeloid
CACATGAAGTAGAAGG-1	Myeloid
TTCGGTCAGAGTTTGA-1	Myeloid
TGCTCGTTCACAAGCT-1	Endo
AGCGTGCCAGGGCTTC-1	Myeloid
ACGTGGCGTTTGTAGC-1	Fib
ACTGCGGTCGGATGTT-1	Fib
GCTCGAGCATTATGGC-1	Fib
AAACGAAAGTACTCTG-1	Endo
TGCATGAGTGCCCGAT-1	Myeloid
TCAAGCACATTGAACC-1	Myeloid
CTCAACCGTGCACTTA-1	Myeloid
GGTGAAGCAGGGCTTC-1	Myeloid
CAAAGCTCAAGCCTTA-1	Myeloid
TAGCCGGGTAGTCCAT-1	Endo
GTAGGAGGTGCACATT-1	Myeloid
AGTTACGAGCGAATAT-1	Myeloid
GTCGTAACAACTCGTA-1	Myeloid
AATACGCGTGGCGCTT-1	Endo
CTTAATCAGTCATACC-1	Myeloid
ACAGCGCGTGTCGGTC-1	Endo
GCGAGAAGTAGATTAG-1	Endo
GTTACTTAGGCCAATG-1	Fib
CTAACTTAGACCCTAT-1	Endo
AGCTGGCAGTGGACGT-1	Fib
GAAGTGGGTACCAAGG-1	Myeloid
AAAGATGTCGTGGTAT-1	Myeloid
AACCGATGTTATAGAG-1	Myeloid
ATTTGTCGTCTAACCA-1	Myeloid
TGCACCTCAACGTCCG-1	Myeloid
CCCGTTAGTGGATTCT-1	Lymphoid
CTACTTAAGACCCTAT-1	Myeloid
AGCCGCAAGCTGATTC-1	Myeloid
GCACCTTTCTTGTGCC-1	Endo
ACTAGGTGTGCTAGTT-1	Myeloid
TGGGTGCGTGTCCAGC-1	Lymphoid
GCAGCTGCAAGCGTCC-1	Endo
ACAAGCTCATGGTAAA-1	Myeloid
CGGACTGTCCTGACCT-1	Fib
GAAATGAGTGGTACTT-1	Pericyte
AAAGATGGTTCTGAGT-1	Myeloid
TACTGCCTCGATATGC-1	Myeloid
CTGCTCACACCCATCT-1	Myeloid
TACATTCGTCTGTCCT-1	Myeloid
CCACGTTTCAGCCGAC-1	Fib
GTGTGATAGGCCAGTA-1	Myeloid
TGCTCACGTCCCTAAA-1	Fib
CACTAAGGTCGATTAC-1	Myeloid
CTTTGCGGTGCTGTGC-1	Lymphoid
ATCCTGCTCCGCTCTA-1	Endo
GGGTTATCATTGTTCT-1	Myeloid
TCACAGAGTAGACGCA-1	Myeloid
GCACGCATCTATCCTA-1	Myeloid
AGCGATTGTGTACGCC-1	Myeloid
TCGGGACCAAGTAACA-1	Pericyte
TTGGTCCTCTGGTACA-1	Myeloid
GAACTTGGTATCTCAG-1	Myeloid
AACCGATTCCGAGGAA-1	Myeloid
CGCTGGACAGCTTACA-1	Myeloid
CCGTAGGTCGTGGCGT-1	Endo
CCGCATTGTAGTCCAT-1	Myeloid
CACCACTGTGCAGACA-1	CM
CTGCGTTAGGCTTCGC-1	Myeloid
GCAACCGTCTACTGCC-1	Myeloid
ACAAGCTTCTTAGTGG-1	Myeloid
AATGTCGCACGTTACA-1	Myeloid
GCCATAAAGTTGCTTG-1	Myeloid
CGCACAGGTAGGTGAC-1	Myeloid
GCGGGTTAGAGAAGCA-1	Myeloid
ACCGGGTAGACCGCAA-1	Myeloid
AGCCTCTAGTACAGAT-1	Lymphoid
GCGAGTCTCATCGCCT-1	Myeloid
GGTGCTGAGTGAAACT-1	Myeloid
GTGCTGGGTTACGGAG-1	Myeloid
TTGTCTACACTGTCAA-1	Myeloid
GGGTCTGAGGGAGATA-1	Fib
ATTACTCAGAAGAGTG-1	Myeloid
ACGTGGCGTCACTCTC-1	Fib
GCATTCCCACATTCTT-1	Myeloid
ACTACGATCCAGAATC-1	Myeloid
TACTAGGTCGAAGCCC-1	Myeloid
CCACAGGGTGTCGTGC-1	Myeloid
GATGATCGTCATAGAA-1	Endo
CGAGTTAGTAACTGAA-1	Myeloid
CGTTCCAGTCTCTGGG-1	Lymphoid
CAGGATTAGTCGATAA-1	Fib
GTAGTACGTTCTGAAC-1	Endo
TTAACGGAGGGAAATG-1	Myeloid
CCTTGCATCCACGCTT-1	Pericyte
GGGACCTGTTGGGAAC-1	Myeloid
ACTGTCCGTTAACTCG-1	Myeloid
TTACCGCGTTGGCTAT-1	CM
GTACTTTTCCCAGCGA-1	Fib
TTGCGAAAGTCTCTAG-1	Myeloid
GATGATCCATTACTTC-1	Myeloid
GGGCCATTCGCTGATA-1	Lymphoid
CAAGCTATCCAACCTC-1	Myeloid
TTCTGTAAGATCGCCC-1	Myeloid
TTGACGATCGCGTGAC-1	Fib
AGCCGCACAATTCAGC-1	Pericyte
CAGTATGTCGGATAGG-1	Myeloid
GTAATCGTCGGTTCCT-1	Endo
CAGCTGGAGTCAGGAC-1	Endo
AAGATAGTCCTGTGGG-1	Myeloid
ACAGACTAGAGTTCGG-1	Myeloid
AGGCGTCTCTTACTCA-1	Myeloid
CGCAATAGTCCTATTT-1	Endo
TGCATTTTCGAACCGC-1	Myeloid
ATCCTCGCACGTGAAG-1	Endo
TACAGCATCATTCATC-1	Myeloid
GTGTCAACACCCTTAC-1	Endo
CGCAATACATAGACGG-1	Myeloid
TCAGCTCCAAGCAGGT-1	Fib
CATAACGAGCAGAAAG-1	Myeloid
GAAGTGGTCCACGAGC-1	Fib
CTCGCTAGTAAGGTCG-1	Myeloid
GCGGTGTCAACGTCCG-1	Myeloid
TTCAACTGTCAACAGG-1	CM
CTTGCCAAGCACCATT-1	Myeloid
CCCACATTCGGTCGAC-1	Lymphoid
GAGACTTAGGTACTCT-1	Lymphoid
GCTTGCTTCAGTCTTT-1	CM
GCATTGAAGGTGTTGG-1	Fib
GCACGCACATAGACGG-1	Endo
TTCAACTGTACGCAAG-1	CM
CTCATGCGTAATGCAA-1	Pericyte
AGTGCGCGTGATGCTT-1	Myeloid
GCCATAAAGCAGGAGG-1	Endo
TGGGTTACAAGTTGCT-1	Myeloid
GCCATAACAGGGTACA-1	Fib
AATGGAACATGGTATC-1	Myeloid
AGTGCCGCAAGCAACG-1	Endo
TTGTTCATCCCATAGA-1	Lymphoid
CTCTAGCCAACTCCCT-1	Lymphoid
TACGCAAAGGCGACTA-1	Myeloid
GAAACAATCTGTTTAC-1	Myeloid
TCAGCTCAGTATGCTC-1	Endo
CTTGAAGAGACACTTC-1	Myeloid
GCGATTAAGAATGCTA-1	Endo
CCTATTAAGATGGCAC-1	Myeloid
CAGGGCTCATGTCCCT-1	Myeloid
ACGTTAGAGGATATCA-1	Myeloid
CGCTATCCATCATCGA-1	Myeloid
CGTAAACTCAGTCTTT-1	Endo
ACCCAAATCCGGAAAG-1	Myeloid
CACGTTCCACGACGAA-1	Myeloid
GTTATGGCAATGTAAG-1	Myeloid
ACAGAAATCCTGACCT-1	Endo
CTAACTTGTGATAGAT-1	Endo
CATAACGCAACTACTG-1	Myeloid
TTGTCTAGTGTGTGCC-1	CM
TGATCAGGTGCTGTCG-1	Myeloid
GCAAAGGTCGTTGTAG-1	Endo
CTGTATTAGTCTGTGT-1	Myeloid
GTCGTAAAGAGTCCGA-1	Pericyte
GTCTACCTCTGCTACC-1	Endo
TGATTTCCAAATGCTC-1	Myeloid
TGGTCCTGTGGTCGAA-1	Lymphoid
GCCAGCACATTGCACA-1	Lymphoid
GCGAGTCCACACATGT-1	Myeloid
ATTGTCTTCCGTTTCG-1	Myeloid
AAATGCCTCTGGCACG-1	Myeloid
AGCGTGCGTCTGATTG-1	Myeloid
CAGTGTAGTGCGTAGA-1	Myeloid
TGCTCACAGTGTCGCC-1	Lymphoid
AACCTGAGTGCCGGTT-1	Myeloid
AACCTTTCATCCGTAA-1	Myeloid
CCACAGGCATCCCAAA-1	Myeloid
TTGTCTAAGCATTCCA-1	Myeloid
CACTAAGGTAACTCCA-1	Myeloid
GCAGCTGCACCAAGGA-1	Myeloid
CACATGAGTAGAAGCC-1	Myeloid
GTCACCTAGCAGAAAG-1	Myeloid
TATTGCTGTATTCTTC-1	Myeloid
GCTGAGCGTCATCAAC-1	Myeloid
TACCTCGAGACACGGT-1	Pericyte
GGAGAACGTAGCTGTT-1	Myeloid
AAAGATGCAAATGCTC-1	Myeloid
GTCCATCTCGATGTAC-1	Fib
TCAAGACGTCTGCACG-1	Pericyte
CCCGTTAGTACAACGG-1	Myeloid
AAAGATGCAGTATACC-1	Myeloid
TAACGGTTCGATGTAC-1	Fib
GCAAAGGGTCCAAGTT-1	Myeloid
TCTATTGCATGGGACA-1	CM
CGCGCAAAGTGTCGCC-1	Myeloid
GTGTCAATCAGTCTTT-1	CM
TGAGCCGAGTCATCTG-1	Fib
CGGTGCATCCGTACGG-1	Lymphoid
TTCATTGAGTCCTTCC-1	Myeloid
GATTAGCGTCAACAGG-1	CM
CATTGGACATCGACCG-1	Myeloid
ATGGATCCAGGGAGTT-1	Myeloid
TAACTTCAGACTAATG-1	Myeloid
TACGCAAGTTCCGCGA-1	CM
GTGTCCTAGCTATCGT-1	Myeloid
GCCAGACTCCGTTTCG-1	Endo
GCAGCCAAGTAACACA-1	Myeloid
CTAGCGGCATGATTGC-1	Myeloid
AGCGTATAGCTGAGGT-1	Myeloid
ATGTCTTGTATCAGCT-1	Fib
CTAGGATAGGATATCA-1	CM
GCACCTTGTGAGTCGA-1	Fib
CAGCTAAGTATTGTCG-1	Myeloid
CGGACCAAGGCAGATC-1	Myeloid
TATCGAGTCTCTATCA-1	Pericyte
TTAACGGGTGGCCTCA-1	Pericyte
CAACCAATCGATGTAC-1	Fib
AACCTGAGTTGGTAAA-1	CM
TACGGATAGGCAGATC-1	Myeloid
AACTGGTTCTGATCTT-1	Myeloid
TACTCGCTCGGGAAAC-1	CM
TACCTCGCATGGAGGT-1	Fib
CCAGATACACGGCCAT-1	Fib
TCAAAGCGTTAACCAC-1	Pericyte
GCCAGCATCACGTGTA-1	Myeloid
TGTAGCAAGTGAACCG-1	Myeloid
TAGTCCCGTGCGTAGA-1	vSMCs
GCTCCTACATCCTGGG-1	Fib
AAATGAGTCGATATGC-1	Myeloid
GTAGGAGCATAGACGG-1	CM
GAGCGCTAGTGTCCCG-1	Lymphoid
ACTATTCGTGCTGTCG-1	CM
TTTGGTTTCAACGTGT-1	Pericyte
TGGTCCTGTGGACCAA-1	Lymphoid
AACTGGTTCCGTTAGA-1	Myeloid
ACTACCCAGCAACGGT-1	Lymphoid
ACCCAAAAGGAGAACA-1	Endo
GTGACATGTTTGGATC-1	Lymphoid
TTGCTATGTCTCGGGT-1	Endo
GCTCGAGAGGTAAGCC-1	Myeloid
AACATCGCATCCTGGG-1	Fib
CAGCTGGTCCGAGAGA-1	Myeloid
CCCTGATAGTCCGATT-1	Myeloid
ACATGCATCGGTCTCT-1	CM
CCGTGAGTCGTTCTAT-1	Myeloid
GAGTGAGAGACCGCAA-1	Lymphoid
AACTTGGAGAGGTCCA-1	CM
TGCTCACAGCTGAATA-1	Myeloid
TACAGCAGTTCTGATG-1	CM
TACTCGCGTAACGGCA-1	Lymphoid
CTTGCCATCACATCCC-1	Endo
GCTGCGAGTTTAGGAA-1	Endo
CATTCCGAGTTCGACT-1	CM
CTTCCAGGTCAAATCC-1	Fib
TCCAGAATCGCTTACC-1	Lymphoid
ACTACCCTCCGTACGG-1	Lymphoid
GCAACCGAGTGCCCTG-1	CM
CTCATGCGTTCTGAGT-1	Pericyte
CATTCATTCGAGAACG-1	CM
GTCACAAAGCAGAAAG-1	Myeloid
GATTAGCGTACGCAAG-1	CM
GGATGAGCACATCATG-1	Lymphoid
ATCCTCGTCGTGGAAG-1	CM
TAAGTGCGTGCTAGTT-1	vSMCs
ACGTGGCGTGTAGGAC-1	Fib
TATGTGGCAGTTACAC-1	vSMCs
AAGATAGAGGACCGAT-1	Myeloid
CTCTACGTCCCGATTC-1	Endo
ACCATCCCAAGCACTT-1	Pericyte
GTGGATTCAGATTGTC-1	Myeloid
TACGGATCATCCTGGG-1	CM
TGCGTAAAGATCCGAG-1	vSMCs
CTGGGACCACGTTACA-1	Lymphoid
GGATAGGTCAGTGTAC-1	Lymphoid
TATCGAGAGCAGAAAG-1	Myeloid
TGTGGCGAGCCATGGA-1	CM
CTGAATGCAACTGCGC-1	Lymphoid
CTCCCAAGTCGCTAGC-1	CM
CGATGATCAAATGCTC-1	Lymphoid
ACTGTCCGTTGGGAAC-1	CM
GCTCGAGCAAACCTAC-1	Fib
CGGTGCAGTATGTTCG-1	Pericyte
TGTAAGCCAAACCGAG-1	CM
TAAGTGCAGAATAGTC-1	Pericyte
GAGACTTTCAAACCAC-1	Pericyte
ATGTCGAAGCAGAAAG-1	Myeloid
TATGTTCCATACTGCA-1	Lymphoid
GACCGACGTTACTTTC-1	Lymphoid
GATCATGAGTAGCAAT-1	Lymphoid
AATGCCAGTGAGCTAG-1	Endo
CATGTTTCAGGTTATC-1	CM
ACTACGAAGTCGATAA-1	Lymphoid
GCAGCTGTCTTCCAGC-1	Fib
CCCACATAGTCCCTCT-1	CM
TGTTAGGCAACGTACT-1	CM
TACGCAAGTAGTATCC-1	Myeloid
CTCCCAAAGATCGCCC-1	Endo
GGAATCTAGCAGAAAG-1	CM
CGCTATCGTGCGTTTA-1	CM
CCATACCGTAACACTC-1	CM
TACCTCGAGAACCATA-1	CM
CACAGATAGGCGCTTC-1	CM
ACTGCAAGTTAGCTCA-1	CM
GTCACCTAGCGATACG-1	CM
ATGTTTCCACATTGCA-1	Pericyte
AGCCTCTAGTTACCAC-1	Endo
CACAGATAGCAGGAGG-1	Fib
GAGATTCAGGCCAATG-1	CM
ATAGTCGAGCAGAAAG-1	CM
AATGGCTCAGGTGTCC-1	CM
TTACGTTGTTAACCAC-1	Endo
TTGCCCAAGAGCTGTG-1	Lymphoid
GCGATTAAGAACCCGA-1	Lymphoid
GTGGATTTCCAGAGAG-1	CM
CACAGATAGCAGAAAG-1	CM
ACTAACGCACATTCTT-1	CM
TTGCCCAGTTAACTCG-1	Endo
TAAGTGCTCGGGAATG-1	Fib
AAAGATGCATCTCACC-1	Fib
ATGTCTTAGACACGGT-1	CM
CTGTTCGCATGGAGGT-1	CM
GGCACGTAGCAGAAAG-1	CM
CTAACTTCAACTCCCT-1	CM
TGGCGCACACGCTAAT-1	Pericyte
GTAGTACTCAGCCGAC-1	CM
TAACGGTTCGGGAAAC-1	CM
TATGTTCAGTAGACCG-1	Endo
ACTCGGGTCCTATCAT-1	Endo
AATACGCTCTAAGGTC-1	CM
GTCACGGCATATTGGC-1	Endo
TTGTTCAAGTCGATAA-1	Fib
TAATCGGAGTCGATAA-1	Fib
CGGACCACACTTACAG-1	Endo
CAAGAAATCGAGGTAG-1	CM
ACCTGCTAGTAACACA-1	Myeloid
CAGCTGGGTACGGTTT-1	CM
CCGTGAGTCTGCTACC-1	Endo
CTAACTTAGGGCTTCC-1	Endo
GAAGTGGTCGAGGTAG-1	Endo
TGTAGCAGTGAGGTCA-1	CM
CTAACTTAGAGGTGGG-1	Endo
TGATCAGTCCAGAATC-1	Myeloid
GCTCGAGCAACTTGGT-1	Fib
AGGCCTGGTCCATTGA-1	Myeloid
AGATTCGGTAACATAG-1	CM
TACGGATCATGGAGGT-1	CM
TAGTCCCGTTGCCTGG-1	Endo
TCACTCGGTTAAGTCC-1	CM
GCTTGCTCAAGTCCTA-1	CM
GCATTGAAGTCGATAA-1	Fib
TACAGCAGTTGGGAAC-1	CM
CCGTGAGTCGATGTAC-1	CM
TAACTTCCACACGGTC-1	Myeloid
AGTTTGGCAGCACATT-1	CM
AGGCGAAAGCAGAAAG-1	CM
TTCTGTACATACCCGG-1	CM
CAACCAATCGTTCTAT-1	CM
CAGCTGGGTTCAGAAA-1	Myeloid
GCAAAGGAGTGAAGGA-1	CM
CGAGTTAGTCAACTGT-1	CM
GTGATCACATACCCGG-1	Fib
TGTTAGGTCTCTTAAC-1	CM
ACCAAACAGGATTGAT-1	CM
GGATGAGGTGGCATAG-1	Endo
GTGGATTCAGGTTATC-1	CM
GCGGTGTGTATGGATA-1	CM
TGCACCTAGCAGGAGG-1	Fib
AGCGATTGTAGCGTTT-1	CM
AGCTGATAGTAGAAGG-1	CM
GCGCATGCAGCGTAGA-1	CM
CTAGGGCCACCGAATT-1	CM
GTAGTACTCCGTGCAG-1	CM
TCAAGGTGTGGCATAG-1	CM
CTGCTCACAAGACTAA-1	CM
TAAACCGTCAGGGTTT-1	CM
GATCATGGTCAAATCC-1	CM
